下午从埃尔卡拉法特去基督城，有什么火车？	{下午=出发时间, 火车=交通方式, 基督城=目的城市, 埃尔卡拉法特=出发城市}	特定行程方式下的路线
上午从圣迭戈去普雷韦扎，有什么地铁？	{圣迭戈=出发城市, 上午=出发时间, 普雷韦扎=目的城市, 地铁=交通方式}	特定行程方式下的路线
上午从图尔奈去西归浦，有什么地铁？	{图尔奈=出发城市, 西归浦=目的城市, 上午=出发时间, 地铁=交通方式}	特定行程方式下的路线
晚上从特内里费岛去帕坦，有什么大巴车？	{特内里费岛=出发城市, 大巴车=交通方式, 帕坦=目的城市, 晚上=出发时间}	特定行程方式下的路线
下午3点从清州去马六甲，有什么飞机？	{下午3点=出发时间, 清州=出发城市, 飞机=交通方式, 马六甲=目的城市}	特定行程方式下的路线
晚上从乌普萨拉去基拉尼，有什么大巴车？	{大巴车=交通方式, 乌普萨拉=出发城市, 基拉尼=目的城市, 晚上=出发时间}	特定行程方式下的路线
下午从赖扬去尔湾，有什么飞机？	{尔湾=目的城市, 下午=出发时间, 赖扬=出发城市, 飞机=交通方式}	特定行程方式下的路线
明天从尼甘布去黄金海岸，有什么地铁？	{黄金海岸=目的城市, 明天=出发时间, 地铁=交通方式, 尼甘布=出发城市}	特定行程方式下的路线
晚上从清迈去圣吉尔根，有什么大巴车？	{大巴车=交通方式, 圣吉尔根=目的城市, 晚上=出发时间, 清迈=出发城市}	特定行程方式下的路线
晚上从卡梅尔去基尔根尼，有什么大巴车？	{大巴车=交通方式, 卡梅尔=出发城市, 基尔根尼=目的城市, 晚上=出发时间}	特定行程方式下的路线
11点从卢塞恩去金泽，有什么飞机？	{11点=出发时间, 卢塞恩=出发城市, 金泽=目的城市, 飞机=交通方式}	特定行程方式下的路线
下午从阿尔布费拉去布法罗，有什么地铁？	{下午=出发时间, 阿尔布费拉=出发城市, 地铁=交通方式, 布法罗=目的城市}	特定行程方式下的路线
下午从依云去蔚山，有什么火车？	{下午=出发时间, 火车=交通方式, 蔚山=目的城市, 依云=出发城市}	特定行程方式下的路线
下午从卑尔根去首尔，有什么大巴车？	{卑尔根=出发城市, 大巴车=交通方式, 下午=出发时间, 首尔=目的城市}	特定行程方式下的路线
晚上从日惹去马丘比丘，有什么地铁？	{马丘比丘=目的城市, 日惹=出发城市, 地铁=交通方式, 晚上=出发时间}	特定行程方式下的路线
本周从格林德瓦去恩纳，有什么地铁？	{本周=出发时间, 恩纳=目的城市, 格林德瓦=出发城市, 地铁=交通方式}	特定行程方式下的路线
下午3点从戛纳去拉杰沙希，有什么地铁？	{下午3点=出发时间, 拉杰沙希=目的城市, 戛纳=出发城市, 地铁=交通方式}	特定行程方式下的路线
后天从花莲去托马尔，有什么大巴车？	{后天=出发时间, 花莲=出发城市, 大巴车=交通方式, 托马尔=目的城市}	特定行程方式下的路线
11点从番红花城去金边，有什么大巴车？	{大巴车=交通方式, 11点=出发时间, 金边=目的城市, 番红花城=出发城市}	特定行程方式下的路线
晚上从马拉加去拉斯佩齐亚，有什么大巴车？	{大巴车=交通方式, 拉斯佩齐亚=目的城市, 晚上=出发时间, 马拉加=出发城市}	特定行程方式下的路线
下午3点从圣吉尔根去卡法亚特，有什么大巴车？	{下午3点=出发时间, 大巴车=交通方式, 圣吉尔根=出发城市, 卡法亚特=目的城市}	特定行程方式下的路线
下午从采法特去蒲甘，有什么飞机？	{下午=出发时间, 蒲甘=目的城市, 采法特=出发城市, 飞机=交通方式}	特定行程方式下的路线
下午3点从康提去宇治，有什么地铁？	{下午3点=出发时间, 康提=出发城市, 地铁=交通方式, 宇治=目的城市}	特定行程方式下的路线
11点从长滩去克鲁姆洛夫，有什么大巴车？	{克鲁姆洛夫=目的城市, 大巴车=交通方式, 11点=出发时间, 长滩=出发城市}	特定行程方式下的路线
上午从波隆纳鲁沃去班贝格，有什么火车？	{火车=交通方式, 上午=出发时间, 波隆纳鲁沃=出发城市, 班贝格=目的城市}	特定行程方式下的路线
本周从克拉克去内罗毕，有什么火车？	{本周=出发时间, 克拉克=出发城市, 内罗毕=目的城市, 火车=交通方式}	特定行程方式下的路线
明天从磅湛去萨克拉门托，有什么大巴车？	{大巴车=交通方式, 明天=出发时间, 磅湛=出发城市, 萨克拉门托=目的城市}	特定行程方式下的路线
本周从鹿港去乌姆盖万，有什么飞机？	{本周=出发时间, 鹿港=出发城市, 乌姆盖万=目的城市, 飞机=交通方式}	特定行程方式下的路线
后天从拿骚去沙勒罗瓦，有什么地铁？	{后天=出发时间, 拿骚=出发城市, 地铁=交通方式, 沙勒罗瓦=目的城市}	特定行程方式下的路线
本周从陶波去锡尔赫特，有什么火车？	{本周=出发时间, 锡尔赫特=目的城市, 火车=交通方式, 陶波=出发城市}	特定行程方式下的路线
下午3点从亚庇去特隆赫姆，有什么火车？	{下午3点=出发时间, 亚庇=出发城市, 火车=交通方式, 特隆赫姆=目的城市}	特定行程方式下的路线
下午3点从克里特岛去帕坦，有什么火车？	{下午3点=出发时间, 火车=交通方式, 克里特岛=出发城市, 帕坦=目的城市}	特定行程方式下的路线
下午3点从浦项市去卡塔尼亚，有什么地铁？	{下午3点=出发时间, 浦项市=出发城市, 地铁=交通方式, 卡塔尼亚=目的城市}	特定行程方式下的路线
下午从乌布去垦丁，有什么地铁？	{垦丁=目的城市, 下午=出发时间, 地铁=交通方式, 乌布=出发城市}	特定行程方式下的路线
下午3点从特拉维夫去因特拉肯，有什么火车？	{下午3点=出发时间, 火车=交通方式, 因特拉肯=目的城市, 特拉维夫=出发城市}	特定行程方式下的路线
11点从马特鲁去罗弗敦群岛，有什么大巴车？	{大巴车=交通方式, 罗弗敦群岛=目的城市, 马特鲁=出发城市, 11点=出发时间}	特定行程方式下的路线
明天从悉尼去伏尔加格勒，有什么地铁？	{伏尔加格勒=目的城市, 明天=出发时间, 地铁=交通方式, 悉尼=出发城市}	特定行程方式下的路线
后天从依云去爱丽丝泉，有什么大巴车？	{爱丽丝泉=目的城市, 后天=出发时间, 大巴车=交通方式, 依云=出发城市}	特定行程方式下的路线
今天从美里去库姆，有什么火车？	{火车=交通方式, 今天=出发时间, 库姆=目的城市, 美里=出发城市}	特定行程方式下的路线
下午3点从乌姆盖万去瓦伦西亚，有什么大巴车？	{下午3点=出发时间, 大巴车=交通方式, 瓦伦西亚=目的城市, 乌姆盖万=出发城市}	特定行程方式下的路线
早上从延雪平去高雄，有什么火车？	{火车=交通方式, 延雪平=出发城市, 早上=出发时间, 高雄=目的城市}	特定行程方式下的路线
晚上从库尔纳去桑尼维尔，有什么地铁？	{地铁=交通方式, 晚上=出发时间, 库尔纳=出发城市, 桑尼维尔=目的城市}	特定行程方式下的路线
11点从图尔库去哥本哈根，有什么地铁？	{11点=出发时间, 地铁=交通方式, 哥本哈根=目的城市, 图尔库=出发城市}	特定行程方式下的路线
今天从杜马盖地去丹老，有什么大巴车？	{丹老=目的城市, 大巴车=交通方式, 杜马盖地=出发城市, 今天=出发时间}	特定行程方式下的路线
下午从特拉维夫去网走，有什么火车？	{网走=目的城市, 下午=出发时间, 火车=交通方式, 特拉维夫=出发城市}	特定行程方式下的路线
本周从华富里去马尔多纳多港，有什么火车？	{本周=出发时间, 火车=交通方式, 马尔多纳多港=目的城市, 华富里=出发城市}	特定行程方式下的路线
上午从长崎去纳塔尔，有什么火车？	{纳塔尔=目的城市, 火车=交通方式, 上午=出发时间, 长崎=出发城市}	特定行程方式下的路线
今天从因斯布鲁克去根特，有什么飞机？	{今天=出发时间, 因斯布鲁克=出发城市, 根特=目的城市, 飞机=交通方式}	特定行程方式下的路线
11点从豪伊杜索博斯洛去博德，有什么飞机？	{豪伊杜索博斯洛=出发城市, 博德=目的城市, 11点=出发时间, 飞机=交通方式}	特定行程方式下的路线
下午从素叻他尼去谢尔盖耶夫，有什么飞机？	{下午=出发时间, 素叻他尼=出发城市, 谢尔盖耶夫=目的城市, 飞机=交通方式}	特定行程方式下的路线
今天从蓬特雷西纳去甲米，有什么飞机？	{蓬特雷西纳=出发城市, 今天=出发时间, 飞机=交通方式, 甲米=目的城市}	特定行程方式下的路线
下午3点从开普敦去萨能，有什么火车？	{下午3点=出发时间, 萨能=目的城市, 火车=交通方式, 开普敦=出发城市}	特定行程方式下的路线
11点从博卡拉去图尔奈，有什么飞机？	{图尔奈=目的城市, 博卡拉=出发城市, 11点=出发时间, 飞机=交通方式}	特定行程方式下的路线
本周从萨格里斯去尔湾，有什么飞机？	{本周=出发时间, 尔湾=目的城市, 萨格里斯=出发城市, 飞机=交通方式}	特定行程方式下的路线
晚上从阿马尔菲去马特莱，有什么火车？	{阿马尔菲=出发城市, 火车=交通方式, 马特莱=目的城市, 晚上=出发时间}	特定行程方式下的路线
11点从玛丽亚温泉市去布雷，有什么飞机？	{玛丽亚温泉市=出发城市, 11点=出发时间, 飞机=交通方式, 布雷=目的城市}	特定行程方式下的路线
下午3点从库比蒂诺去玛瑙斯市，有什么飞机？	{下午3点=出发时间, 库比蒂诺=出发城市, 飞机=交通方式, 玛瑙斯市=目的城市}	特定行程方式下的路线
上午从威克洛郡去毛凯岛，有什么大巴车？	{大巴车=交通方式, 上午=出发时间, 威克洛郡=出发城市, 毛凯岛=目的城市}	特定行程方式下的路线
明天从台中去蓝山，有什么飞机？	{蓝山=目的城市, 明天=出发时间, 台中=出发城市, 飞机=交通方式}	特定行程方式下的路线
后天从施皮茨去那慕尔，有什么火车？	{后天=出发时间, 火车=交通方式, 那慕尔=目的城市, 施皮茨=出发城市}	特定行程方式下的路线
下午从釜山去阿拉梅达，有什么大巴车？	{大巴车=交通方式, 下午=出发时间, 釜山=出发城市, 阿拉梅达=目的城市}	特定行程方式下的路线
今天从蔚山去厄尔查尔坦，有什么飞机？	{今天=出发时间, 蔚山=出发城市, 厄尔查尔坦=目的城市, 飞机=交通方式}	特定行程方式下的路线
后天从美蕊沙去瓜拉登嘉楼，有什么火车？	{瓜拉登嘉楼=目的城市, 后天=出发时间, 美蕊沙=出发城市, 火车=交通方式}	特定行程方式下的路线
晚上从枫丹白露去台南，有什么地铁？	{枫丹白露=出发城市, 地铁=交通方式, 晚上=出发时间, 台南=目的城市}	特定行程方式下的路线
下午3点从棕榈泉去胡萨维克，有什么飞机？	{下午3点=出发时间, 棕榈泉=出发城市, 胡萨维克=目的城市, 飞机=交通方式}	特定行程方式下的路线
下午3点从伊萨菲厄泽去陶波，有什么火车？	{下午3点=出发时间, 火车=交通方式, 伊萨菲厄泽=出发城市, 陶波=目的城市}	特定行程方式下的路线
晚上从费城去维甘，有什么地铁？	{费城=出发城市, 地铁=交通方式, 维甘=目的城市, 晚上=出发时间}	特定行程方式下的路线
今天从莱城去蓝山，有什么火车？	{蓝山=目的城市, 火车=交通方式, 今天=出发时间, 莱城=出发城市}	特定行程方式下的路线
早上从高雄去眉谬，有什么大巴车？	{大巴车=交通方式, 早上=出发时间, 眉谬=目的城市, 高雄=出发城市}	特定行程方式下的路线
明天从金巴兰去阿罗萨，有什么大巴车？	{金巴兰=出发城市, 阿罗萨=目的城市, 大巴车=交通方式, 明天=出发时间}	特定行程方式下的路线
晚上从沙勒罗瓦去布法罗，有什么火车？	{火车=交通方式, 布法罗=目的城市, 晚上=出发时间, 沙勒罗瓦=出发城市}	特定行程方式下的路线
下午3点从圣地亚哥-德孔波斯特拉去玛琅，有什么火车？	{下午3点=出发时间, 玛琅=目的城市, 火车=交通方式, 圣地亚哥-德孔波斯特拉=出发城市}	特定行程方式下的路线
后天从拉哈尔去达沃，有什么火车？	{后天=出发时间, 达沃=目的城市, 火车=交通方式, 拉哈尔=出发城市}	特定行程方式下的路线
明天从玛琅去富川，有什么火车？	{玛琅=出发城市, 火车=交通方式, 明天=出发时间, 富川=目的城市}	特定行程方式下的路线
晚上从澎湖列岛去伊瓜苏市，有什么地铁？	{伊瓜苏市=目的城市, 澎湖列岛=出发城市, 地铁=交通方式, 晚上=出发时间}	特定行程方式下的路线
晚上从宫崎市去岘港，有什么地铁？	{地铁=交通方式, 晚上=出发时间, 宫崎市=出发城市, 岘港=目的城市}	特定行程方式下的路线
上午从埃拉特去奥克兰，有什么火车？	{奥克兰=目的城市, 火车=交通方式, 埃拉特=出发城市, 上午=出发时间}	特定行程方式下的路线
11点从金巴兰去加勒，有什么飞机？	{金巴兰=出发城市, 11点=出发时间, 加勒=目的城市, 飞机=交通方式}	特定行程方式下的路线
下午从西奈山去贝尔法斯特，有什么地铁？	{贝尔法斯特=目的城市, 下午=出发时间, 西奈山=出发城市, 地铁=交通方式}	特定行程方式下的路线
本周从哈利法克斯去布鲁塞尔，有什么火车？	{本周=出发时间, 火车=交通方式, 布鲁塞尔=目的城市, 哈利法克斯=出发城市}	特定行程方式下的路线
明天从哈利法克斯去库兰达，有什么火车？	{火车=交通方式, 明天=出发时间, 哈利法克斯=出发城市, 库兰达=目的城市}	特定行程方式下的路线
11点从新山去河内，有什么火车？	{火车=交通方式, 11点=出发时间, 新山=出发城市, 河内=目的城市}	特定行程方式下的路线
早上从龙达去奥斯坦德，有什么地铁？	{奥斯坦德=目的城市, 龙达=出发城市, 地铁=交通方式, 早上=出发时间}	特定行程方式下的路线
今天从美里去班贝格，有什么地铁？	{今天=出发时间, 班贝格=目的城市, 地铁=交通方式, 美里=出发城市}	特定行程方式下的路线
早上从伏尔加格勒去吉马良斯，有什么大巴车？	{伏尔加格勒=出发城市, 大巴车=交通方式, 吉马良斯=目的城市, 早上=出发时间}	特定行程方式下的路线
上午从蒲甘去基洛纳，有什么火车？	{基洛纳=目的城市, 火车=交通方式, 蒲甘=出发城市, 上午=出发时间}	特定行程方式下的路线
下午3点从木尔坦去黑维兹，有什么大巴车？	{下午3点=出发时间, 大巴车=交通方式, 木尔坦=出发城市, 黑维兹=目的城市}	特定行程方式下的路线
今天从里斯本去门多萨，有什么火车？	{火车=交通方式, 今天=出发时间, 门多萨=目的城市, 里斯本=出发城市}	特定行程方式下的路线
明天从米湖去格拉斯哥，有什么飞机？	{格拉斯哥=目的城市, 明天=出发时间, 米湖=出发城市, 飞机=交通方式}	特定行程方式下的路线
11点从布尔诺去大分，有什么火车？	{大分=目的城市, 布尔诺=出发城市, 火车=交通方式, 11点=出发时间}	特定行程方式下的路线
本周从皮皮岛去金边，有什么大巴车？	{本周=出发时间, 大巴车=交通方式, 皮皮岛=出发城市, 金边=目的城市}	特定行程方式下的路线
晚上从里斯本去伊斯梅利亚，有什么火车？	{火车=交通方式, 伊斯梅利亚=目的城市, 里斯本=出发城市, 晚上=出发时间}	特定行程方式下的路线
本周从克里特岛去伊拉克利翁，有什么地铁？	{本周=出发时间, 伊拉克利翁=目的城市, 克里特岛=出发城市, 地铁=交通方式}	特定行程方式下的路线
下午从皮皮岛去拉包尔，有什么火车？	{下午=出发时间, 拉包尔=目的城市, 火车=交通方式, 皮皮岛=出发城市}	特定行程方式下的路线
早上从锡耶纳去密西沙加，有什么飞机？	{锡耶纳=出发城市, 密西沙加=目的城市, 早上=出发时间, 飞机=交通方式}	特定行程方式下的路线
上午从图恩去帕岸岛，有什么火车？	{图恩=出发城市, 帕岸岛=目的城市, 火车=交通方式, 上午=出发时间}	特定行程方式下的路线
下午3点从亚兹德去厄吕代尼兹，有什么飞机？	{下午3点=出发时间, 厄吕代尼兹=目的城市, 亚兹德=出发城市, 飞机=交通方式}	特定行程方式下的路线
早上从厄勒布鲁去米茨佩拉蒙，有什么大巴车？	{大巴车=交通方式, 厄勒布鲁=出发城市, 米茨佩拉蒙=目的城市, 早上=出发时间}	特定行程方式下的路线
今天从代尔夫特去丽水，有什么地铁？	{今天=出发时间, 地铁=交通方式, 代尔夫特=出发城市, 丽水=目的城市}	特定行程方式下的路线
明天从宜兰去奥基，有什么大巴车？	{大巴车=交通方式, 明天=出发时间, 奥基=目的城市, 宜兰=出发城市}	特定行程方式下的路线
11点从莱城去维多利亚市，有什么航班？	{维多利亚市=目的城市, 11点=出发时间, 莱城=出发城市}	特定行程方式下的路线
今天从豪伊杜索博斯洛去大不里士，有什么航班？	{豪伊杜索博斯洛=出发城市, 今天=出发时间, 大不里士=目的城市}	特定行程方式下的路线
11点从阿努拉德普勒去利默里克，有什么航班？	{阿努拉德普勒=出发城市, 利默里克=目的城市, 11点=出发时间}	特定行程方式下的路线
明天从拜县去坦佩雷，有什么航班？	{坦佩雷=目的城市, 明天=出发时间, 拜县=出发城市}	特定行程方式下的路线
后天从林雪平去剑桥，有什么航班？	{后天=出发时间, 林雪平=出发城市, 剑桥=目的城市}	特定行程方式下的路线
下午从米湖去列日，有什么航班？	{下午=出发时间, 列日=目的城市, 米湖=出发城市}	特定行程方式下的路线
下午从萨斯费去贾夫纳，有什么航班？	{下午=出发时间, 贾夫纳=目的城市, 萨斯费=出发城市}	特定行程方式下的路线
早上从陶尔米纳去长崎，有什么航班？	{陶尔米纳=出发城市, 早上=出发时间, 长崎=目的城市}	特定行程方式下的路线
下午从金泽去图尔库，有什么航班？	{下午=出发时间, 金泽=出发城市, 图尔库=目的城市}	特定行程方式下的路线
本周从奥基去日惹，有什么航班？	{本周=出发时间, 日惹=目的城市, 奥基=出发城市}	特定行程方式下的路线
上午从凯恩斯去圣罗莎，有什么航班？	{上午=出发时间, 凯恩斯=出发城市, 圣罗莎=目的城市}	特定行程方式下的路线
早上从瓦尼莫去淡水，有什么航班？	{瓦尼莫=出发城市, 早上=出发时间, 淡水=目的城市}	特定行程方式下的路线
下午3点从伊卡去伯克利，有什么航班？	{下午3点=出发时间, 伊卡=出发城市, 伯克利=目的城市}	特定行程方式下的路线
早上从函馆去阿维拉，有什么航班？	{函馆=出发城市, 阿维拉=目的城市, 早上=出发时间}	特定行程方式下的路线
下午3点从奥斯陆去利物浦，有什么航班？	{下午3点=出发时间, 奥斯陆=出发城市, 利物浦=目的城市}	特定行程方式下的路线
下午从渥太华去阿尔科巴萨，有什么航班？	{渥太华=出发城市, 下午=出发时间, 阿尔科巴萨=目的城市}	特定行程方式下的路线
后天从叶卡捷琳堡去萨斯费，有什么航班？	{后天=出发时间, 叶卡捷琳堡=出发城市, 萨斯费=目的城市}	特定行程方式下的路线
下午3点从神户去伊斯法罕，有什么航班？	{下午3点=出发时间, 神户=出发城市, 伊斯法罕=目的城市}	特定行程方式下的路线
下午从素叻他尼去新西伯利亚，有什么航班？	{下午=出发时间, 素叻他尼=出发城市, 新西伯利亚=目的城市}	特定行程方式下的路线
下午从设拉子去拜伦湾，有什么航班？	{下午=出发时间, 拜伦湾=目的城市, 设拉子=出发城市}	特定行程方式下的路线
今天从拉姆拉去贝尔马尔，有什么航班？	{拉姆拉=出发城市, 今天=出发时间, 贝尔马尔=目的城市}	特定行程方式下的路线
下午3点从亚特兰大去纳塔尔，有什么航班？	{下午3点=出发时间, 亚特兰大=出发城市, 纳塔尔=目的城市}	特定行程方式下的路线
明天从朗塞斯顿去雅典，有什么航班？	{雅典=目的城市, 朗塞斯顿=出发城市, 明天=出发时间}	特定行程方式下的路线
上午从伊卡去马六甲，有什么航班？	{上午=出发时间, 伊卡=出发城市, 马六甲=目的城市}	特定行程方式下的路线
下午从马赛马拉去库比蒂诺，有什么航班？	{下午=出发时间, 库比蒂诺=目的城市, 马赛马拉=出发城市}	特定行程方式下的路线
后天从欧登塞去谢菲尔德，有什么航班？	{后天=出发时间, 欧登塞=出发城市, 谢菲尔德=目的城市}	特定行程方式下的路线
下午从圣吉尔根去亚兹德，有什么航班？	{下午=出发时间, 圣吉尔根=出发城市, 亚兹德=目的城市}	特定行程方式下的路线
今天从科莫去弗洛姆，有什么航班？	{弗洛姆=目的城市, 科莫=出发城市, 今天=出发时间}	特定行程方式下的路线
晚上从法蒂玛去伊斯梅利亚，有什么航班？	{法蒂玛=出发城市, 伊斯梅利亚=目的城市, 晚上=出发时间}	特定行程方式下的路线
本周从因斯布鲁克去吉马良斯，有什么航班？	{本周=出发时间, 吉马良斯=目的城市, 因斯布鲁克=出发城市}	特定行程方式下的路线
今天从巴厘巴板去芒特哈根，有什么航班？	{巴厘巴板=出发城市, 今天=出发时间, 芒特哈根=目的城市}	特定行程方式下的路线
上午从日光去英国湖区，有什么航班？	{上午=出发时间, 日光=出发城市, 英国湖区=目的城市}	特定行程方式下的路线
本周从布拉加去库姆，有什么航班？	{本周=出发时间, 布拉加=出发城市, 库姆=目的城市}	特定行程方式下的路线
今天从巴厘巴板去拉罗汤加岛，有什么航班？	{拉罗汤加岛=目的城市, 巴厘巴板=出发城市, 今天=出发时间}	特定行程方式下的路线
明天从库姆去纳斯卡，有什么航班？	{明天=出发时间, 库姆=出发城市, 纳斯卡=目的城市}	特定行程方式下的路线
本周从巴拉望去亭可马里，有什么航班？	{本周=出发时间, 亭可马里=目的城市, 巴拉望=出发城市}	特定行程方式下的路线
明天从瓦纳卡去塔哈岛，有什么航班？	{塔哈岛=目的城市, 瓦纳卡=出发城市, 明天=出发时间}	特定行程方式下的路线
上午从巴格达去大城，有什么航班？	{上午=出发时间, 巴格达=出发城市, 大城=目的城市}	特定行程方式下的路线
今天从费特希耶去关丹，有什么航班？	{费特希耶=出发城市, 今天=出发时间, 关丹=目的城市}	特定行程方式下的路线
今天从长崎去白沙瓦，有什么航班？	{白沙瓦=目的城市, 今天=出发时间, 长崎=出发城市}	特定行程方式下的路线
下午从克里特岛去艾图塔基，有什么航班？	{下午=出发时间, 艾图塔基=目的城市, 克里特岛=出发城市}	特定行程方式下的路线
11点从埃德蒙顿去库兰达，有什么航班？	{埃德蒙顿=出发城市, 11点=出发时间, 库兰达=目的城市}	特定行程方式下的路线
上午从苏伊士去特拉维夫，有什么航班？	{苏伊士=出发城市, 上午=出发时间, 特拉维夫=目的城市}	特定行程方式下的路线
11点从阿比斯库去塔维拉，有什么航班？	{塔维拉=目的城市, 阿比斯库=出发城市, 11点=出发时间}	特定行程方式下的路线
下午3点从帕萨迪纳去攀牙，有什么航班？	{下午3点=出发时间, 攀牙=目的城市, 帕萨迪纳=出发城市}	特定行程方式下的路线
明天从麦地那去拉彭兰塔，有什么航班？	{拉彭兰塔=目的城市, 明天=出发时间, 麦地那=出发城市}	特定行程方式下的路线
上午从布里恩茨去摩尔曼斯克，有什么航班？	{布里恩茨=出发城市, 上午=出发时间, 摩尔曼斯克=目的城市}	特定行程方式下的路线
明天从宇治去埃尔卡拉法特，有什么航班？	{明天=出发时间, 宇治=出发城市, 埃尔卡拉法特=目的城市}	特定行程方式下的路线
11点从拉包尔去民丹岛，有什么航班？	{拉包尔=出发城市, 11点=出发时间, 民丹岛=目的城市}	特定行程方式下的路线
下午3点从黄金海岸去文根，有什么航班？	{下午3点=出发时间, 黄金海岸=出发城市, 文根=目的城市}	特定行程方式下的路线
下午从莱城去黄金海岸，有什么航班？	{黄金海岸=目的城市, 下午=出发时间, 莱城=出发城市}	特定行程方式下的路线
下午从圣克鲁斯去斯卡恩，有什么航班？	{下午=出发时间, 圣克鲁斯=出发城市, 斯卡恩=目的城市}	特定行程方式下的路线
下午从马特勒去谢菲尔德，有什么航班？	{下午=出发时间, 马特勒=出发城市, 谢菲尔德=目的城市}	特定行程方式下的路线
11点从汉诺威去凡尔赛，有什么航班？	{汉诺威=出发城市, 凡尔赛=目的城市, 11点=出发时间}	特定行程方式下的路线
今天从瓦伊塔佩去金巴兰，有什么航班？	{金巴兰=目的城市, 今天=出发时间, 瓦伊塔佩=出发城市}	特定行程方式下的路线
晚上从内坦亚去鹿港，有什么航班？	{鹿港=目的城市, 内坦亚=出发城市, 晚上=出发时间}	特定行程方式下的路线
本周从阿克雷里去罗托鲁瓦，有什么航班？	{本周=出发时间, 阿克雷里=出发城市, 罗托鲁瓦=目的城市}	特定行程方式下的路线
今天从指宿市去捷克布杰约维采，有什么航班？	{指宿市=出发城市, 今天=出发时间, 捷克布杰约维采=目的城市}	特定行程方式下的路线
11点从爪哇岛去南特，有什么航班？	{11点=出发时间, 南特=目的城市, 爪哇岛=出发城市}	特定行程方式下的路线
本周从拜县去布里斯班，有什么航班？	{本周=出发时间, 布里斯班=目的城市, 拜县=出发城市}	特定行程方式下的路线
下午3点从安东去布宜诺斯艾利斯，有什么航班？	{下午3点=出发时间, 安东=出发城市, 布宜诺斯艾利斯=目的城市}	特定行程方式下的路线
后天从浦项市去芭堤雅，有什么航班？	{后天=出发时间, 浦项市=出发城市, 芭堤雅=目的城市}	特定行程方式下的路线
早上从福伦丹去坦佩雷，有什么航班？	{福伦丹=出发城市, 坦佩雷=目的城市, 早上=出发时间}	特定行程方式下的路线
下午从西哈努克去格蒙登，有什么航班？	{西哈努克=出发城市, 下午=出发时间, 格蒙登=目的城市}	特定行程方式下的路线
11点从多哈去杰尔，有什么航班？	{多哈=出发城市, 11点=出发时间, 杰尔=目的城市}	特定行程方式下的路线
上午从戈公去波士顿，有什么航班？	{波士顿=目的城市, 上午=出发时间, 戈公=出发城市}	特定行程方式下的路线
11点从阿雷格里港去素可泰，有什么航班？	{阿雷格里港=出发城市, 素可泰=目的城市, 11点=出发时间}	特定行程方式下的路线
今天从圣吉尔根去釜山，有什么航班？	{今天=出发时间, 釜山=目的城市, 圣吉尔根=出发城市}	特定行程方式下的路线
晚上从布拉加去富良野，有什么航班？	{富良野=目的城市, 布拉加=出发城市, 晚上=出发时间}	特定行程方式下的路线
早上从暹粒去新山，有什么航班？	{暹粒=出发城市, 早上=出发时间, 新山=目的城市}	特定行程方式下的路线
下午3点从都灵去塔哈岛，有什么航班？	{下午3点=出发时间, 塔哈岛=目的城市, 都灵=出发城市}	特定行程方式下的路线
下午3点从圣安德烈去格罗宁根，有什么航班？	{下午3点=出发时间, 圣安德烈=出发城市, 格罗宁根=目的城市}	特定行程方式下的路线
11点从苏梅岛去桃园，有什么航班？	{桃园=目的城市, 11点=出发时间, 苏梅岛=出发城市}	特定行程方式下的路线
本周从戈罗卡去美蕊沙，有什么航班？	{本周=出发时间, 美蕊沙=目的城市, 戈罗卡=出发城市}	特定行程方式下的路线
晚上从吉大港去布法罗，有什么航班？	{吉大港=出发城市, 布法罗=目的城市, 晚上=出发时间}	特定行程方式下的路线
上午从埃尔卡拉法特去比萨，有什么航班？	{上午=出发时间, 比萨=目的城市, 埃尔卡拉法特=出发城市}	特定行程方式下的路线
11点从阿尔勒去忠州，有什么航班？	{阿尔勒=出发城市, 忠州=目的城市, 11点=出发时间}	特定行程方式下的路线
早上从俄斯特拉发去阿尔布费拉，有什么航班？	{阿尔布费拉=目的城市, 俄斯特拉发=出发城市, 早上=出发时间}	特定行程方式下的路线
明天从东京去帕罗斯，有什么航班？	{明天=出发时间, 东京=出发城市, 帕罗斯=目的城市}	特定行程方式下的路线
下午从佛罗伦萨去会安，有什么航班？	{下午=出发时间, 佛罗伦萨=出发城市, 会安=目的城市}	特定行程方式下的路线
上午从豪伊杜索博斯洛去坡州，有什么航班？	{豪伊杜索博斯洛=出发城市, 上午=出发时间, 坡州=目的城市}	特定行程方式下的路线
本周从皇后镇去阿尔布费拉，有什么航班？	{本周=出发时间, 阿尔布费拉=目的城市, 皇后镇=出发城市}	特定行程方式下的路线
晚上从多哈去埃武拉，有什么航班？	{埃武拉=目的城市, 多哈=出发城市, 晚上=出发时间}	特定行程方式下的路线
下午从蒂阿瑙去波尔图，有什么航班？	{下午=出发时间, 蒂阿瑙=出发城市, 波尔图=目的城市}	特定行程方式下的路线
下午从大邱去贝尔法斯特，有什么航班？	{大邱=出发城市, 贝尔法斯特=目的城市, 下午=出发时间}	特定行程方式下的路线
上午从温哥华去黄金海岸，有什么航班？	{黄金海岸=目的城市, 上午=出发时间, 温哥华=出发城市}	特定行程方式下的路线
下午3点从埃尔卡拉法特去施瓦茨，有什么航班？	{下午3点=出发时间, 施瓦茨=目的城市, 埃尔卡拉法特=出发城市}	特定行程方式下的路线
后天从弗拉基米尔去尼姆，有什么航班？	{后天=出发时间, 尼姆=目的城市, 弗拉基米尔=出发城市}	特定行程方式下的路线
11点从韦瓦克去拿骚，有什么航班？	{韦瓦克=出发城市, 拿骚=目的城市, 11点=出发时间}	特定行程方式下的路线
今天从圣罗莎去珀斯，有什么航班？	{珀斯=目的城市, 今天=出发时间, 圣罗莎=出发城市}	特定行程方式下的路线
明天从仙本那去捷克布杰约维采，有什么航班？	{仙本那=出发城市, 明天=出发时间, 捷克布杰约维采=目的城市}	特定行程方式下的路线
下午3点从苗栗去阿维尼翁，有什么航班？	{下午3点=出发时间, 苗栗=出发城市, 阿维尼翁=目的城市}	特定行程方式下的路线
后天从波尔图去霍基蒂卡，有什么航班？	{后天=出发时间, 波尔图=出发城市, 霍基蒂卡=目的城市}	特定行程方式下的路线
后天从库塔去库什蒂亚，有什么航班？	{库什蒂亚=目的城市, 后天=出发时间, 库塔=出发城市}	特定行程方式下的路线
后天从日惹去伊卡，有什么航班？	{后天=出发时间, 日惹=出发城市, 伊卡=目的城市}	特定行程方式下的路线
明天从莱比锡去斗湖，有什么航班？	{斗湖=目的城市, 莱比锡=出发城市, 明天=出发时间}	特定行程方式下的路线
上午从亚历山大去凯夫拉维克，有什么航班？	{亚历山大=出发城市, 凯夫拉维克=目的城市, 上午=出发时间}	特定行程方式下的路线
后天从拉斯佩齐亚去布鲁塞尔，有什么航班？	{后天=出发时间, 布鲁塞尔=目的城市, 拉斯佩齐亚=出发城市}	特定行程方式下的路线
下午3点从金泽去蒲甘，有什么航班？	{下午3点=出发时间, 蒲甘=目的城市, 金泽=出发城市}	特定行程方式下的路线
上午从格拉斯哥去古赛尔，有什么航班？	{古赛尔=目的城市, 格拉斯哥=出发城市, 上午=出发时间}	特定行程方式下的路线
早上从云林到卡梅尔的航班有哪些	{卡梅尔=目的城市, 早上=出发时间, 云林=出发城市}	特定行程方式下的路线
今天从阿洛陶到圣莫尼卡的航班有哪些	{今天=出发时间, 圣莫尼卡=目的城市, 阿洛陶=出发城市}	特定行程方式下的路线
后天从沙美岛到基督城的航班有哪些	{后天=出发时间, 沙美岛=出发城市, 基督城=目的城市}	特定行程方式下的路线
早上从隆德到捷克布杰约维采的航班有哪些	{隆德=出发城市, 捷克布杰约维采=目的城市, 早上=出发时间}	特定行程方式下的路线
今天从台东到圣路易奥比斯波的航班有哪些	{今天=出发时间, 台东=出发城市, 圣路易奥比斯波=目的城市}	特定行程方式下的路线
后天从美瑛到赫尔辛堡的航班有哪些	{后天=出发时间, 美瑛=出发城市, 赫尔辛堡=目的城市}	特定行程方式下的路线
早上从阿威罗到赫尔辛格的航班有哪些	{阿威罗=出发城市, 早上=出发时间, 赫尔辛格=目的城市}	特定行程方式下的路线
早上从白马市到纳克索斯的航班有哪些	{白马市=出发城市, 早上=出发时间, 纳克索斯=目的城市}	特定行程方式下的路线
今天从马特鲁到阿纳帕的航班有哪些	{阿纳帕=目的城市, 今天=出发时间, 马特鲁=出发城市}	特定行程方式下的路线
下午从马当到阿拉梅达的航班有哪些	{下午=出发时间, 马当=出发城市, 阿拉梅达=目的城市}	特定行程方式下的路线
上午从龙仁市到南极半岛的航班有哪些	{上午=出发时间, 南极半岛=目的城市, 龙仁市=出发城市}	特定行程方式下的路线
明天从代尔夫特到拉什特的航班有哪些	{明天=出发时间, 代尔夫特=出发城市, 拉什特=目的城市}	特定行程方式下的路线
11点从坡州到巴德伊舍的航班有哪些	{巴德伊舍=目的城市, 坡州=出发城市, 11点=出发时间}	特定行程方式下的路线
下午3点从西西里岛到晋州市的航班有哪些	{下午3点=出发时间, 晋州市=目的城市, 西西里岛=出发城市}	特定行程方式下的路线
明天从阿瓦诺斯到首尔的航班有哪些	{明天=出发时间, 阿瓦诺斯=出发城市, 首尔=目的城市}	特定行程方式下的路线
下午从科莫到沃斯的航班有哪些	{沃斯=目的城市, 下午=出发时间, 科莫=出发城市}	特定行程方式下的路线
下午从拉瓦格到坦佩雷的航班有哪些	{下午=出发时间, 坦佩雷=目的城市, 拉瓦格=出发城市}	特定行程方式下的路线
明天从撒丁岛到基拉尼的航班有哪些	{明天=出发时间, 基拉尼=目的城市, 撒丁岛=出发城市}	特定行程方式下的路线
本周从阿尔布费拉到第戎的航班有哪些	{本周=出发时间, 阿尔布费拉=出发城市, 第戎=目的城市}	特定行程方式下的路线
今天从谢菲尔德到奥克兰的航班有哪些	{奥克兰=目的城市, 今天=出发时间, 谢菲尔德=出发城市}	特定行程方式下的路线
后天从锡吉里耶到吉马良斯的航班有哪些	{后天=出发时间, 吉马良斯=目的城市, 锡吉里耶=出发城市}	特定行程方式下的路线
明天从塔哈岛到皇后镇的航班有哪些	{塔哈岛=出发城市, 明天=出发时间, 皇后镇=目的城市}	特定行程方式下的路线
后天从巴德伊舍到加勒的航班有哪些	{巴德伊舍=出发城市, 后天=出发时间, 加勒=目的城市}	特定行程方式下的路线
早上从五渔村到阿卡的航班有哪些	{阿卡=目的城市, 五渔村=出发城市, 早上=出发时间}	特定行程方式下的路线
今天从赫尔辛堡到白沙瓦的航班有哪些	{白沙瓦=目的城市, 今天=出发时间, 赫尔辛堡=出发城市}	特定行程方式下的路线
早上从哥打巴鲁到阿克雷里的航班有哪些	{阿克雷里=目的城市, 早上=出发时间, 哥打巴鲁=出发城市}	特定行程方式下的路线
晚上从亭可马里到巴格达的航班有哪些	{亭可马里=出发城市, 巴格达=目的城市, 晚上=出发时间}	特定行程方式下的路线
11点从尼亚加拉瀑布城到艾图塔基的航班有哪些	{艾图塔基=目的城市, 11点=出发时间, 尼亚加拉瀑布城=出发城市}	特定行程方式下的路线
今天从长滩岛到箭镇的航班有哪些	{箭镇=目的城市, 今天=出发时间, 长滩岛=出发城市}	特定行程方式下的路线
晚上从苗栗到尼斯的航班有哪些	{苗栗=出发城市, 尼斯=目的城市, 晚上=出发时间}	特定行程方式下的路线
后天从海兰泡到沙迦的航班有哪些	{沙迦=目的城市, 后天=出发时间, 海兰泡=出发城市}	特定行程方式下的路线
明天从八打灵再也到波茨坦的航班有哪些	{明天=出发时间, 波茨坦=目的城市, 八打灵再也=出发城市}	特定行程方式下的路线
本周从纳夫普利翁到万荣的航班有哪些	{本周=出发时间, 纳夫普利翁=出发城市, 万荣=目的城市}	特定行程方式下的路线
下午3点从大城到米伦的航班有哪些	{下午3点=出发时间, 大城=出发城市, 米伦=目的城市}	特定行程方式下的路线
下午从巴勒莫到西雅图的航班有哪些	{下午=出发时间, 巴勒莫=出发城市, 西雅图=目的城市}	特定行程方式下的路线
上午从白沙瓦到毛里求斯的航班有哪些	{白沙瓦=出发城市, 毛里求斯=目的城市, 上午=出发时间}	特定行程方式下的路线
今天从格林诺奇到拉哈尔的航班有哪些	{格林诺奇=出发城市, 今天=出发时间, 拉哈尔=目的城市}	特定行程方式下的路线
本周从阿雷基帕到丽水的航班有哪些	{本周=出发时间, 阿雷基帕=出发城市, 丽水=目的城市}	特定行程方式下的路线
上午从圣何塞到大溪地的航班有哪些	{大溪地=目的城市, 上午=出发时间, 圣何塞=出发城市}	特定行程方式下的路线
上午从帕拉阿图到春蓬的航班有哪些	{上午=出发时间, 帕拉阿图=出发城市, 春蓬=目的城市}	特定行程方式下的路线
早上从辛特拉到赖扬的航班有哪些	{辛特拉=出发城市, 赖扬=目的城市, 早上=出发时间}	特定行程方式下的路线
早上从罗什平纳到萨斯费的航班有哪些	{早上=出发时间, 萨斯费=目的城市, 罗什平纳=出发城市}	特定行程方式下的路线
明天从林茨到那不勒斯的航班有哪些	{明天=出发时间, 那不勒斯=目的城市, 林茨=出发城市}	特定行程方式下的路线
下午3点从莱比锡到霍基蒂卡的航班有哪些	{下午3点=出发时间, 莱比锡=出发城市, 霍基蒂卡=目的城市}	特定行程方式下的路线
早上从喀山到塔拉戈纳的航班有哪些	{塔拉戈纳=目的城市, 喀山=出发城市, 早上=出发时间}	特定行程方式下的路线
今天从弗雷斯诺到大田的航班有哪些	{大田=目的城市, 今天=出发时间, 弗雷斯诺=出发城市}	特定行程方式下的路线
本周从洛杉矶到伊拉克利翁的航班有哪些	{本周=出发时间, 伊拉克利翁=目的城市, 洛杉矶=出发城市}	特定行程方式下的路线
下午从基洛夫到卡梅尔的航班有哪些	{下午=出发时间, 卡梅尔=目的城市, 基洛夫=出发城市}	特定行程方式下的路线
下午3点从希欧福克到香港的航班有哪些	{下午3点=出发时间, 香港=目的城市, 希欧福克=出发城市}	特定行程方式下的路线
上午从提比里亚到棉兰的航班有哪些	{提比里亚=出发城市, 上午=出发时间, 棉兰=目的城市}	特定行程方式下的路线
后天从琅南塔到埃尔卡拉法特的航班有哪些	{后天=出发时间, 琅南塔=出发城市, 埃尔卡拉法特=目的城市}	特定行程方式下的路线
下午3点从库姆到卢加诺的航班有哪些	{下午3点=出发时间, 库姆=出发城市, 卢加诺=目的城市}	特定行程方式下的路线
本周从庞贝到纳夫普利翁的航班有哪些	{本周=出发时间, 纳夫普利翁=目的城市, 庞贝=出发城市}	特定行程方式下的路线
后天从巴东到彭措林的航班有哪些	{后天=出发时间, 巴东=出发城市, 彭措林=目的城市}	特定行程方式下的路线
明天从琅多到万荣的航班有哪些	{万荣=目的城市, 明天=出发时间, 琅多=出发城市}	特定行程方式下的路线
今天从金海市到普诺的航班有哪些	{普诺=目的城市, 今天=出发时间, 金海市=出发城市}	特定行程方式下的路线
上午从帕坦到日内瓦的航班有哪些	{上午=出发时间, 帕坦=出发城市, 日内瓦=目的城市}	特定行程方式下的路线
明天从莫皮蒂岛到巴淡岛的航班有哪些	{巴淡岛=目的城市, 莫皮蒂岛=出发城市, 明天=出发时间}	特定行程方式下的路线
下午3点从维谢格拉德到罗瓦涅米的航班有哪些	{下午3点=出发时间, 维谢格拉德=出发城市, 罗瓦涅米=目的城市}	特定行程方式下的路线
下午3点从安东到涛岛的航班有哪些	{下午3点=出发时间, 安东=出发城市, 涛岛=目的城市}	特定行程方式下的路线
上午从玛琅到拉彭兰塔的航班有哪些	{拉彭兰塔=目的城市, 玛琅=出发城市, 上午=出发时间}	特定行程方式下的路线
11点从蓝梦岛到延雪平的航班有哪些	{11点=出发时间, 延雪平=目的城市, 蓝梦岛=出发城市}	特定行程方式下的路线
下午3点从束草到特罗姆瑟的航班有哪些	{下午3点=出发时间, 特罗姆瑟=目的城市, 束草=出发城市}	特定行程方式下的路线
上午从登别到屏东的航班有哪些	{屏东=目的城市, 上午=出发时间, 登别=出发城市}	特定行程方式下的路线
明天从毛凯岛到恩格尔贝格的航班有哪些	{恩格尔贝格=目的城市, 明天=出发时间, 毛凯岛=出发城市}	特定行程方式下的路线
今天从新加坡到新北的航班有哪些	{今天=出发时间, 新加坡=出发城市, 新北=目的城市}	特定行程方式下的路线
今天从帕坦到霍基蒂卡的航班有哪些	{今天=出发时间, 霍基蒂卡=目的城市, 帕坦=出发城市}	特定行程方式下的路线
早上从圣克鲁斯到塞萨洛尼基的航班有哪些	{圣克鲁斯=出发城市, 塞萨洛尼基=目的城市, 早上=出发时间}	特定行程方式下的路线
下午3点从伊瓜苏市到基洛夫的航班有哪些	{下午3点=出发时间, 伊瓜苏市=出发城市, 基洛夫=目的城市}	特定行程方式下的路线
后天从罗萨里奥到瓦伊塔佩的航班有哪些	{后天=出发时间, 罗萨里奥=出发城市, 瓦伊塔佩=目的城市}	特定行程方式下的路线
后天从阿雷基帕到格林德瓦的航班有哪些	{后天=出发时间, 格林德瓦=目的城市, 阿雷基帕=出发城市}	特定行程方式下的路线
晚上从巴斯到哥德堡的航班有哪些	{巴斯=出发城市, 哥德堡=目的城市, 晚上=出发时间}	特定行程方式下的路线
11点从伊瓜苏港到达沃的航班有哪些	{达沃=目的城市, 伊瓜苏港=出发城市, 11点=出发时间}	特定行程方式下的路线
上午从龙目岛到加勒的航班有哪些	{龙目岛=出发城市, 上午=出发时间, 加勒=目的城市}	特定行程方式下的路线
下午从拜县到圣迭戈的航班有哪些	{下午=出发时间, 圣迭戈=目的城市, 拜县=出发城市}	特定行程方式下的路线
今天从南安普顿到番红花城的航班有哪些	{南安普顿=出发城市, 今天=出发时间, 番红花城=目的城市}	特定行程方式下的路线
11点从关丹到琅南塔的航班有哪些	{11点=出发时间, 关丹=出发城市, 琅南塔=目的城市}	特定行程方式下的路线
本周从萨尔茨堡到廷布的航班有哪些	{本周=出发时间, 廷布=目的城市, 萨尔茨堡=出发城市}	特定行程方式下的路线
今天从维多利亚市到第戎的航班有哪些	{维多利亚市=出发城市, 今天=出发时间, 第戎=目的城市}	特定行程方式下的路线
早上从罗得岛到约克的航班有哪些	{罗得岛=出发城市, 约克=目的城市, 早上=出发时间}	特定行程方式下的路线
上午从达沃斯到福森的航班有哪些	{福森=目的城市, 达沃斯=出发城市, 上午=出发时间}	特定行程方式下的路线
本周从希拉到小樽的航班有哪些	{本周=出发时间, 小樽=目的城市, 希拉=出发城市}	特定行程方式下的路线
下午从安特卫普到京都的航班有哪些	{下午=出发时间, 安特卫普=出发城市, 京都=目的城市}	特定行程方式下的路线
11点从华盛顿到素叻他尼的航班有哪些	{华盛顿=出发城市, 素叻他尼=目的城市, 11点=出发时间}	特定行程方式下的路线
11点从布达佩斯到库姆的航班有哪些	{布达佩斯=出发城市, 11点=出发时间, 库姆=目的城市}	特定行程方式下的路线
下午从夏蒙尼到北碧府的航班有哪些	{下午=出发时间, 北碧府=目的城市, 夏蒙尼=出发城市}	特定行程方式下的路线
上午从利斯特维扬卡到指宿市的航班有哪些	{利斯特维扬卡=出发城市, 指宿市=目的城市, 上午=出发时间}	特定行程方式下的路线
后天从隆德到巴生的航班有哪些	{巴生=目的城市, 后天=出发时间, 隆德=出发城市}	特定行程方式下的路线
上午从乌斯怀亚到北京的航班有哪些	{上午=出发时间, 乌斯怀亚=出发城市, 北京=目的城市}	特定行程方式下的路线
明天从爱丁堡到瓦伊塔佩的航班有哪些	{明天=出发时间, 爱丁堡=出发城市, 瓦伊塔佩=目的城市}	特定行程方式下的路线
今天从格雷茅斯到坦佩雷的航班有哪些	{今天=出发时间, 坦佩雷=目的城市, 格雷茅斯=出发城市}	特定行程方式下的路线
早上从伊卡到采法特的航班有哪些	{采法特=目的城市, 早上=出发时间, 伊卡=出发城市}	特定行程方式下的路线
11点从布鲁塞尔到锡基霍尔的航班有哪些	{布鲁塞尔=出发城市, 锡基霍尔=目的城市, 11点=出发时间}	特定行程方式下的路线
今天从巴色到依云的航班有哪些	{巴色=出发城市, 今天=出发时间, 依云=目的城市}	特定行程方式下的路线
晚上从圣路易奥比斯波到北碧府的航班有哪些	{圣路易奥比斯波=出发城市, 北碧府=目的城市, 晚上=出发时间}	特定行程方式下的路线
后天从卡塔赫纳到艾图塔基的航班有哪些	{后天=出发时间, 艾图塔基=目的城市, 卡塔赫纳=出发城市}	特定行程方式下的路线
下午3点从罗瓦涅米到巴斯的航班有哪些	{下午3点=出发时间, 巴斯=目的城市, 罗瓦涅米=出发城市}	特定行程方式下的路线
上午从贝尼多姆到旭川的航班有哪些	{贝尼多姆=出发城市, 上午=出发时间, 旭川=目的城市}	特定行程方式下的路线
下午3点从艾图塔基到京都的航班有哪些	{下午3点=出发时间, 艾图塔基=出发城市, 京都=目的城市}	特定行程方式下的路线
下午从埼玉到玛瑙斯市的航班有哪些	{下午=出发时间, 埼玉=出发城市, 玛瑙斯市=目的城市}	特定行程方式下的路线
早上有从法尤姆到威尼斯的飞机吗	{法尤姆=出发城市, 威尼斯=目的城市, 早上=出发时间}	特定行程方式下的路线
下午3点有从罗腾堡到涛岛的飞机吗	{下午3点=出发时间, 罗腾堡=出发城市, 涛岛=目的城市}	特定行程方式下的路线
早上有从密西沙加到圣莫里茨的飞机吗	{圣莫里茨=目的城市, 密西沙加=出发城市, 早上=出发时间}	特定行程方式下的路线
下午有从长崎到巴拉望的飞机吗	{下午=出发时间, 巴拉望=目的城市, 长崎=出发城市}	特定行程方式下的路线
上午有从萨斯卡通到维尔茨堡的飞机吗	{维尔茨堡=目的城市, 上午=出发时间, 萨斯卡通=出发城市}	特定行程方式下的路线
晚上有从累西腓到维罗纳的飞机吗	{累西腓=出发城市, 晚上=出发时间, 维罗纳=目的城市}	特定行程方式下的路线
11点有从图恩到阿拉梅达的飞机吗	{图恩=出发城市, 11点=出发时间, 阿拉梅达=目的城市}	特定行程方式下的路线
下午有从乌得勒支到拉斯帕尔马斯的飞机吗	{乌得勒支=出发城市, 下午=出发时间, 拉斯帕尔马斯=目的城市}	特定行程方式下的路线
上午有从象岛到名古屋的飞机吗	{名古屋=目的城市, 上午=出发时间, 象岛=出发城市}	特定行程方式下的路线
今天有从米伦到因斯布鲁克的飞机吗	{今天=出发时间, 因斯布鲁克=目的城市, 米伦=出发城市}	特定行程方式下的路线
下午3点有从拉什特到高山的飞机吗	{下午3点=出发时间, 高山=目的城市, 拉什特=出发城市}	特定行程方式下的路线
晚上有从吉达到特拉维夫的飞机吗	{晚上=出发时间, 特拉维夫=目的城市, 吉达=出发城市}	特定行程方式下的路线
今天有从董里到东枝的飞机吗	{今天=出发时间, 东枝=目的城市, 董里=出发城市}	特定行程方式下的路线
今天有从南安普顿到吉马良斯的飞机吗	{吉马良斯=目的城市, 南安普顿=出发城市, 今天=出发时间}	特定行程方式下的路线
明天有从华欣到纳加阔特的飞机吗	{纳加阔特=目的城市, 明天=出发时间, 华欣=出发城市}	特定行程方式下的路线
下午有从伊豆到达沃的飞机吗	{下午=出发时间, 达沃=目的城市, 伊豆=出发城市}	特定行程方式下的路线
下午有从滑铁卢到台中的飞机吗	{滑铁卢=出发城市, 下午=出发时间, 台中=目的城市}	特定行程方式下的路线
11点有从高威到乌布的飞机吗	{11点=出发时间, 高威=出发城市, 乌布=目的城市}	特定行程方式下的路线
晚上有从拉彭兰塔到阿纳帕的飞机吗	{拉彭兰塔=出发城市, 阿纳帕=目的城市, 晚上=出发时间}	特定行程方式下的路线
11点有从鲁汶到科尔多瓦的飞机吗	{鲁汶=出发城市, 11点=出发时间, 科尔多瓦=目的城市}	特定行程方式下的路线
11点有从蒙彼利埃到吉大港的飞机吗	{吉大港=目的城市, 11点=出发时间, 蒙彼利埃=出发城市}	特定行程方式下的路线
早上有从圣莫尼卡到汉密尔顿的飞机吗	{汉密尔顿=目的城市, 圣莫尼卡=出发城市, 早上=出发时间}	特定行程方式下的路线
下午有从卡塔赫纳到福伦丹的飞机吗	{福伦丹=目的城市, 下午=出发时间, 卡塔赫纳=出发城市}	特定行程方式下的路线
后天有从番红花城到维多利亚的飞机吗	{后天=出发时间, 维多利亚=目的城市, 番红花城=出发城市}	特定行程方式下的路线
晚上有从布鲁日到贝尔法斯特的飞机吗	{布鲁日=出发城市, 贝尔法斯特=目的城市, 晚上=出发时间}	特定行程方式下的路线
下午有从巴厘岛到加德满都的飞机吗	{下午=出发时间, 加德满都=目的城市, 巴厘岛=出发城市}	特定行程方式下的路线
本周有从埃斯波到马拉加的飞机吗	{本周=出发时间, 埃斯波=出发城市, 马拉加=目的城市}	特定行程方式下的路线
下午有从斯图加特到华富里的飞机吗	{斯图加特=出发城市, 下午=出发时间, 华富里=目的城市}	特定行程方式下的路线
下午3点有从素叻他尼到埃尔卡拉法特的飞机吗	{下午3点=出发时间, 素叻他尼=出发城市, 埃尔卡拉法特=目的城市}	特定行程方式下的路线
早上有从巴勒莫到哈瑟尔特的飞机吗	{巴勒莫=出发城市, 哈瑟尔特=目的城市, 早上=出发时间}	特定行程方式下的路线
本周有从马当到兹沃勒的飞机吗	{本周=出发时间, 马当=出发城市, 兹沃勒=目的城市}	特定行程方式下的路线
晚上有从巴德伊舍到法兰克福的飞机吗	{巴德伊舍=出发城市, 法兰克福=目的城市, 晚上=出发时间}	特定行程方式下的路线
今天有从耶路撒冷到莱城的飞机吗	{今天=出发时间, 耶路撒冷=出发城市, 莱城=目的城市}	特定行程方式下的路线
下午有从嘉义到赫尔辛基的飞机吗	{下午=出发时间, 嘉义=出发城市, 赫尔辛基=目的城市}	特定行程方式下的路线
后天有从苏兹达尔到瓜拉登嘉楼的飞机吗	{瓜拉登嘉楼=目的城市, 后天=出发时间, 苏兹达尔=出发城市}	特定行程方式下的路线
下午3点有从科英布拉到蒙达的飞机吗	{下午3点=出发时间, 科英布拉=出发城市, 蒙达=目的城市}	特定行程方式下的路线
后天有从堪培拉到格蒙登的飞机吗	{后天=出发时间, 格蒙登=目的城市, 堪培拉=出发城市}	特定行程方式下的路线
明天有从吉萨到曼德勒的飞机吗	{吉萨=出发城市, 明天=出发时间, 曼德勒=目的城市}	特定行程方式下的路线
下午有从里约热内卢到圣莫尼卡的飞机吗	{下午=出发时间, 圣莫尼卡=目的城市, 里约热内卢=出发城市}	特定行程方式下的路线
本周有从罗托鲁瓦到克拉根福的飞机吗	{本周=出发时间, 克拉根福=目的城市, 罗托鲁瓦=出发城市}	特定行程方式下的路线
明天有从静冈到渥太华的飞机吗	{渥太华=目的城市, 明天=出发时间, 静冈=出发城市}	特定行程方式下的路线
下午3点有从苏梅岛到奥克兰的飞机吗	{下午3点=出发时间, 奥克兰=目的城市, 苏梅岛=出发城市}	特定行程方式下的路线
明天有从旧金山到河内的飞机吗	{明天=出发时间, 旧金山=出发城市, 河内=目的城市}	特定行程方式下的路线
下午3点有从兰达岛到沃特福德的飞机吗	{下午3点=出发时间, 兰达岛=出发城市, 沃特福德=目的城市}	特定行程方式下的路线
本周有从蒂阿瑙到帕岸岛的飞机吗	{本周=出发时间, 帕岸岛=目的城市, 蒂阿瑙=出发城市}	特定行程方式下的路线
下午有从奥兰多到瓦纳卡的飞机吗	{瓦纳卡=目的城市, 下午=出发时间, 奥兰多=出发城市}	特定行程方式下的路线
下午有从乌鲁班巴到施皮茨的飞机吗	{下午=出发时间, 施皮茨=目的城市, 乌鲁班巴=出发城市}	特定行程方式下的路线
明天有从道格拉斯港到坎莫尔的飞机吗	{明天=出发时间, 道格拉斯港=出发城市, 坎莫尔=目的城市}	特定行程方式下的路线
本周有从圣塞瓦斯蒂安到蒙达的飞机吗	{本周=出发时间, 圣塞瓦斯蒂安=出发城市, 蒙达=目的城市}	特定行程方式下的路线
早上有从鲁汶到恩格尔贝格的飞机吗	{恩格尔贝格=目的城市, 鲁汶=出发城市, 早上=出发时间}	特定行程方式下的路线
今天有从阿维尼翁到巴黎的飞机吗	{巴黎=目的城市, 今天=出发时间, 阿维尼翁=出发城市}	特定行程方式下的路线
今天有从多哈到都灵的飞机吗	{多哈=出发城市, 今天=出发时间, 都灵=目的城市}	特定行程方式下的路线
明天有从白马市到罗什平纳的飞机吗	{明天=出发时间, 白马市=出发城市, 罗什平纳=目的城市}	特定行程方式下的路线
后天有从热那亚到伊斯梅利亚的飞机吗	{后天=出发时间, 伊斯梅利亚=目的城市, 热那亚=出发城市}	特定行程方式下的路线
明天有从雅加达到贝特默阿尔卑的飞机吗	{贝特默阿尔卑=目的城市, 雅加达=出发城市, 明天=出发时间}	特定行程方式下的路线
后天有从岘港到安吉利斯的飞机吗	{后天=出发时间, 安吉利斯=目的城市, 岘港=出发城市}	特定行程方式下的路线
11点有从塞哥维亚到道格拉斯港的飞机吗	{塞哥维亚=出发城市, 11点=出发时间, 道格拉斯港=目的城市}	特定行程方式下的路线
后天有从第戎到姬路的飞机吗	{后天=出发时间, 姬路=目的城市, 第戎=出发城市}	特定行程方式下的路线
11点有从采尔马特到凯萨莉亚的飞机吗	{凯萨莉亚=目的城市, 11点=出发时间, 采尔马特=出发城市}	特定行程方式下的路线
上午有从阿罗萨到巴德伊舍的飞机吗	{巴德伊舍=目的城市, 阿罗萨=出发城市, 上午=出发时间}	特定行程方式下的路线
今天有从宫崎市到赫本的飞机吗	{赫本=目的城市, 今天=出发时间, 宫崎市=出发城市}	特定行程方式下的路线
下午3点有从贝尔法斯特到迈阿密的飞机吗	{下午3点=出发时间, 迈阿密=目的城市, 贝尔法斯特=出发城市}	特定行程方式下的路线
后天有从库斯科到利贝雷茨的飞机吗	{后天=出发时间, 利贝雷茨=目的城市, 库斯科=出发城市}	特定行程方式下的路线
今天有从延雪平到耶路撒冷的飞机吗	{今天=出发时间, 耶路撒冷=目的城市, 延雪平=出发城市}	特定行程方式下的路线
上午有从伊纳里到圣地亚哥的飞机吗	{圣地亚哥=目的城市, 上午=出发时间, 伊纳里=出发城市}	特定行程方式下的路线
今天有从南投到京都的飞机吗	{南投=出发城市, 今天=出发时间, 京都=目的城市}	特定行程方式下的路线
今天有从阿尔布费拉到斯德哥尔摩的飞机吗	{阿尔布费拉=出发城市, 今天=出发时间, 斯德哥尔摩=目的城市}	特定行程方式下的路线
今天有从吉达到福伦丹的飞机吗	{福伦丹=目的城市, 今天=出发时间, 吉达=出发城市}	特定行程方式下的路线
今天有从克拉斯诺达尔到卡塔尼亚的飞机吗	{克拉斯诺达尔=出发城市, 今天=出发时间, 卡塔尼亚=目的城市}	特定行程方式下的路线
11点有从哥德堡到美因茨的飞机吗	{哥德堡=出发城市, 11点=出发时间, 美因茨=目的城市}	特定行程方式下的路线
上午有从恩格尔贝格到海法的飞机吗	{海法=目的城市, 恩格尔贝格=出发城市, 上午=出发时间}	特定行程方式下的路线
下午有从黑维兹到霍基蒂卡的飞机吗	{下午=出发时间, 黑维兹=出发城市, 霍基蒂卡=目的城市}	特定行程方式下的路线
明天有从佐贺到维罗纳的飞机吗	{佐贺=出发城市, 明天=出发时间, 维罗纳=目的城市}	特定行程方式下的路线
本周有从库奥皮奥到卢塞恩的飞机吗	{本周=出发时间, 库奥皮奥=出发城市, 卢塞恩=目的城市}	特定行程方式下的路线
明天有从卢卡拉到束草的飞机吗	{明天=出发时间, 束草=目的城市, 卢卡拉=出发城市}	特定行程方式下的路线
今天有从高松到摩尔曼斯克的飞机吗	{高松=出发城市, 今天=出发时间, 摩尔曼斯克=目的城市}	特定行程方式下的路线
早上有从贝尼多姆到阿尔勒的飞机吗	{贝尼多姆=出发城市, 阿尔勒=目的城市, 早上=出发时间}	特定行程方式下的路线
11点有从格雷茅斯到摩尔曼斯克的飞机吗	{11点=出发时间, 格雷茅斯=出发城市, 摩尔曼斯克=目的城市}	特定行程方式下的路线
下午3点有从拜伦湾到巴勒莫的飞机吗	{下午3点=出发时间, 巴勒莫=目的城市, 拜伦湾=出发城市}	特定行程方式下的路线
11点有从英国湖区到萨尔茨堡的飞机吗	{11点=出发时间, 萨尔茨堡=目的城市, 英国湖区=出发城市}	特定行程方式下的路线
本周有从捷克布杰约维采到城南市的飞机吗	{本周=出发时间, 捷克布杰约维采=出发城市, 城南市=目的城市}	特定行程方式下的路线
今天有从堪培拉到董里的飞机吗	{今天=出发时间, 董里=目的城市, 堪培拉=出发城市}	特定行程方式下的路线
11点有从巴德伊舍到海参崴的飞机吗	{巴德伊舍=出发城市, 11点=出发时间, 海参崴=目的城市}	特定行程方式下的路线
11点有从济州岛到布里斯班的飞机吗	{11点=出发时间, 布里斯班=目的城市, 济州岛=出发城市}	特定行程方式下的路线
晚上有从金斯顿到沙美岛的飞机吗	{金斯顿=出发城市, 沙美岛=目的城市, 晚上=出发时间}	特定行程方式下的路线
早上有从马丘比丘到谢菲尔德的飞机吗	{马丘比丘=出发城市, 早上=出发时间, 谢菲尔德=目的城市}	特定行程方式下的路线
晚上有从滑铁卢到马赛马拉的飞机吗	{滑铁卢=出发城市, 马赛马拉=目的城市, 晚上=出发时间}	特定行程方式下的路线
上午有从卢卡拉到台中的飞机吗	{上午=出发时间, 台中=目的城市, 卢卡拉=出发城市}	特定行程方式下的路线
11点有从钏路到新不列颠岛的飞机吗	{钏路=出发城市, 新不列颠岛=目的城市, 11点=出发时间}	特定行程方式下的路线
上午有从塞维利亚到阿姆斯特丹的飞机吗	{阿姆斯特丹=目的城市, 塞维利亚=出发城市, 上午=出发时间}	特定行程方式下的路线
明天有从曼谷到麦地那的飞机吗	{曼谷=出发城市, 明天=出发时间, 麦地那=目的城市}	特定行程方式下的路线
11点有从皮皮岛到马贝拉的飞机吗	{皮皮岛=出发城市, 11点=出发时间, 马贝拉=目的城市}	特定行程方式下的路线
今天有从和歌山到挪日利亚的飞机吗	{挪日利亚=目的城市, 今天=出发时间, 和歌山=出发城市}	特定行程方式下的路线
早上有从沙努尔到麦地那的飞机吗	{沙努尔=出发城市, 麦地那=目的城市, 早上=出发时间}	特定行程方式下的路线
下午3点有从庆州到美里的飞机吗	{下午3点=出发时间, 庆州=出发城市, 美里=目的城市}	特定行程方式下的路线
下午有从奥洛穆茨到克里特岛的飞机吗	{奥洛穆茨=出发城市, 下午=出发时间, 克里特岛=目的城市}	特定行程方式下的路线
晚上有从奥斯坦德到埃斯波的飞机吗	{奥斯坦德=出发城市, 埃斯波=目的城市, 晚上=出发时间}	特定行程方式下的路线
本周有从萨尔茨堡到普罗旺斯的飞机吗	{本周=出发时间, 普罗旺斯=目的城市, 萨尔茨堡=出发城市}	特定行程方式下的路线
今天有从菲拉赫到捷克布杰约维采的飞机吗	{今天=出发时间, 捷克布杰约维采=目的城市, 菲拉赫=出发城市}	特定行程方式下的路线
早上有从埃尔卡拉法特到鹿特丹的飞机吗	{早上=出发时间, 鹿特丹=目的城市, 埃尔卡拉法特=出发城市}	特定行程方式下的路线
早上从纳哈里亚飞到普罗旺斯的航班有哪些	{普罗旺斯=目的城市, 纳哈里亚=出发城市, 早上=出发时间}	特定行程方式下的路线
后天从尔湾飞到新北的航班有哪些	{后天=出发时间, 尔湾=出发城市, 新北=目的城市}	特定行程方式下的路线
11点从博拉博拉岛飞到吉萨的航班有哪些	{吉萨=目的城市, 11点=出发时间, 博拉博拉岛=出发城市}	特定行程方式下的路线
上午从塔拉戈纳飞到贝尔马尔的航班有哪些	{塔拉戈纳=出发城市, 上午=出发时间, 贝尔马尔=目的城市}	特定行程方式下的路线
11点从帕斯托飞到圣何塞的航班有哪些	{帕斯托=出发城市, 11点=出发时间, 圣何塞=目的城市}	特定行程方式下的路线
本周从沙迦飞到高松的航班有哪些	{本周=出发时间, 沙迦=出发城市, 高松=目的城市}	特定行程方式下的路线
早上从杰尔飞到基隆的航班有哪些	{基隆=目的城市, 杰尔=出发城市, 早上=出发时间}	特定行程方式下的路线
本周从布里斯班飞到魁北克市的航班有哪些	{本周=出发时间, 魁北克市=目的城市, 布里斯班=出发城市}	特定行程方式下的路线
下午从米湖飞到美因茨的航班有哪些	{下午=出发时间, 米湖=出发城市, 美因茨=目的城市}	特定行程方式下的路线
上午从卑尔根飞到富良野的航班有哪些	{卑尔根=出发城市, 富良野=目的城市, 上午=出发时间}	特定行程方式下的路线
下午3点从萨法加飞到锡瓦绿洲的航班有哪些	{下午3点=出发时间, 锡瓦绿洲=目的城市, 萨法加=出发城市}	特定行程方式下的路线
下午3点从都柏林飞到丰沙尔的航班有哪些	{下午3点=出发时间, 都柏林=出发城市, 丰沙尔=目的城市}	特定行程方式下的路线
11点从皮皮岛飞到布尔诺的航班有哪些	{布尔诺=目的城市, 皮皮岛=出发城市, 11点=出发时间}	特定行程方式下的路线
下午从斯帕飞到贾夫纳的航班有哪些	{下午=出发时间, 斯帕=出发城市, 贾夫纳=目的城市}	特定行程方式下的路线
早上从巴色飞到蒙特利尔的航班有哪些	{巴色=出发城市, 蒙特利尔=目的城市, 早上=出发时间}	特定行程方式下的路线
今天从合艾飞到波茨坦的航班有哪些	{今天=出发时间, 波茨坦=目的城市, 合艾=出发城市}	特定行程方式下的路线
下午从雷斯蒙飞到尼尔森的航班有哪些	{雷斯蒙=出发城市, 尼尔森=目的城市, 下午=出发时间}	特定行程方式下的路线
明天从塞得港飞到埃德蒙顿的航班有哪些	{塞得港=出发城市, 埃德蒙顿=目的城市, 明天=出发时间}	特定行程方式下的路线
上午从特隆赫姆飞到大阪的航班有哪些	{上午=出发时间, 特隆赫姆=出发城市, 大阪=目的城市}	特定行程方式下的路线
11点从美奈飞到涛岛的航班有哪些	{美奈=出发城市, 11点=出发时间, 涛岛=目的城市}	特定行程方式下的路线
早上从德累斯顿飞到托莱多的航班有哪些	{托莱多=目的城市, 早上=出发时间, 德累斯顿=出发城市}	特定行程方式下的路线
11点从吉马良斯飞到董里的航班有哪些	{吉马良斯=出发城市, 11点=出发时间, 董里=目的城市}	特定行程方式下的路线
明天从圣地亚哥飞到甲米的航班有哪些	{圣地亚哥=出发城市, 明天=出发时间, 甲米=目的城市}	特定行程方式下的路线
早上从维亚纳堡飞到拉彭兰塔的航班有哪些	{拉彭兰塔=目的城市, 维亚纳堡=出发城市, 早上=出发时间}	特定行程方式下的路线
下午3点从帕萨迪纳飞到新加坡的航班有哪些	{下午3点=出发时间, 新加坡=目的城市, 帕萨迪纳=出发城市}	特定行程方式下的路线
后天从夜丰颂飞到济州岛的航班有哪些	{后天=出发时间, 夜丰颂=出发城市, 济州岛=目的城市}	特定行程方式下的路线
11点从希欧福克飞到麦加的航班有哪些	{希欧福克=出发城市, 11点=出发时间, 麦加=目的城市}	特定行程方式下的路线
今天从托马尔飞到奥卢的航班有哪些	{托马尔=出发城市, 今天=出发时间, 奥卢=目的城市}	特定行程方式下的路线
明天从戈公飞到琅勃拉邦的航班有哪些	{明天=出发时间, 戈公=出发城市, 琅勃拉邦=目的城市}	特定行程方式下的路线
早上从圣何塞飞到施皮茨的航班有哪些	{施皮茨=目的城市, 早上=出发时间, 圣何塞=出发城市}	特定行程方式下的路线
今天从莱比锡飞到淡水的航班有哪些	{莱比锡=出发城市, 今天=出发时间, 淡水=目的城市}	特定行程方式下的路线
下午从克拉克飞到贝克斯菲尔德的航班有哪些	{克拉克=出发城市, 下午=出发时间, 贝克斯菲尔德=目的城市}	特定行程方式下的路线
明天从棉花堡飞到伊拉克利翁的航班有哪些	{棉花堡=出发城市, 伊拉克利翁=目的城市, 明天=出发时间}	特定行程方式下的路线
11点从泰尔奇飞到知床半岛的航班有哪些	{泰尔奇=出发城市, 11点=出发时间, 知床半岛=目的城市}	特定行程方式下的路线
上午从羊角村飞到圣吉米尼亚诺的航班有哪些	{羊角村=出发城市, 上午=出发时间, 圣吉米尼亚诺=目的城市}	特定行程方式下的路线
下午3点从波蓬德塔飞到伊兹密尔的航班有哪些	{下午3点=出发时间, 伊兹密尔=目的城市, 波蓬德塔=出发城市}	特定行程方式下的路线
下午从根特飞到尼甘布的航班有哪些	{下午=出发时间, 根特=出发城市, 尼甘布=目的城市}	特定行程方式下的路线
11点从万隆飞到列日的航班有哪些	{列日=目的城市, 万隆=出发城市, 11点=出发时间}	特定行程方式下的路线
下午从蓝毗尼飞到科克斯巴扎尔的航班有哪些	{蓝毗尼=出发城市, 下午=出发时间, 科克斯巴扎尔=目的城市}	特定行程方式下的路线
今天从金边飞到恩纳的航班有哪些	{今天=出发时间, 恩纳=目的城市, 金边=出发城市}	特定行程方式下的路线
本周从苏伊士飞到攀牙的航班有哪些	{本周=出发时间, 苏伊士=出发城市, 攀牙=目的城市}	特定行程方式下的路线
下午从努韦巴飞到萨斯卡通的航班有哪些	{努韦巴=出发城市, 下午=出发时间, 萨斯卡通=目的城市}	特定行程方式下的路线
后天从新竹飞到圣加仑的航班有哪些	{后天=出发时间, 新竹=出发城市, 圣加仑=目的城市}	特定行程方式下的路线
早上从佐贺飞到千叶市的航班有哪些	{佐贺=出发城市, 千叶市=目的城市, 早上=出发时间}	特定行程方式下的路线
下午从德累斯顿飞到厄吕代尼兹的航班有哪些	{厄吕代尼兹=目的城市, 下午=出发时间, 德累斯顿=出发城市}	特定行程方式下的路线
后天从亚琛飞到门多萨的航班有哪些	{后天=出发时间, 亚琛=出发城市, 门多萨=目的城市}	特定行程方式下的路线
后天从丰沙尔飞到利物浦的航班有哪些	{后天=出发时间, 利物浦=目的城市, 丰沙尔=出发城市}	特定行程方式下的路线
明天从尼甘布飞到马卡蒂的航班有哪些	{马卡蒂=目的城市, 明天=出发时间, 尼甘布=出发城市}	特定行程方式下的路线
11点从斯蒂基斯霍尔米飞到维亚纳堡的航班有哪些	{斯蒂基斯霍尔米=出发城市, 11点=出发时间, 维亚纳堡=目的城市}	特定行程方式下的路线
晚上从卡普里岛飞到恩戈地的航班有哪些	{卡普里岛=出发城市, 恩戈地=目的城市, 晚上=出发时间}	特定行程方式下的路线
明天从多哈飞到赫达的航班有哪些	{赫达=目的城市, 多哈=出发城市, 明天=出发时间}	特定行程方式下的路线
下午从热浪岛飞到牛津的航班有哪些	{下午=出发时间, 牛津=目的城市, 热浪岛=出发城市}	特定行程方式下的路线
下午3点从阿维拉飞到海兰泡的航班有哪些	{下午3点=出发时间, 阿维拉=出发城市, 海兰泡=目的城市}	特定行程方式下的路线
下午3点从蒂卡普湖飞到萨斯费的航班有哪些	{下午3点=出发时间, 蒂卡普湖=出发城市, 萨斯费=目的城市}	特定行程方式下的路线
早上从凯夫拉维克飞到科莫的航班有哪些	{科莫=目的城市, 凯夫拉维克=出发城市, 早上=出发时间}	特定行程方式下的路线
今天从伊势飞到索伦托的航班有哪些	{今天=出发时间, 索伦托=目的城市, 伊势=出发城市}	特定行程方式下的路线
后天从莫斯科飞到索伦托的航班有哪些	{后天=出发时间, 莫斯科=出发城市, 索伦托=目的城市}	特定行程方式下的路线
今天从布里斯班飞到塔维拉的航班有哪些	{塔维拉=目的城市, 今天=出发时间, 布里斯班=出发城市}	特定行程方式下的路线
本周从萨法加飞到圣莫里茨的航班有哪些	{本周=出发时间, 圣莫里茨=目的城市, 萨法加=出发城市}	特定行程方式下的路线
今天从利雅得飞到波茨坦的航班有哪些	{今天=出发时间, 波茨坦=目的城市, 利雅得=出发城市}	特定行程方式下的路线
11点从特隆赫姆飞到格拉纳达的航班有哪些	{特隆赫姆=出发城市, 11点=出发时间, 格拉纳达=目的城市}	特定行程方式下的路线
11点从高威飞到温哥华的航班有哪些	{11点=出发时间, 高威=出发城市, 温哥华=目的城市}	特定行程方式下的路线
后天从迪南飞到圣地亚哥-德孔波斯特拉的航班有哪些	{后天=出发时间, 圣地亚哥-德孔波斯特拉=目的城市, 迪南=出发城市}	特定行程方式下的路线
早上从羊角村飞到斗湖的航班有哪些	{斗湖=目的城市, 羊角村=出发城市, 早上=出发时间}	特定行程方式下的路线
今天从汉堡飞到玛琅的航班有哪些	{玛琅=目的城市, 汉堡=出发城市, 今天=出发时间}	特定行程方式下的路线
晚上从列治文飞到伯明翰的航班有哪些	{列治文=出发城市, 伯明翰=目的城市, 晚上=出发时间}	特定行程方式下的路线
明天从波士顿飞到广岛的航班有哪些	{波士顿=出发城市, 明天=出发时间, 广岛=目的城市}	特定行程方式下的路线
晚上从埃兹飞到采尔马特的航班有哪些	{采尔马特=目的城市, 晚上=出发时间, 埃兹=出发城市}	特定行程方式下的路线
11点从布宜诺斯艾利斯飞到春武里府的航班有哪些	{春武里府=目的城市, 11点=出发时间, 布宜诺斯艾利斯=出发城市}	特定行程方式下的路线
11点从鲁尔蒙德飞到蒙达的航班有哪些	{蒙达=目的城市, 11点=出发时间, 鲁尔蒙德=出发城市}	特定行程方式下的路线
上午从布里斯班飞到赞丹的航班有哪些	{上午=出发时间, 赞丹=目的城市, 布里斯班=出发城市}	特定行程方式下的路线
上午从塞得港飞到斯德哥尔摩的航班有哪些	{塞得港=出发城市, 斯德哥尔摩=目的城市, 上午=出发时间}	特定行程方式下的路线
下午3点从洞爷湖飞到会晒的航班有哪些	{下午3点=出发时间, 会晒=目的城市, 洞爷湖=出发城市}	特定行程方式下的路线
今天从玛瑙斯市飞到下龙湾的航班有哪些	{今天=出发时间, 下龙湾=目的城市, 玛瑙斯市=出发城市}	特定行程方式下的路线
11点从蒂瑟默哈拉默飞到巴勒莫的航班有哪些	{蒂瑟默哈拉默=出发城市, 巴勒莫=目的城市, 11点=出发时间}	特定行程方式下的路线
下午从纳夫普利翁飞到亚历山大的航班有哪些	{纳夫普利翁=出发城市, 亚历山大=目的城市, 下午=出发时间}	特定行程方式下的路线
上午从阿拉梅达飞到大不里士的航班有哪些	{上午=出发时间, 大不里士=目的城市, 阿拉梅达=出发城市}	特定行程方式下的路线
下午3点从弗拉基米尔飞到德尔斐的航班有哪些	{下午3点=出发时间, 德尔斐=目的城市, 弗拉基米尔=出发城市}	特定行程方式下的路线
晚上从班贝格飞到戛纳的航班有哪些	{戛纳=目的城市, 班贝格=出发城市, 晚上=出发时间}	特定行程方式下的路线
上午从巴盖尔哈德飞到利马的航班有哪些	{巴盖尔哈德=出发城市, 上午=出发时间, 利马=目的城市}	特定行程方式下的路线
下午3点从纽约飞到西归浦的航班有哪些	{下午3点=出发时间, 西归浦=目的城市, 纽约=出发城市}	特定行程方式下的路线
下午3点从海法飞到日内瓦的航班有哪些	{下午3点=出发时间, 海法=出发城市, 日内瓦=目的城市}	特定行程方式下的路线
后天从垦丁飞到素可泰的航班有哪些	{后天=出发时间, 垦丁=出发城市, 素可泰=目的城市}	特定行程方式下的路线
本周从泗水飞到戈公的航班有哪些	{本周=出发时间, 泗水=出发城市, 戈公=目的城市}	特定行程方式下的路线
明天从拉姆拉飞到丹老的航班有哪些	{丹老=目的城市, 拉姆拉=出发城市, 明天=出发时间}	特定行程方式下的路线
今天从木尔坦飞到延雪平的航班有哪些	{木尔坦=出发城市, 今天=出发时间, 延雪平=目的城市}	特定行程方式下的路线
上午从多哈飞到罗勇的航班有哪些	{多哈=出发城市, 上午=出发时间, 罗勇=目的城市}	特定行程方式下的路线
11点从锡耶纳飞到苏拉哈的航班有哪些	{锡耶纳=出发城市, 11点=出发时间, 苏拉哈=目的城市}	特定行程方式下的路线
下午从贝特谢安飞到里斯本的航班有哪些	{下午=出发时间, 贝特谢安=出发城市, 里斯本=目的城市}	特定行程方式下的路线
今天从卡斯凯什飞到南池市场的航班有哪些	{卡斯凯什=出发城市, 南池市场=目的城市, 今天=出发时间}	特定行程方式下的路线
后天从纳克索斯飞到阿瓦诺斯的航班有哪些	{后天=出发时间, 阿瓦诺斯=目的城市, 纳克索斯=出发城市}	特定行程方式下的路线
下午3点从坎莫尔飞到邦劳的航班有哪些	{下午3点=出发时间, 邦劳=目的城市, 坎莫尔=出发城市}	特定行程方式下的路线
下午从亭可马里飞到恩格尔贝格的航班有哪些	{亭可马里=出发城市, 下午=出发时间, 恩格尔贝格=目的城市}	特定行程方式下的路线
下午3点从原州市飞到阿维拉的航班有哪些	{下午3点=出发时间, 原州市=出发城市, 阿维拉=目的城市}	特定行程方式下的路线
晚上从赫尔辛格飞到瓦伦西亚的航班有哪些	{瓦伦西亚=目的城市, 晚上=出发时间, 赫尔辛格=出发城市}	特定行程方式下的路线
下午从列治文飞到宜兰的航班有哪些	{列治文=出发城市, 下午=出发时间, 宜兰=目的城市}	特定行程方式下的路线
上午从帕岸岛飞到赫达的航班有哪些	{赫达=目的城市, 帕岸岛=出发城市, 上午=出发时间}	特定行程方式下的路线
本周从谢尔盖耶夫飞到兰达岛的航班有哪些	{本周=出发时间, 谢尔盖耶夫=出发城市, 兰达岛=目的城市}	特定行程方式下的路线
上午从法兰克福飞到长野的航班有哪些	{上午=出发时间, 法兰克福=出发城市, 长野=目的城市}	特定行程方式下的路线
下午3点从福伦丹飞到马德里的航班有哪些	{下午3点=出发时间, 福伦丹=出发城市, 马德里=目的城市}	特定行程方式下的路线
从利亚内斯可以飞到芝加哥吗	{利亚内斯=出发城市, 芝加哥=目的城市}	特定行程方式下的路线
从恩纳可以飞到罗勇吗	{恩纳=出发城市, 罗勇=目的城市}	特定行程方式下的路线
从大溪地可以飞到普诺吗	{普诺=目的城市, 大溪地=出发城市}	特定行程方式下的路线
从蓝梦岛可以飞到约翰内斯堡吗	{约翰内斯堡=目的城市, 蓝梦岛=出发城市}	特定行程方式下的路线
从马德望可以飞到巴厘岛吗	{巴厘岛=目的城市, 马德望=出发城市}	特定行程方式下的路线
从河内可以飞到邦劳吗	{邦劳=目的城市, 河内=出发城市}	特定行程方式下的路线
从热海可以飞到棉花堡吗	{棉花堡=目的城市, 热海=出发城市}	特定行程方式下的路线
从熊本可以飞到名古屋吗	{名古屋=目的城市, 熊本=出发城市}	特定行程方式下的路线
从拉哈尔可以飞到冲绳吗	{拉哈尔=出发城市, 冲绳=目的城市}	特定行程方式下的路线
从阿巴斯港可以飞到北碧府吗	{北碧府=目的城市, 阿巴斯港=出发城市}	特定行程方式下的路线
从高威可以飞到图卢兹吗	{图卢兹=目的城市, 高威=出发城市}	特定行程方式下的路线
从西奈山可以飞到罗瓦涅米吗	{西奈山=出发城市, 罗瓦涅米=目的城市}	特定行程方式下的路线
从米湖可以飞到卑尔根吗	{卑尔根=目的城市, 米湖=出发城市}	特定行程方式下的路线
从巴格达可以飞到龙目岛吗	{龙目岛=目的城市, 巴格达=出发城市}	特定行程方式下的路线
从埃伊尔斯塔济可以飞到札幌吗	{札幌=目的城市, 埃伊尔斯塔济=出发城市}	特定行程方式下的路线
从魁北克市可以飞到麦地那吗	{麦地那=目的城市, 魁北克市=出发城市}	特定行程方式下的路线
从赞丹可以飞到贝尔马尔吗	{赞丹=出发城市, 贝尔马尔=目的城市}	特定行程方式下的路线
从斗湖可以飞到帕劳吗	{斗湖=出发城市, 帕劳=目的城市}	特定行程方式下的路线
从五渔村可以飞到伊瓜苏市吗	{伊瓜苏市=目的城市, 五渔村=出发城市}	特定行程方式下的路线
从延雪平可以飞到伊纳里吗	{延雪平=出发城市, 伊纳里=目的城市}	特定行程方式下的路线
从格拉斯哥可以飞到达沃吗	{格拉斯哥=出发城市, 达沃=目的城市}	特定行程方式下的路线
从白沙瓦可以飞到埃伊尔斯塔济吗	{白沙瓦=出发城市, 埃伊尔斯塔济=目的城市}	特定行程方式下的路线
从恩格尔贝格可以飞到格雷茅斯吗	{恩格尔贝格=出发城市, 格雷茅斯=目的城市}	特定行程方式下的路线
从兹沃勒可以飞到卑尔根吗	{卑尔根=目的城市, 兹沃勒=出发城市}	特定行程方式下的路线
从努韦巴可以飞到雷克雅未克吗	{努韦巴=出发城市, 雷克雅未克=目的城市}	特定行程方式下的路线
从凯萨莉亚可以飞到列治文吗	{列治文=目的城市, 凯萨莉亚=出发城市}	特定行程方式下的路线
从格拉茨可以飞到开罗吗	{格拉茨=出发城市, 开罗=目的城市}	特定行程方式下的路线
从维克可以飞到埃尔卡拉法特吗	{维克=出发城市, 埃尔卡拉法特=目的城市}	特定行程方式下的路线
从豪尔可以飞到鹿港吗	{鹿港=目的城市, 豪尔=出发城市}	特定行程方式下的路线
从华欣可以飞到布达佩斯吗	{布达佩斯=目的城市, 华欣=出发城市}	特定行程方式下的路线
从丰沙尔可以飞到马特鲁吗	{马特鲁=目的城市, 丰沙尔=出发城市}	特定行程方式下的路线
从拜伦湾可以飞到不莱梅吗	{不莱梅=目的城市, 拜伦湾=出发城市}	特定行程方式下的路线
从撒丁岛可以飞到嘉义吗	{嘉义=目的城市, 撒丁岛=出发城市}	特定行程方式下的路线
从古晋可以飞到美蕊沙吗	{美蕊沙=目的城市, 古晋=出发城市}	特定行程方式下的路线
从巴淡岛可以飞到尔湾吗	{巴淡岛=出发城市, 尔湾=目的城市}	特定行程方式下的路线
从爱丽丝泉可以飞到圣莫尼卡吗	{爱丽丝泉=出发城市, 圣莫尼卡=目的城市}	特定行程方式下的路线
从伊斯法罕可以飞到费城吗	{费城=目的城市, 伊斯法罕=出发城市}	特定行程方式下的路线
从芽庄可以飞到哈尔施塔特吗	{芽庄=出发城市, 哈尔施塔特=目的城市}	特定行程方式下的路线
从都灵可以飞到蒙特勒吗	{都灵=出发城市, 蒙特勒=目的城市}	特定行程方式下的路线
从塔拉戈纳可以飞到晋州市吗	{晋州市=目的城市, 塔拉戈纳=出发城市}	特定行程方式下的路线
从希拉可以飞到沙美岛吗	{沙美岛=目的城市, 希拉=出发城市}	特定行程方式下的路线
从吉马良斯可以飞到美瑛吗	{美瑛=目的城市, 吉马良斯=出发城市}	特定行程方式下的路线
从吉隆坡可以飞到贝尼多姆吗	{贝尼多姆=目的城市, 吉隆坡=出发城市}	特定行程方式下的路线
从利亚内斯可以飞到金斯顿吗	{利亚内斯=出发城市, 金斯顿=目的城市}	特定行程方式下的路线
从恩纳可以飞到曼谷吗	{恩纳=出发城市, 曼谷=目的城市}	特定行程方式下的路线
从奥马鲁可以飞到撒丁岛吗	{奥马鲁=出发城市, 撒丁岛=目的城市}	特定行程方式下的路线
从温尼伯可以飞到芽庄吗	{温尼伯=出发城市, 芽庄=目的城市}	特定行程方式下的路线
从帕皮提可以飞到毕尔巴鄂吗	{毕尔巴鄂=目的城市, 帕皮提=出发城市}	特定行程方式下的路线
从库塔可以飞到尼亚加拉瀑布城吗	{库塔=出发城市, 尼亚加拉瀑布城=目的城市}	特定行程方式下的路线
从布拉格可以飞到萨尔瓦多吗	{布拉格=出发城市, 萨尔瓦多=目的城市}	特定行程方式下的路线
从木尔坦可以飞到普那卡吗	{木尔坦=出发城市, 普那卡=目的城市}	特定行程方式下的路线
从圣安娜可以飞到里雄莱锡安吗	{圣安娜=出发城市, 里雄莱锡安=目的城市}	特定行程方式下的路线
从热浪岛可以飞到盐湖城吗	{盐湖城=目的城市, 热浪岛=出发城市}	特定行程方式下的路线
从莱城可以飞到斯卡恩吗	{莱城=出发城市, 斯卡恩=目的城市}	特定行程方式下的路线
从格拉茨可以飞到阿莱姆港吗	{格拉茨=出发城市, 阿莱姆港=目的城市}	特定行程方式下的路线
从赞丹可以飞到大邱吗	{大邱=目的城市, 赞丹=出发城市}	特定行程方式下的路线
从拉斯维加斯可以飞到象岛吗	{拉斯维加斯=出发城市, 象岛=目的城市}	特定行程方式下的路线
从锡基霍尔可以飞到暹粒吗	{暹粒=目的城市, 锡基霍尔=出发城市}	特定行程方式下的路线
从托莱多可以飞到约翰内斯堡吗	{托莱多=出发城市, 约翰内斯堡=目的城市}	特定行程方式下的路线
从圣路易斯可以飞到帕皮提吗	{圣路易斯=出发城市, 帕皮提=目的城市}	特定行程方式下的路线
从锡瓦绿洲可以飞到丹布勒吗	{锡瓦绿洲=出发城市, 丹布勒=目的城市}	特定行程方式下的路线
从弗里堡可以飞到扎金索斯吗	{扎金索斯=目的城市, 弗里堡=出发城市}	特定行程方式下的路线
从尼斯可以飞到卡劳吗	{尼斯=出发城市, 卡劳=目的城市}	特定行程方式下的路线
从瓦胡卡岛可以飞到波尔蒂芒吗	{瓦胡卡岛=出发城市, 波尔蒂芒=目的城市}	特定行程方式下的路线
从凯米可以飞到温哥华吗	{温哥华=目的城市, 凯米=出发城市}	特定行程方式下的路线
从坦加勒可以飞到道格拉斯港吗	{坦加勒=出发城市, 道格拉斯港=目的城市}	特定行程方式下的路线
从卡劳可以飞到维也纳吗	{卡劳=出发城市, 维也纳=目的城市}	特定行程方式下的路线
从南特可以飞到奥马鲁吗	{南特=出发城市, 奥马鲁=目的城市}	特定行程方式下的路线
从布鲁塞尔可以飞到安塔利亚吗	{布鲁塞尔=出发城市, 安塔利亚=目的城市}	特定行程方式下的路线
从水原可以飞到北宾吗	{水原=出发城市, 北宾=目的城市}	特定行程方式下的路线
从奥洛穆茨可以飞到巴拉顿菲赖德吗	{奥洛穆茨=出发城市, 巴拉顿菲赖德=目的城市}	特定行程方式下的路线
从迈阿密可以飞到春武里府吗	{迈阿密=出发城市, 春武里府=目的城市}	特定行程方式下的路线
从伊瓜苏港可以飞到金泽吗	{伊瓜苏港=出发城市, 金泽=目的城市}	特定行程方式下的路线
从比雷埃夫斯可以飞到宿雾吗	{宿雾=目的城市, 比雷埃夫斯=出发城市}	特定行程方式下的路线
从富良野可以飞到贝尔谢巴吗	{富良野=出发城市, 贝尔谢巴=目的城市}	特定行程方式下的路线
从拉斯维加斯可以飞到采法特吗	{拉斯维加斯=出发城市, 采法特=目的城市}	特定行程方式下的路线
从格拉斯哥可以飞到拉斯海马吗	{格拉斯哥=出发城市, 拉斯海马=目的城市}	特定行程方式下的路线
从维谢格拉德可以飞到朗塞斯顿吗	{朗塞斯顿=目的城市, 维谢格拉德=出发城市}	特定行程方式下的路线
从哥德堡可以飞到伊势吗	{哥德堡=出发城市, 伊势=目的城市}	特定行程方式下的路线
从卡法萨巴可以飞到米科诺斯岛吗	{米科诺斯岛=目的城市, 卡法萨巴=出发城市}	特定行程方式下的路线
从斐济可以飞到番红花城吗	{斐济=出发城市, 番红花城=目的城市}	特定行程方式下的路线
从里斯本可以飞到哥本哈根吗	{里斯本=出发城市, 哥本哈根=目的城市}	特定行程方式下的路线
从宇治可以飞到哥打巴鲁吗	{宇治=出发城市, 哥打巴鲁=目的城市}	特定行程方式下的路线
从八打灵再也可以飞到维甘吗	{八打灵再也=出发城市, 维甘=目的城市}	特定行程方式下的路线
从波茨坦可以飞到华欣吗	{波茨坦=出发城市, 华欣=目的城市}	特定行程方式下的路线
从布尔诺可以飞到拉瓦格吗	{布尔诺=出发城市, 拉瓦格=目的城市}	特定行程方式下的路线
从木浦市可以飞到里尔吗	{木浦市=出发城市, 里尔=目的城市}	特定行程方式下的路线
从内比都可以飞到东枝吗	{内比都=出发城市, 东枝=目的城市}	特定行程方式下的路线
从西西里岛可以飞到麦加吗	{西西里岛=出发城市, 麦加=目的城市}	特定行程方式下的路线
从圣彼得堡可以飞到斯蒂基斯霍尔米吗	{斯蒂基斯霍尔米=目的城市, 圣彼得堡=出发城市}	特定行程方式下的路线
从塔斯马尼亚岛可以飞到特鲁希略吗	{塔斯马尼亚岛=出发城市, 特鲁希略=目的城市}	特定行程方式下的路线
从克拉根福可以飞到玛瑙斯市吗	{克拉根福=出发城市, 玛瑙斯市=目的城市}	特定行程方式下的路线
从叶卡捷琳堡可以飞到米茨佩拉蒙吗	{米茨佩拉蒙=目的城市, 叶卡捷琳堡=出发城市}	特定行程方式下的路线
从法蒂玛可以飞到爱丁堡吗	{法蒂玛=出发城市, 爱丁堡=目的城市}	特定行程方式下的路线
从海德堡可以飞到蔚山吗	{海德堡=出发城市, 蔚山=目的城市}	特定行程方式下的路线
从北宾可以飞到凯夫拉维克吗	{凯夫拉维克=目的城市, 北宾=出发城市}	特定行程方式下的路线
从罗斯基勒可以飞到台南吗	{罗斯基勒=出发城市, 台南=目的城市}	特定行程方式下的路线
从潘切市可以飞到休伊吗	{休伊=目的城市, 潘切市=出发城市}	特定行程方式下的路线
从加德满都可以飞到马六甲吗	{加德满都=出发城市, 马六甲=目的城市}	特定行程方式下的路线
从尔湾可以飞到安特卫普吗	{尔湾=出发城市, 安特卫普=目的城市}	特定行程方式下的路线
从釜山有飞往代尔夫特的飞机吗	{釜山=出发城市, 代尔夫特=目的城市}	特定行程方式下的路线
从波恩有飞往日光的飞机吗	{日光=目的城市, 波恩=出发城市}	特定行程方式下的路线
从贝克斯菲尔德有飞往斯蒂基斯霍尔米的飞机吗	{斯蒂基斯霍尔米=目的城市, 贝克斯菲尔德=出发城市}	特定行程方式下的路线
从卡法萨巴有飞往圣路易斯的飞机吗	{圣路易斯=目的城市, 卡法萨巴=出发城市}	特定行程方式下的路线
从蒂阿瑙有飞往夏蒙尼的飞机吗	{蒂阿瑙=出发城市, 夏蒙尼=目的城市}	特定行程方式下的路线
从霍巴特有飞往赖扬的飞机吗	{霍巴特=出发城市, 赖扬=目的城市}	特定行程方式下的路线
从西雅图有飞往莱蒂西亚的飞机吗	{莱蒂西亚=目的城市, 西雅图=出发城市}	特定行程方式下的路线
从曼彻斯特有飞往雷斯蒙的飞机吗	{雷斯蒙=目的城市, 曼彻斯特=出发城市}	特定行程方式下的路线
从金斯顿有飞往魁北克市的飞机吗	{金斯顿=出发城市, 魁北克市=目的城市}	特定行程方式下的路线
从普那卡有飞往拉斯帕尔马斯的飞机吗	{拉斯帕尔马斯=目的城市, 普那卡=出发城市}	特定行程方式下的路线
从汉堡有飞往首尔的飞机吗	{汉堡=出发城市, 首尔=目的城市}	特定行程方式下的路线
从马什哈德有飞往恩格尔贝格的飞机吗	{恩格尔贝格=目的城市, 马什哈德=出发城市}	特定行程方式下的路线
从网走有飞往埃因霍温的飞机吗	{网走=出发城市, 埃因霍温=目的城市}	特定行程方式下的路线
从知床半岛有飞往哈尔施塔特的飞机吗	{哈尔施塔特=目的城市, 知床半岛=出发城市}	特定行程方式下的路线
从水原有飞往塞维利亚的飞机吗	{塞维利亚=目的城市, 水原=出发城市}	特定行程方式下的路线
从马斯特里赫特有飞往那霸的飞机吗	{马斯特里赫特=出发城市, 那霸=目的城市}	特定行程方式下的路线
从纳夫普利翁有飞往阿蒂乌岛的飞机吗	{纳夫普利翁=出发城市, 阿蒂乌岛=目的城市}	特定行程方式下的路线
从指宿市有飞往宫古岛的飞机吗	{宫古岛=目的城市, 指宿市=出发城市}	特定行程方式下的路线
从钏路有飞往象岛的飞机吗	{钏路=出发城市, 象岛=目的城市}	特定行程方式下的路线
从埃伊尔斯塔济有飞往卡法萨巴的飞机吗	{埃伊尔斯塔济=出发城市, 卡法萨巴=目的城市}	特定行程方式下的路线
从撒丁岛有飞往岘港的飞机吗	{岘港=目的城市, 撒丁岛=出发城市}	特定行程方式下的路线
从普吉岛有飞往纽约的飞机吗	{纽约=目的城市, 普吉岛=出发城市}	特定行程方式下的路线
从撒丁岛有飞往斯特拉斯堡的飞机吗	{斯特拉斯堡=目的城市, 撒丁岛=出发城市}	特定行程方式下的路线
从拜伦湾有飞往玛瑙斯市的飞机吗	{拜伦湾=出发城市, 玛瑙斯市=目的城市}	特定行程方式下的路线
从圣克鲁斯有飞往河内的飞机吗	{圣克鲁斯=出发城市, 河内=目的城市}	特定行程方式下的路线
从乌布有飞往五渔村的飞机吗	{五渔村=目的城市, 乌布=出发城市}	特定行程方式下的路线
从丰盛港有飞往厄吕代尼兹的飞机吗	{丰盛港=出发城市, 厄吕代尼兹=目的城市}	特定行程方式下的路线
从维多利亚市有飞往尼亚加拉瀑布城的飞机吗	{维多利亚市=出发城市, 尼亚加拉瀑布城=目的城市}	特定行程方式下的路线
从本迪布尔有飞往亚特兰大的飞机吗	{本迪布尔=出发城市, 亚特兰大=目的城市}	特定行程方式下的路线
从门迪有飞往萨格里斯的飞机吗	{门迪=出发城市, 萨格里斯=目的城市}	特定行程方式下的路线
从春武里府有飞往埃德蒙顿的飞机吗	{春武里府=出发城市, 埃德蒙顿=目的城市}	特定行程方式下的路线
从香港有飞往费城的飞机吗	{费城=目的城市, 香港=出发城市}	特定行程方式下的路线
从梅赫伦有飞往金泽的飞机吗	{梅赫伦=出发城市, 金泽=目的城市}	特定行程方式下的路线
从加的斯有飞往黄金海岸的飞机吗	{黄金海岸=目的城市, 加的斯=出发城市}	特定行程方式下的路线
从渥太华有飞往第戎的飞机吗	{渥太华=出发城市, 第戎=目的城市}	特定行程方式下的路线
从提比里亚有飞往天安市的飞机吗	{提比里亚=出发城市, 天安市=目的城市}	特定行程方式下的路线
从民丹岛有飞往霍尼亚拉的飞机吗	{霍尼亚拉=目的城市, 民丹岛=出发城市}	特定行程方式下的路线
从布鲁塞尔有飞往万象的飞机吗	{万象=目的城市, 布鲁塞尔=出发城市}	特定行程方式下的路线
从库奥皮奥有飞往金门的飞机吗	{库奥皮奥=出发城市, 金门=目的城市}	特定行程方式下的路线
从谢尔盖耶夫有飞往佛罗伦萨的飞机吗	{佛罗伦萨=目的城市, 谢尔盖耶夫=出发城市}	特定行程方式下的路线
从克鲁姆洛夫有飞往本托特的飞机吗	{本托特=目的城市, 克鲁姆洛夫=出发城市}	特定行程方式下的路线
从哥德堡有飞往仰光的飞机吗	{仰光=目的城市, 哥德堡=出发城市}	特定行程方式下的路线
从函馆有飞往休伊的飞机吗	{休伊=目的城市, 函馆=出发城市}	特定行程方式下的路线
从新加坡有飞往凯库拉的飞机吗	{新加坡=出发城市, 凯库拉=目的城市}	特定行程方式下的路线
从卡尔维亚有飞往戈公的飞机吗	{戈公=目的城市, 卡尔维亚=出发城市}	特定行程方式下的路线
从蒙彼利埃有飞往维罗纳的飞机吗	{蒙彼利埃=出发城市, 维罗纳=目的城市}	特定行程方式下的路线
从下龙湾有飞往东京的飞机吗	{下龙湾=出发城市, 东京=目的城市}	特定行程方式下的路线
从豪尔有飞往辛特拉的飞机吗	{辛特拉=目的城市, 豪尔=出发城市}	特定行程方式下的路线
从里雄莱锡安有飞往奥马鲁的飞机吗	{里雄莱锡安=出发城市, 奥马鲁=目的城市}	特定行程方式下的路线
从墨尔本有飞往塞得港的飞机吗	{塞得港=目的城市, 墨尔本=出发城市}	特定行程方式下的路线
从维尔茨堡有飞往董里的飞机吗	{维尔茨堡=出发城市, 董里=目的城市}	特定行程方式下的路线
从开罗有飞往埃斯波的飞机吗	{埃斯波=目的城市, 开罗=出发城市}	特定行程方式下的路线
从厄吕代尼兹有飞往水原的飞机吗	{厄吕代尼兹=出发城市, 水原=目的城市}	特定行程方式下的路线
从沙姆沙伊赫有飞往毕尔巴鄂的飞机吗	{毕尔巴鄂=目的城市, 沙姆沙伊赫=出发城市}	特定行程方式下的路线
从普那卡有飞往因弗卡吉尔的飞机吗	{因弗卡吉尔=目的城市, 普那卡=出发城市}	特定行程方式下的路线
从蒲甘有飞往费城的飞机吗	{费城=目的城市, 蒲甘=出发城市}	特定行程方式下的路线
从利亚内斯有飞往毕尔巴鄂的飞机吗	{利亚内斯=出发城市, 毕尔巴鄂=目的城市}	特定行程方式下的路线
从亚兹德有飞往巴塔利亚的飞机吗	{亚兹德=出发城市, 巴塔利亚=目的城市}	特定行程方式下的路线
从波隆纳鲁沃有飞往良瑞的飞机吗	{波隆纳鲁沃=出发城市, 良瑞=目的城市}	特定行程方式下的路线
从维罗纳有飞往奥胡斯的飞机吗	{维罗纳=出发城市, 奥胡斯=目的城市}	特定行程方式下的路线
从万象有飞往约翰内斯堡的飞机吗	{万象=出发城市, 约翰内斯堡=目的城市}	特定行程方式下的路线
从菲拉赫有飞往萨拉戈萨的飞机吗	{萨拉戈萨=目的城市, 菲拉赫=出发城市}	特定行程方式下的路线
从欧登塞有飞往仰光的飞机吗	{仰光=目的城市, 欧登塞=出发城市}	特定行程方式下的路线
从比雷埃夫斯有飞往卡普里岛的飞机吗	{卡普里岛=目的城市, 比雷埃夫斯=出发城市}	特定行程方式下的路线
从阿比斯库有飞往长野的飞机吗	{阿比斯库=出发城市, 长野=目的城市}	特定行程方式下的路线
从帕罗斯有飞往乌布的飞机吗	{帕罗斯=出发城市, 乌布=目的城市}	特定行程方式下的路线
从卑尔根有飞往基洛纳的飞机吗	{卑尔根=出发城市, 基洛纳=目的城市}	特定行程方式下的路线
从古赛尔有飞往第戎的飞机吗	{古赛尔=出发城市, 第戎=目的城市}	特定行程方式下的路线
从阿尔科巴萨有飞往布鲁塞尔的飞机吗	{布鲁塞尔=目的城市, 阿尔科巴萨=出发城市}	特定行程方式下的路线
从哈尔施塔特有飞往阿雷格里港的飞机吗	{阿雷格里港=目的城市, 哈尔施塔特=出发城市}	特定行程方式下的路线
从亚庇有飞往沙努尔的飞机吗	{沙努尔=目的城市, 亚庇=出发城市}	特定行程方式下的路线
从马特勒有飞往图恩的飞机吗	{图恩=目的城市, 马特勒=出发城市}	特定行程方式下的路线
从帕皮提有飞往南投的飞机吗	{南投=目的城市, 帕皮提=出发城市}	特定行程方式下的路线
从撒丁岛有飞往丰盛港的飞机吗	{丰盛港=目的城市, 撒丁岛=出发城市}	特定行程方式下的路线
从瓦纳卡有飞往莫皮蒂岛的飞机吗	{瓦纳卡=出发城市, 莫皮蒂岛=目的城市}	特定行程方式下的路线
从廷布有飞往捷克布杰约维采的飞机吗	{廷布=出发城市, 捷克布杰约维采=目的城市}	特定行程方式下的路线
从阿纳帕有飞往海宁的飞机吗	{阿纳帕=出发城市, 海宁=目的城市}	特定行程方式下的路线
从戈公有飞往阿罗萨的飞机吗	{阿罗萨=目的城市, 戈公=出发城市}	特定行程方式下的路线
从暹粒有飞往内比都的飞机吗	{内比都=目的城市, 暹粒=出发城市}	特定行程方式下的路线
从蒂豪尼有飞往苏拉哈的飞机吗	{蒂豪尼=出发城市, 苏拉哈=目的城市}	特定行程方式下的路线
从斯特拉斯堡有飞往华盛顿的飞机吗	{斯特拉斯堡=出发城市, 华盛顿=目的城市}	特定行程方式下的路线
从布法罗有飞往马什哈德的飞机吗	{马什哈德=目的城市, 布法罗=出发城市}	特定行程方式下的路线
从安吉利斯有飞往米兰的飞机吗	{米兰=目的城市, 安吉利斯=出发城市}	特定行程方式下的路线
从波蓬德塔有飞往奥基的飞机吗	{波蓬德塔=出发城市, 奥基=目的城市}	特定行程方式下的路线
从加里宁格勒有飞往基拉尼的飞机吗	{加里宁格勒=出发城市, 基拉尼=目的城市}	特定行程方式下的路线
从阿布扎比有飞往花莲的飞机吗	{花莲=目的城市, 阿布扎比=出发城市}	特定行程方式下的路线
从光州有飞往曼彻斯特的飞机吗	{曼彻斯特=目的城市, 光州=出发城市}	特定行程方式下的路线
从米伦有飞往库比蒂诺的飞机吗	{库比蒂诺=目的城市, 米伦=出发城市}	特定行程方式下的路线
从白马市有飞往波隆纳鲁沃的飞机吗	{波隆纳鲁沃=目的城市, 白马市=出发城市}	特定行程方式下的路线
从凯恩斯有飞往静冈的飞机吗	{凯恩斯=出发城市, 静冈=目的城市}	特定行程方式下的路线
从庆州有飞往罗得岛的飞机吗	{罗得岛=目的城市, 庆州=出发城市}	特定行程方式下的路线
从苏梅岛有飞往加里宁格勒的飞机吗	{加里宁格勒=目的城市, 苏梅岛=出发城市}	特定行程方式下的路线
从阿吉曼有飞往波贝的飞机吗	{波贝=目的城市, 阿吉曼=出发城市}	特定行程方式下的路线
从美瑛有飞往门迪的飞机吗	{门迪=目的城市, 美瑛=出发城市}	特定行程方式下的路线
从南安普顿有飞往普罗旺斯的飞机吗	{普罗旺斯=目的城市, 南安普顿=出发城市}	特定行程方式下的路线
从塞格德有飞往布拉加的飞机吗	{塞格德=出发城市, 布拉加=目的城市}	特定行程方式下的路线
从富川有飞往札幌的飞机吗	{札幌=目的城市, 富川=出发城市}	特定行程方式下的路线
从拉斯佩齐亚有飞往波贝的飞机吗	{波贝=目的城市, 拉斯佩齐亚=出发城市}	特定行程方式下的路线
从图尔奈有飞往泰尔奇的飞机吗	{图尔奈=出发城市, 泰尔奇=目的城市}	特定行程方式下的路线
从安卡拉有飞往棉兰的飞机吗	{安卡拉=出发城市, 棉兰=目的城市}	特定行程方式下的路线
2017年1月下旬从新加坡去新加坡，怎么走？	{2017年1月下旬=日期, 新加坡=城市, 首尔=城市}	大行程路线
8月6号从香港去香港，怎么走？	{香港=城市, 东京=城市, 8月6号=日期}	大行程路线
2017年1月下旬从台北去台北，怎么走？	{2017年1月下旬=日期, 首尔=城市, 台北=城市}	大行程路线
2016年9月初从巴黎去巴黎，怎么走？	{巴黎=城市, 2016年9月初=日期, 东京=城市}	大行程路线
2017年1月下旬从澳门去澳门，怎么走？	{2017年1月下旬=日期, 吉萨=城市, 澳门=城市}	大行程路线
2016年9月30日从东京去东京，怎么走？	{2016年9月30日=日期, 东京=城市}	大行程路线
2016年10月中旬从巴黎去巴黎，怎么走？	{巴黎=城市, 首尔=城市, 2016年10月中旬=日期}	大行程路线
2017年1月下旬从香港去香港，怎么走？	{2017年1月下旬=日期, 纽约市=城市, 香港=城市}	大行程路线
8月5日从新加坡去新加坡，怎么走？	{巴黎=城市, 新加坡=城市, 8月5日=日期}	大行程路线
2016年9月30日从普吉岛去普吉岛，怎么走？	{2016年9月30日=日期, 东京=城市, 普吉岛=城市}	大行程路线
8月5日从西归浦去西归浦，怎么走？	{西归浦=城市, 新加坡=城市, 8月5日=日期}	大行程路线
2016年9月30日从台北去台北，怎么走？	{西归浦=城市, 2016年9月30日=日期, 台北=城市}	大行程路线
2016年9月30日从首尔去首尔，怎么走？	{2016年9月30日=日期, 澳门=城市, 首尔=城市}	大行程路线
8月6号从纽约市去纽约市，怎么走？	{纽约市=城市, 首尔=城市, 8月6号=日期}	大行程路线
2016年10月中旬从西归浦去西归浦，怎么走？	{巴黎=城市, 西归浦=城市, 2016年10月中旬=日期}	大行程路线
2016年9月初从吉萨去吉萨，怎么走？	{西归浦=城市, 2016年9月初=日期, 吉萨=城市}	大行程路线
8月6号从芭堤雅去芭堤雅，怎么走？	{芭堤雅=城市, 8月6号=日期, 台北=城市}	大行程路线
2017年1月下旬从东京去东京，怎么走？	{2017年1月下旬=日期, 东京=城市}	大行程路线
2016年9月初从西归浦去西归浦，怎么走？	{西归浦=城市, 2016年9月初=日期, 台北=城市}	大行程路线
8月5日从巴黎去巴黎，怎么走？	{巴黎=城市, 西归浦=城市, 8月5日=日期}	大行程路线
2016年9月30日从澳门去澳门，怎么走？	{巴黎=城市, 2016年9月30日=日期, 澳门=城市}	大行程路线
8月5日从纽约市去纽约市，怎么走？	{纽约市=城市, 8月5日=日期}	大行程路线
2016年9月30日从里昂去里昂，怎么走？	{里昂=城市, 2016年9月30日=日期}	大行程路线
2016年10月中旬从普吉岛去普吉岛，怎么走？	{西归浦=城市, 普吉岛=城市, 2016年10月中旬=日期}	大行程路线
2017年1月下旬从纽约市去纽约市，怎么走？	{2017年1月下旬=日期, 纽约市=城市}	大行程路线
2016年9月30日从新加坡去新加坡，怎么走？	{纽约市=城市, 2016年9月30日=日期, 新加坡=城市}	大行程路线
2017年1月下旬从首尔去首尔，怎么走？	{2017年1月下旬=日期, 新加坡=城市, 首尔=城市}	大行程路线
2017年1月下旬从巴黎去巴黎，怎么走？	{2017年1月下旬=日期, 巴黎=城市, 澳门=城市}	大行程路线
2016年9月初从香港去香港，怎么走？	{西归浦=城市, 2016年9月初=日期, 香港=城市}	大行程路线
2016年10月中旬从澳门去澳门，怎么走？	{澳门=城市, 芭堤雅=城市, 2016年10月中旬=日期}	大行程路线
2016年9月30日从西归浦去西归浦，怎么走？	{西归浦=城市, 2016年9月30日=日期, 新加坡=城市}	大行程路线
2016年10月中旬从纽约市去纽约市，怎么走？	{纽约市=城市, 里昂=城市, 2016年10月中旬=日期}	大行程路线
2016年9月初从澳门去澳门，怎么走？	{纽约市=城市, 2016年9月初=日期, 澳门=城市}	大行程路线
8月6号从普吉岛去普吉岛，怎么走？	{普吉岛=城市, 8月6号=日期, 台北=城市}	大行程路线
2016年9月30日从吉萨去吉萨，怎么走？	{2016年9月30日=日期, 吉萨=城市, 澳门=城市}	大行程路线
8月6号从澳门去澳门，怎么走？	{澳门=城市, 芭堤雅=城市, 8月6号=日期}	大行程路线
2016年9月初从新加坡去新加坡，怎么走？	{2016年9月初=日期, 吉萨=城市, 新加坡=城市}	大行程路线
2017年1月下旬从普吉岛去普吉岛，怎么走？	{2017年1月下旬=日期, 东京=城市, 普吉岛=城市}	大行程路线
2016年9月初从东京去东京，怎么走？	{巴黎=城市, 2016年9月初=日期, 东京=城市}	大行程路线
2016年9月30日从纽约市去纽约市，怎么走？	{纽约市=城市, 2016年9月30日=日期, 澳门=城市}	大行程路线
2016年9月初从芭堤雅去芭堤雅，怎么走？	{2016年9月初=日期, 吉萨=城市, 芭堤雅=城市}	大行程路线
8月6号从吉萨去吉萨，怎么走？	{吉萨=城市, 8月6号=日期}	大行程路线
2016年10月中旬从新加坡去新加坡，怎么走？	{新加坡=城市, 首尔=城市, 2016年10月中旬=日期}	大行程路线
8月6号从新加坡去新加坡，怎么走？	{里昂=城市, 新加坡=城市, 8月6号=日期}	大行程路线
2017年1月下旬从里昂去里昂，怎么走？	{2017年1月下旬=日期, 里昂=城市, 芭堤雅=城市}	大行程路线
2016年9月初从台北去台北，怎么走？	{2016年9月初=日期, 澳门=城市, 台北=城市}	大行程路线
2016年9月初从里昂去里昂，怎么走？	{2016年9月初=日期, 里昂=城市, 普吉岛=城市}	大行程路线
2016年10月中旬从香港去香港，怎么走？	{香港=城市, 东京=城市, 2016年10月中旬=日期}	大行程路线
从胡志明市怎么去古晋	{胡志明市=出发城市, 古晋=目的城市}	大行程路线
从古晋怎么去帕拉阿图	{帕拉阿图=目的城市, 古晋=出发城市}	大行程路线
从凡尔赛怎么去拉哈尔	{凡尔赛=出发城市, 拉哈尔=目的城市}	大行程路线
从宜兰怎么去卡斯凯什	{卡斯凯什=目的城市, 宜兰=出发城市}	大行程路线
从福森怎么去埃兹	{福森=出发城市, 埃兹=目的城市}	大行程路线
从纽卡斯尔怎么去基洛夫	{纽卡斯尔=出发城市, 基洛夫=目的城市}	大行程路线
从雅典怎么去圣沃尔夫冈	{雅典=出发城市, 圣沃尔夫冈=目的城市}	大行程路线
从图卢兹怎么去阿雷基帕	{图卢兹=出发城市, 阿雷基帕=目的城市}	大行程路线
从希拉怎么去设拉子	{希拉=出发城市, 设拉子=目的城市}	大行程路线
从晋州市怎么去大阪	{晋州市=出发城市, 大阪=目的城市}	大行程路线
从德尔斐怎么去采尔马特	{德尔斐=出发城市, 采尔马特=目的城市}	大行程路线
从芽庄怎么去梅尔克	{芽庄=出发城市, 梅尔克=目的城市}	大行程路线
从拉瓦格怎么去雷克雅未克	{雷克雅未克=目的城市, 拉瓦格=出发城市}	大行程路线
从良瑞怎么去亚兹德	{亚兹德=目的城市, 良瑞=出发城市}	大行程路线
从拉斯帕尔马斯怎么去基洛纳	{基洛纳=目的城市, 拉斯帕尔马斯=出发城市}	大行程路线
从里昂怎么去罗瓦涅米	{里昂=出发城市, 罗瓦涅米=目的城市}	大行程路线
从米茨佩拉蒙怎么去圣托里尼	{米茨佩拉蒙=出发城市, 圣托里尼=目的城市}	大行程路线
从卡塔尼亚怎么去云林	{卡塔尼亚=出发城市, 云林=目的城市}	大行程路线
从马六甲怎么去夏蒙尼	{夏蒙尼=目的城市, 马六甲=出发城市}	大行程路线
从沙巴怎么去横滨	{横滨=目的城市, 沙巴=出发城市}	大行程路线
从毕尔巴鄂怎么去棉兰	{毕尔巴鄂=出发城市, 棉兰=目的城市}	大行程路线
从磅湛怎么去谢菲尔德	{磅湛=出发城市, 谢菲尔德=目的城市}	大行程路线
从朗布尔怎么去古晋	{朗布尔=出发城市, 古晋=目的城市}	大行程路线
从米兰怎么去下龙湾	{米兰=出发城市, 下龙湾=目的城市}	大行程路线
从马尔代夫怎么去墨尔本	{马尔代夫=出发城市, 墨尔本=目的城市}	大行程路线
从凯库拉怎么去戛纳	{戛纳=目的城市, 凯库拉=出发城市}	大行程路线
从蓬特雷西纳怎么去箱根	{蓬特雷西纳=出发城市, 箱根=目的城市}	大行程路线
从纽卡斯尔怎么去马洛卡帕尔马	{马洛卡帕尔马=目的城市, 纽卡斯尔=出发城市}	大行程路线
从瓦伊塔佩怎么去加的斯	{瓦伊塔佩=出发城市, 加的斯=目的城市}	大行程路线
从克拉斯诺达尔怎么去箭镇	{克拉斯诺达尔=出发城市, 箭镇=目的城市}	大行程路线
从新北怎么去奥尔堡	{奥尔堡=目的城市, 新北=出发城市}	大行程路线
从霍基蒂卡怎么去埃兹	{霍基蒂卡=出发城市, 埃兹=目的城市}	大行程路线
从奈良怎么去马斯特里赫特	{马斯特里赫特=目的城市, 奈良=出发城市}	大行程路线
从高雄怎么去凯米	{凯米=目的城市, 高雄=出发城市}	大行程路线
从关岛怎么去卡斯凯什	{卡斯凯什=目的城市, 关岛=出发城市}	大行程路线
从俄斯特拉发怎么去静冈	{俄斯特拉发=出发城市, 静冈=目的城市}	大行程路线
从因特拉肯怎么去龙达	{龙达=目的城市, 因特拉肯=出发城市}	大行程路线
从槟城怎么去罗弗敦群岛	{槟城=出发城市, 罗弗敦群岛=目的城市}	大行程路线
从圣克拉拉怎么去暹粒	{圣克拉拉=出发城市, 暹粒=目的城市}	大行程路线
从卡塔赫纳怎么去埃因霍温	{埃因霍温=目的城市, 卡塔赫纳=出发城市}	大行程路线
从爱丽丝泉怎么去普诺	{爱丽丝泉=出发城市, 普诺=目的城市}	大行程路线
从南投怎么去利雅得	{南投=出发城市, 利雅得=目的城市}	大行程路线
从清州怎么去迪南	{清州=出发城市, 迪南=目的城市}	大行程路线
从阿蒂乌岛怎么去卡尔维亚	{阿蒂乌岛=出发城市, 卡尔维亚=目的城市}	大行程路线
从费城怎么去巴盖尔哈德	{巴盖尔哈德=目的城市, 费城=出发城市}	大行程路线
从苏拉哈怎么去基洛夫	{苏拉哈=出发城市, 基洛夫=目的城市}	大行程路线
从波士顿怎么去萨格里斯	{波士顿=出发城市, 萨格里斯=目的城市}	大行程路线
从阿雷基帕怎么去克拉根福	{克拉根福=目的城市, 阿雷基帕=出发城市}	大行程路线
从小樽怎么去春蓬	{小樽=出发城市, 春蓬=目的城市}	大行程路线
从库尔纳怎么去辛特拉	{辛特拉=目的城市, 库尔纳=出发城市}	大行程路线
从本托特怎么去卡斯凯什	{卡斯凯什=目的城市, 本托特=出发城市}	大行程路线
从喀山怎么去赫尔辛堡	{喀山=出发城市, 赫尔辛堡=目的城市}	大行程路线
从多哈怎么去斯特拉斯堡	{斯特拉斯堡=目的城市, 多哈=出发城市}	大行程路线
从奥基怎么去库特纳霍拉	{库特纳霍拉=目的城市, 奥基=出发城市}	大行程路线
从格拉斯哥怎么去施拉德明	{格拉斯哥=出发城市, 施拉德明=目的城市}	大行程路线
从拉斯佩齐亚怎么去豪尔	{拉斯佩齐亚=出发城市, 豪尔=目的城市}	大行程路线
从柏威夏怎么去维尔茨堡	{维尔茨堡=目的城市, 柏威夏=出发城市}	大行程路线
从马斯特里赫特怎么去昌原	{马斯特里赫特=出发城市, 昌原=目的城市}	大行程路线
从纳斯卡怎么去亚庇	{亚庇=目的城市, 纳斯卡=出发城市}	大行程路线
从米茨佩拉蒙怎么去马拉加	{米茨佩拉蒙=出发城市, 马拉加=目的城市}	大行程路线
从拉彭兰塔怎么去埃斯泰尔戈姆	{拉彭兰塔=出发城市, 埃斯泰尔戈姆=目的城市}	大行程路线
从普吉岛怎么去第戎	{普吉岛=出发城市, 第戎=目的城市}	大行程路线
从伊拉克利翁怎么去圣地亚哥-德孔波斯特拉	{伊拉克利翁=出发城市, 圣地亚哥-德孔波斯特拉=目的城市}	大行程路线
从米什科尔茨怎么去都灵	{米什科尔茨=出发城市, 都灵=目的城市}	大行程路线
从圣罗莎怎么去台南	{圣罗莎=出发城市, 台南=目的城市}	大行程路线
从琅南塔怎么去宿雾	{宿雾=目的城市, 琅南塔=出发城市}	大行程路线
从圣彼得堡怎么去波尔蒂芒	{波尔蒂芒=目的城市, 圣彼得堡=出发城市}	大行程路线
从阿卡怎么去塔巴	{阿卡=出发城市, 塔巴=目的城市}	大行程路线
从沃斯怎么去加的斯	{沃斯=出发城市, 加的斯=目的城市}	大行程路线
从陶尔米纳怎么去莱城	{陶尔米纳=出发城市, 莱城=目的城市}	大行程路线
从代尔夫特怎么去拉斯佩齐亚	{拉斯佩齐亚=目的城市, 代尔夫特=出发城市}	大行程路线
从埃兹怎么去林茨	{埃兹=出发城市, 林茨=目的城市}	大行程路线
从伊势怎么去特罗姆瑟	{特罗姆瑟=目的城市, 伊势=出发城市}	大行程路线
从合艾怎么去济州岛	{合艾=出发城市, 济州岛=目的城市}	大行程路线
从塞哥维亚怎么去斯米兰群岛	{塞哥维亚=出发城市, 斯米兰群岛=目的城市}	大行程路线
从腓特烈港怎么去因斯布鲁克	{腓特烈港=出发城市, 因斯布鲁克=目的城市}	大行程路线
从渥太华怎么去里昂	{渥太华=出发城市, 里昂=目的城市}	大行程路线
从台东怎么去布法罗	{台东=出发城市, 布法罗=目的城市}	大行程路线
从霍巴特怎么去蒂卡普湖	{霍巴特=出发城市, 蒂卡普湖=目的城市}	大行程路线
从宫崎市怎么去洛杉矶	{宫崎市=出发城市, 洛杉矶=目的城市}	大行程路线
从内坦亚怎么去霍基蒂卡	{内坦亚=出发城市, 霍基蒂卡=目的城市}	大行程路线
从卡塔尼亚怎么去罗马	{罗马=目的城市, 卡塔尼亚=出发城市}	大行程路线
从凯库拉怎么去大阪	{大阪=目的城市, 凯库拉=出发城市}	大行程路线
从伊拉克利翁怎么去萨斯卡通	{伊拉克利翁=出发城市, 萨斯卡通=目的城市}	大行程路线
从里斯本怎么去贡布	{贡布=目的城市, 里斯本=出发城市}	大行程路线
从波贝怎么去里尔	{波贝=出发城市, 里尔=目的城市}	大行程路线
从华盛顿怎么去木尔坦	{木尔坦=目的城市, 华盛顿=出发城市}	大行程路线
从西西里岛怎么去开罗	{西西里岛=出发城市, 开罗=目的城市}	大行程路线
从奥比都斯怎么去纳斯卡	{奥比都斯=出发城市, 纳斯卡=目的城市}	大行程路线
从贝克斯菲尔德怎么去约克	{贝克斯菲尔德=出发城市, 约克=目的城市}	大行程路线
从圣托里尼怎么去大叻	{圣托里尼=出发城市, 大叻=目的城市}	大行程路线
从清州怎么去圣何塞	{清州=出发城市, 圣何塞=目的城市}	大行程路线
从亚历山大怎么去布里斯班	{亚历山大=出发城市, 布里斯班=目的城市}	大行程路线
从贝特默阿尔卑怎么去尼尔森	{贝特默阿尔卑=出发城市, 尼尔森=目的城市}	大行程路线
从布鲁塞尔怎么去高山	{布鲁塞尔=出发城市, 高山=目的城市}	大行程路线
从圣沃尔夫冈怎么去静冈	{圣沃尔夫冈=出发城市, 静冈=目的城市}	大行程路线
从美蕊沙怎么去本托特	{美蕊沙=出发城市, 本托特=目的城市}	大行程路线
从波尔多怎么去忠州	{忠州=目的城市, 波尔多=出发城市}	大行程路线
从坡州怎么去布拉格	{坡州=出发城市, 布拉格=目的城市}	大行程路线
从乌得勒支怎么去洛桑	{乌得勒支=出发城市, 洛桑=目的城市}	大行程路线
从哈利法克斯到捷克布杰约维采可以怎么走	{捷克布杰约维采=目的城市, 哈利法克斯=出发城市}	大行程路线
从卡塔赫纳到伊斯兰堡可以怎么走	{伊斯兰堡=目的城市, 卡塔赫纳=出发城市}	大行程路线
从门迪到阿罗萨可以怎么走	{门迪=出发城市, 阿罗萨=目的城市}	大行程路线
从塞格德到锡基霍尔可以怎么走	{塞格德=出发城市, 锡基霍尔=目的城市}	大行程路线
从萨尔茨堡到木尔坦可以怎么走	{木尔坦=目的城市, 萨尔茨堡=出发城市}	大行程路线
从苏莱曼尼亚到曼谷可以怎么走	{曼谷=目的城市, 苏莱曼尼亚=出发城市}	大行程路线
从黎牙实比到南设得兰群岛可以怎么走	{黎牙实比=出发城市, 南设得兰群岛=目的城市}	大行程路线
从德累斯顿到马贝拉可以怎么走	{德累斯顿=出发城市, 马贝拉=目的城市}	大行程路线
从和歌山到兰达岛可以怎么走	{和歌山=出发城市, 兰达岛=目的城市}	大行程路线
从塔巴到克鲁姆洛夫可以怎么走	{克鲁姆洛夫=目的城市, 塔巴=出发城市}	大行程路线
从施拉德明到长滩岛可以怎么走	{施拉德明=出发城市, 长滩岛=目的城市}	大行程路线
从圣何塞到恩纳可以怎么走	{恩纳=目的城市, 圣何塞=出发城市}	大行程路线
从坎莫尔到彭措林可以怎么走	{彭措林=目的城市, 坎莫尔=出发城市}	大行程路线
从萨尔茨堡到汉堡可以怎么走	{汉堡=目的城市, 萨尔茨堡=出发城市}	大行程路线
从霍伦到千叶市可以怎么走	{霍伦=出发城市, 千叶市=目的城市}	大行程路线
从西哈努克到拉彭兰塔可以怎么走	{拉彭兰塔=目的城市, 西哈努克=出发城市}	大行程路线
从镰仓到尼斯可以怎么走	{镰仓=出发城市, 尼斯=目的城市}	大行程路线
从赫尔辛格到日内瓦可以怎么走	{赫尔辛格=出发城市, 日内瓦=目的城市}	大行程路线
从卡法萨巴到里雄莱锡安可以怎么走	{里雄莱锡安=目的城市, 卡法萨巴=出发城市}	大行程路线
从丰盛港到锡耶纳可以怎么走	{丰盛港=出发城市, 锡耶纳=目的城市}	大行程路线
从内罗毕到圣何塞可以怎么走	{内罗毕=出发城市, 圣何塞=目的城市}	大行程路线
从罗什平纳到罗马可以怎么走	{罗马=目的城市, 罗什平纳=出发城市}	大行程路线
从锡瓦绿洲到亚庇可以怎么走	{亚庇=目的城市, 锡瓦绿洲=出发城市}	大行程路线
从内罗毕到镰仓可以怎么走	{镰仓=目的城市, 内罗毕=出发城市}	大行程路线
从海牙到伊萨菲厄泽可以怎么走	{伊萨菲厄泽=目的城市, 海牙=出发城市}	大行程路线
从希欧福克到林雪平可以怎么走	{希欧福克=出发城市, 林雪平=目的城市}	大行程路线
从利马到圣安德烈可以怎么走	{圣安德烈=目的城市, 利马=出发城市}	大行程路线
从加勒到图卢兹可以怎么走	{图卢兹=目的城市, 加勒=出发城市}	大行程路线
从埃德蒙顿到巴塞罗那可以怎么走	{埃德蒙顿=出发城市, 巴塞罗那=目的城市}	大行程路线
从锡切斯到马特勒可以怎么走	{锡切斯=出发城市, 马特勒=目的城市}	大行程路线
从费城到美蕊沙可以怎么走	{美蕊沙=目的城市, 费城=出发城市}	大行程路线
从民丹岛到霍基蒂卡可以怎么走	{霍基蒂卡=目的城市, 民丹岛=出发城市}	大行程路线
从大田到山打根可以怎么走	{山打根=目的城市, 大田=出发城市}	大行程路线
从阿纳海姆到摩苏尔可以怎么走	{阿纳海姆=出发城市, 摩苏尔=目的城市}	大行程路线
从拉什特到伊斯兰堡可以怎么走	{伊斯兰堡=目的城市, 拉什特=出发城市}	大行程路线
从白沙瓦到黑维兹可以怎么走	{白沙瓦=出发城市, 黑维兹=目的城市}	大行程路线
从仙本那到比雷埃夫斯可以怎么走	{仙本那=出发城市, 比雷埃夫斯=目的城市}	大行程路线
从奥洛穆茨到维也纳可以怎么走	{奥洛穆茨=出发城市, 维也纳=目的城市}	大行程路线
从锡切斯到加勒可以怎么走	{锡切斯=出发城市, 加勒=目的城市}	大行程路线
从加里宁格勒到纽伦堡可以怎么走	{加里宁格勒=出发城市, 纽伦堡=目的城市}	大行程路线
从会安到弗拉基米尔可以怎么走	{会安=出发城市, 弗拉基米尔=目的城市}	大行程路线
从米伦到干尼亚可以怎么走	{米伦=出发城市, 干尼亚=目的城市}	大行程路线
从夏威夷到象岛可以怎么走	{象岛=目的城市, 夏威夷=出发城市}	大行程路线
从霍伦到比萨可以怎么走	{比萨=目的城市, 霍伦=出发城市}	大行程路线
从安特卫普到阿莱姆港可以怎么走	{安特卫普=出发城市, 阿莱姆港=目的城市}	大行程路线
从锡切斯到南池市场可以怎么走	{锡切斯=出发城市, 南池市场=目的城市}	大行程路线
从萨法加到马尼拉可以怎么走	{马尼拉=目的城市, 萨法加=出发城市}	大行程路线
从弗拉基米尔到哈尔施塔特可以怎么走	{弗拉基米尔=出发城市, 哈尔施塔特=目的城市}	大行程路线
从帕罗斯到班贝格可以怎么走	{班贝格=目的城市, 帕罗斯=出发城市}	大行程路线
从谢尔盖耶夫到宇治可以怎么走	{谢尔盖耶夫=出发城市, 宇治=目的城市}	大行程路线
从首尔到羊角村可以怎么走	{羊角村=目的城市, 首尔=出发城市}	大行程路线
从惠斯勒到卢卡拉可以怎么走	{卢卡拉=目的城市, 惠斯勒=出发城市}	大行程路线
从会安到万鸦老可以怎么走	{会安=出发城市, 万鸦老=目的城市}	大行程路线
从海兰泡到伊兹密尔可以怎么走	{伊兹密尔=目的城市, 海兰泡=出发城市}	大行程路线
从隆德到莫尔斯比港可以怎么走	{隆德=出发城市, 莫尔斯比港=目的城市}	大行程路线
从伊拉克利翁到城南市可以怎么走	{伊拉克利翁=出发城市, 城南市=目的城市}	大行程路线
从黄金海岸到伊斯法罕可以怎么走	{黄金海岸=出发城市, 伊斯法罕=目的城市}	大行程路线
从马特莱到里弗赛德可以怎么走	{马特莱=出发城市, 里弗赛德=目的城市}	大行程路线
从蒙达到密西沙加可以怎么走	{蒙达=出发城市, 密西沙加=目的城市}	大行程路线
从西西里岛到会晒可以怎么走	{会晒=目的城市, 西西里岛=出发城市}	大行程路线
从伊斯法罕到马贝拉可以怎么走	{伊斯法罕=出发城市, 马贝拉=目的城市}	大行程路线
从法鲁到列治文可以怎么走	{法鲁=出发城市, 列治文=目的城市}	大行程路线
从羊角村到坦加勒可以怎么走	{羊角村=出发城市, 坦加勒=目的城市}	大行程路线
从基拉尼到比隆可以怎么走	{基拉尼=出发城市, 比隆=目的城市}	大行程路线
从巴德伊舍到牛津可以怎么走	{巴德伊舍=出发城市, 牛津=目的城市}	大行程路线
从苏伊士到圣保罗可以怎么走	{苏伊士=出发城市, 圣保罗=目的城市}	大行程路线
从丁格尔到乌得勒支可以怎么走	{乌得勒支=目的城市, 丁格尔=出发城市}	大行程路线
从釜山到朗布尔可以怎么走	{朗布尔=目的城市, 釜山=出发城市}	大行程路线
从福冈到格蒙登可以怎么走	{福冈=出发城市, 格蒙登=目的城市}	大行程路线
从内比都到沙姆沙伊赫可以怎么走	{内比都=出发城市, 沙姆沙伊赫=目的城市}	大行程路线
从布法罗到指宿市可以怎么走	{指宿市=目的城市, 布法罗=出发城市}	大行程路线
从箱根到仁川可以怎么走	{仁川=目的城市, 箱根=出发城市}	大行程路线
从波茨坦到萨斯卡通可以怎么走	{波茨坦=出发城市, 萨斯卡通=目的城市}	大行程路线
从庆州到迈泰奥拉可以怎么走	{庆州=出发城市, 迈泰奥拉=目的城市}	大行程路线
从南池市场到马当可以怎么走	{马当=目的城市, 南池市场=出发城市}	大行程路线
从内罗毕到克拉克可以怎么走	{克拉克=目的城市, 内罗毕=出发城市}	大行程路线
从锡瓦绿洲到奥兰多可以怎么走	{奥兰多=目的城市, 锡瓦绿洲=出发城市}	大行程路线
从伊卡到阿尔布费拉可以怎么走	{阿尔布费拉=目的城市, 伊卡=出发城市}	大行程路线
从海参崴到马尔默可以怎么走	{海参崴=出发城市, 马尔默=目的城市}	大行程路线
从巴拉顿菲赖德到帕萨迪纳可以怎么走	{巴拉顿菲赖德=出发城市, 帕萨迪纳=目的城市}	大行程路线
从伊斯梅利亚到尼甘布可以怎么走	{伊斯梅利亚=出发城市, 尼甘布=目的城市}	大行程路线
从圣马洛到富良野可以怎么走	{富良野=目的城市, 圣马洛=出发城市}	大行程路线
从蒙特利尔到眉谬可以怎么走	{蒙特利尔=出发城市, 眉谬=目的城市}	大行程路线
从比尔森到斯蒂基斯霍尔米可以怎么走	{斯蒂基斯霍尔米=目的城市, 比尔森=出发城市}	大行程路线
从帕岸岛到哥德堡可以怎么走	{帕岸岛=出发城市, 哥德堡=目的城市}	大行程路线
从高山到威尼斯可以怎么走	{威尼斯=目的城市, 高山=出发城市}	大行程路线
从圣卡洛斯-德巴里洛切到波尔多可以怎么走	{圣卡洛斯-德巴里洛切=出发城市, 波尔多=目的城市}	大行程路线
从拉斯维加斯到维亚纳堡可以怎么走	{拉斯维加斯=出发城市, 维亚纳堡=目的城市}	大行程路线
从朗布尔到吉大港可以怎么走	{朗布尔=出发城市, 吉大港=目的城市}	大行程路线
从龙达到多哈可以怎么走	{多哈=目的城市, 龙达=出发城市}	大行程路线
从伊尔库茨克到丰盛港可以怎么走	{伊尔库茨克=出发城市, 丰盛港=目的城市}	大行程路线
从巴淡岛到维亚纳堡可以怎么走	{巴淡岛=出发城市, 维亚纳堡=目的城市}	大行程路线
从米兰到波尔图可以怎么走	{米兰=出发城市, 波尔图=目的城市}	大行程路线
从纽伦堡到设拉子可以怎么走	{纽伦堡=出发城市, 设拉子=目的城市}	大行程路线
从涛岛到塞哥维亚可以怎么走	{塞哥维亚=目的城市, 涛岛=出发城市}	大行程路线
从巴盖尔哈德到阿里山可以怎么走	{巴盖尔哈德=出发城市, 阿里山=目的城市}	大行程路线
从施瓦茨到博洛尼亚可以怎么走	{施瓦茨=出发城市, 博洛尼亚=目的城市}	大行程路线
从蒙特利尔到尼斯可以怎么走	{蒙特利尔=出发城市, 尼斯=目的城市}	大行程路线
从桃园到纳帕可以怎么走	{桃园=出发城市, 纳帕=目的城市}	大行程路线
从艾图塔基到塞格德可以怎么走	{塞格德=目的城市, 艾图塔基=出发城市}	大行程路线
怎样能从琅勃拉邦去到文根	{琅勃拉邦=出发城市, 文根=目的城市}	大行程路线
怎样能从赞丹去到仁川	{仁川=目的城市, 赞丹=出发城市}	大行程路线
怎样能从吉马良斯去到法鲁	{法鲁=目的城市, 吉马良斯=出发城市}	大行程路线
怎样能从番红花城去到巴盖尔哈德	{巴盖尔哈德=目的城市, 番红花城=出发城市}	大行程路线
怎样能从米茨佩拉蒙去到布里斯班	{米茨佩拉蒙=出发城市, 布里斯班=目的城市}	大行程路线
怎样能从河内去到图尔库	{河内=出发城市, 图尔库=目的城市}	大行程路线
怎样能从卢戈去到波茨坦	{波茨坦=目的城市, 卢戈=出发城市}	大行程路线
怎样能从洛桑去到拿撒勒	{洛桑=出发城市, 拿撒勒=目的城市}	大行程路线
怎样能从奥洛穆茨去到奥卢	{奥洛穆茨=出发城市, 奥卢=目的城市}	大行程路线
怎样能从伊斯梅利亚去到卡尔加里	{卡尔加里=目的城市, 伊斯梅利亚=出发城市}	大行程路线
怎样能从奥卢去到塞哥维亚	{塞哥维亚=目的城市, 奥卢=出发城市}	大行程路线
怎样能从里尔去到奥尔堡	{奥尔堡=目的城市, 里尔=出发城市}	大行程路线
怎样能从利雅得去到苏伊士	{苏伊士=目的城市, 利雅得=出发城市}	大行程路线
怎样能从贾夫纳去到干尼亚	{贾夫纳=出发城市, 干尼亚=目的城市}	大行程路线
怎样能从圣吉尔根去到科莫	{科莫=目的城市, 圣吉尔根=出发城市}	大行程路线
怎样能从下龙湾去到根特	{下龙湾=出发城市, 根特=目的城市}	大行程路线
怎样能从伊纳里去到巴拉望	{伊纳里=出发城市, 巴拉望=目的城市}	大行程路线
怎样能从巴生去到米蒂亚罗岛	{巴生=出发城市, 米蒂亚罗岛=目的城市}	大行程路线
怎样能从冲绳去到阿吉曼	{冲绳=出发城市, 阿吉曼=目的城市}	大行程路线
怎样能从卡塔尼亚去到埃武拉	{埃武拉=目的城市, 卡塔尼亚=出发城市}	大行程路线
怎样能从蔚山去到塞得港	{塞得港=目的城市, 蔚山=出发城市}	大行程路线
怎样能从圣吉米尼亚诺去到米湖	{圣吉米尼亚诺=出发城市, 米湖=目的城市}	大行程路线
怎样能从马卡蒂去到德布勒森	{马卡蒂=出发城市, 德布勒森=目的城市}	大行程路线
怎样能从第戎去到瓜拉登嘉楼	{瓜拉登嘉楼=目的城市, 第戎=出发城市}	大行程路线
怎样能从蒙达去到弗雷斯诺	{蒙达=出发城市, 弗雷斯诺=目的城市}	大行程路线
怎样能从花莲去到隆德	{花莲=出发城市, 隆德=目的城市}	大行程路线
怎样能从斯卡恩去到莫尔斯比港	{莫尔斯比港=目的城市, 斯卡恩=出发城市}	大行程路线
怎样能从金巴兰去到马德望	{金巴兰=出发城市, 马德望=目的城市}	大行程路线
怎样能从阿雷格里港去到惠斯勒	{阿雷格里港=出发城市, 惠斯勒=目的城市}	大行程路线
怎样能从尼斯去到圣卡洛斯-德巴里洛切	{圣卡洛斯-德巴里洛切=目的城市, 尼斯=出发城市}	大行程路线
怎样能从阿拉梅达去到鹿特丹	{鹿特丹=目的城市, 阿拉梅达=出发城市}	大行程路线
怎样能从帕皮提去到密西沙加	{帕皮提=出发城市, 密西沙加=目的城市}	大行程路线
怎样能从卢塞恩去到布尔诺	{布尔诺=目的城市, 卢塞恩=出发城市}	大行程路线
怎样能从米伦去到伯明翰	{伯明翰=目的城市, 米伦=出发城市}	大行程路线
怎样能从春蓬去到奥卢	{奥卢=目的城市, 春蓬=出发城市}	大行程路线
怎样能从卡塔赫纳去到哈利法克斯	{哈利法克斯=目的城市, 卡塔赫纳=出发城市}	大行程路线
怎样能从丁格尔去到摩苏尔	{摩苏尔=目的城市, 丁格尔=出发城市}	大行程路线
怎样能从努韦巴去到迈阿密	{努韦巴=出发城市, 迈阿密=目的城市}	大行程路线
怎样能从帕斯托去到彰化	{帕斯托=出发城市, 彰化=目的城市}	大行程路线
怎样能从威尼斯去到蓝梦岛	{威尼斯=出发城市, 蓝梦岛=目的城市}	大行程路线
怎样能从西雅图去到沙努尔	{沙努尔=目的城市, 西雅图=出发城市}	大行程路线
怎样能从新北去到巴拉顿菲赖德	{巴拉顿菲赖德=目的城市, 新北=出发城市}	大行程路线
怎样能从布达佩斯去到厄吕代尼兹	{布达佩斯=出发城市, 厄吕代尼兹=目的城市}	大行程路线
怎样能从帕拉阿图去到凯夫拉维克	{凯夫拉维克=目的城市, 帕拉阿图=出发城市}	大行程路线
怎样能从温尼伯去到莱顿	{温尼伯=出发城市, 莱顿=目的城市}	大行程路线
怎样能从班贝格去到蒂阿瑙	{班贝格=出发城市, 蒂阿瑙=目的城市}	大行程路线
怎样能从沙勒罗瓦去到爱丽丝泉	{爱丽丝泉=目的城市, 沙勒罗瓦=出发城市}	大行程路线
怎样能从埃勒去到波蓬德塔	{埃勒=出发城市, 波蓬德塔=目的城市}	大行程路线
怎样能从库特纳霍拉去到延雪平	{延雪平=目的城市, 库特纳霍拉=出发城市}	大行程路线
怎样能从科罗尔去到恩格尔贝格	{恩格尔贝格=目的城市, 科罗尔=出发城市}	大行程路线
怎样能从欧登塞去到卡拉奇	{欧登塞=出发城市, 卡拉奇=目的城市}	大行程路线
怎样能从豪尔去到纳加阔特	{纳加阔特=目的城市, 豪尔=出发城市}	大行程路线
怎样能从阿莱姆港去到夏威夷	{夏威夷=目的城市, 阿莱姆港=出发城市}	大行程路线
怎样能从格雷梅去到登巴萨	{格雷梅=出发城市, 登巴萨=目的城市}	大行程路线
怎样能从罗弗敦群岛去到弗拉基米尔	{罗弗敦群岛=出发城市, 弗拉基米尔=目的城市}	大行程路线
怎样能从万荣去到塞萨洛尼基	{万荣=出发城市, 塞萨洛尼基=目的城市}	大行程路线
怎样能从达沃斯去到拉什特	{达沃斯=出发城市, 拉什特=目的城市}	大行程路线
怎样能从基洛纳去到凯夫拉维克	{基洛纳=出发城市, 凯夫拉维克=目的城市}	大行程路线
怎样能从加勒去到旧金山	{旧金山=目的城市, 加勒=出发城市}	大行程路线
怎样能从扎金索斯去到佩雷拉	{扎金索斯=出发城市, 佩雷拉=目的城市}	大行程路线
怎样能从鹿特丹去到吉马良斯	{吉马良斯=目的城市, 鹿特丹=出发城市}	大行程路线
怎样能从苏拉哈去到彭措林	{彭措林=目的城市, 苏拉哈=出发城市}	大行程路线
怎样能从布法罗去到宫崎市	{布法罗=出发城市, 宫崎市=目的城市}	大行程路线
怎样能从素可泰去到垦丁	{素可泰=出发城市, 垦丁=目的城市}	大行程路线
怎样能从仰光去到霍基蒂卡	{仰光=出发城市, 霍基蒂卡=目的城市}	大行程路线
怎样能从丰沙尔去到施皮茨	{丰沙尔=出发城市, 施皮茨=目的城市}	大行程路线
怎样能从美奈去到大溪地	{大溪地=目的城市, 美奈=出发城市}	大行程路线
怎样能从弗雷斯诺去到基隆	{弗雷斯诺=出发城市, 基隆=目的城市}	大行程路线
怎样能从阿努拉德普勒去到碧瑶	{阿努拉德普勒=出发城市, 碧瑶=目的城市}	大行程路线
怎样能从朗塞斯顿去到马贝拉	{朗塞斯顿=出发城市, 马贝拉=目的城市}	大行程路线
怎样能从纳帕去到多伦多	{多伦多=目的城市, 纳帕=出发城市}	大行程路线
怎样能从兰达岛去到富吉拉	{兰达岛=出发城市, 富吉拉=目的城市}	大行程路线
怎样能从斯德哥尔摩去到鹿特丹	{斯德哥尔摩=出发城市, 鹿特丹=目的城市}	大行程路线
怎样能从水原去到屏东	{水原=出发城市, 屏东=目的城市}	大行程路线
怎样能从布达佩斯去到温尼伯	{布达佩斯=出发城市, 温尼伯=目的城市}	大行程路线
怎样能从磅湛去到伯尔尼	{伯尔尼=目的城市, 磅湛=出发城市}	大行程路线
怎样能从涛岛去到卢塞恩	{卢塞恩=目的城市, 涛岛=出发城市}	大行程路线
怎样能从旧金山去到林茨	{旧金山=出发城市, 林茨=目的城市}	大行程路线
怎样能从蒂阿瑙去到新潟	{新潟=目的城市, 蒂阿瑙=出发城市}	大行程路线
怎样能从锡切斯去到戈罗卡	{锡切斯=出发城市, 戈罗卡=目的城市}	大行程路线
怎样能从沃斯去到谢菲尔德	{沃斯=出发城市, 谢菲尔德=目的城市}	大行程路线
怎样能从大阪去到马尼拉	{马尼拉=目的城市, 大阪=出发城市}	大行程路线
怎样能从波尔多去到格拉茨	{格拉茨=目的城市, 波尔多=出发城市}	大行程路线
怎样能从维谢格拉德去到摩尔曼斯克	{维谢格拉德=出发城市, 摩尔曼斯克=目的城市}	大行程路线
怎样能从庆州去到布里斯班	{庆州=出发城市, 布里斯班=目的城市}	大行程路线
怎样能从圣卡洛斯-德巴里洛切去到波茨坦	{圣卡洛斯-德巴里洛切=出发城市, 波茨坦=目的城市}	大行程路线
怎样能从新加坡去到福森	{福森=目的城市, 新加坡=出发城市}	大行程路线
怎样能从兰达岛去到波尔多	{波尔多=目的城市, 兰达岛=出发城市}	大行程路线
怎样能从拉罗汤加岛去到阿德莱德	{拉罗汤加岛=出发城市, 阿德莱德=目的城市}	大行程路线
怎样能从戛纳去到博卡拉	{博卡拉=目的城市, 戛纳=出发城市}	大行程路线
怎样能从埃拉特去到苏莱曼尼亚	{埃拉特=出发城市, 苏莱曼尼亚=目的城市}	大行程路线
怎样能从奥斯坦德去到长野	{奥斯坦德=出发城市, 长野=目的城市}	大行程路线
怎样能从瓦伊塔佩去到沙美岛	{沙美岛=目的城市, 瓦伊塔佩=出发城市}	大行程路线
怎样能从德尔斐去到毛里求斯	{德尔斐=出发城市, 毛里求斯=目的城市}	大行程路线
怎样能从万荣去到马斯特里赫特	{万荣=出发城市, 马斯特里赫特=目的城市}	大行程路线
怎样能从北宾去到西哈努克	{西哈努克=目的城市, 北宾=出发城市}	大行程路线
怎样能从奥比都斯去到宇治	{奥比都斯=出发城市, 宇治=目的城市}	大行程路线
怎样能从巴黎去到龙仁市	{巴黎=出发城市, 龙仁市=目的城市}	大行程路线
怎样能从伊势去到北碧府	{北碧府=目的城市, 伊势=出发城市}	大行程路线
怎样能从巴塞罗那去到坎莫尔	{巴塞罗那=出发城市, 坎莫尔=目的城市}	大行程路线
从科莫去库尔纳有什么方式	{科莫=出发城市, 库尔纳=目的城市}	大行程路线
从贝尔法斯特去北九州有什么方式	{贝尔法斯特=出发城市, 北九州=目的城市}	大行程路线
从磅湛去布鲁塞尔有什么方式	{布鲁塞尔=目的城市, 磅湛=出发城市}	大行程路线
从利兹去斯塔万格有什么方式	{斯塔万格=目的城市, 利兹=出发城市}	大行程路线
从彭措林去珀斯有什么方式	{珀斯=目的城市, 彭措林=出发城市}	大行程路线
从拿骚去维也纳有什么方式	{拿骚=出发城市, 维也纳=目的城市}	大行程路线
从西西里岛去大邱有什么方式	{大邱=目的城市, 西西里岛=出发城市}	大行程路线
从乌斯怀亚去金斯顿有什么方式	{金斯顿=目的城市, 乌斯怀亚=出发城市}	大行程路线
从格雷梅去文根有什么方式	{格雷梅=出发城市, 文根=目的城市}	大行程路线
从洛杉矶去富川有什么方式	{富川=目的城市, 洛杉矶=出发城市}	大行程路线
从迈泰奥拉去圣路易斯有什么方式	{圣路易斯=目的城市, 迈泰奥拉=出发城市}	大行程路线
从拉包尔去兰卡威有什么方式	{拉包尔=出发城市, 兰卡威=目的城市}	大行程路线
从塞格德去圣保罗有什么方式	{塞格德=出发城市, 圣保罗=目的城市}	大行程路线
从梅赫伦去阿雷基帕有什么方式	{梅赫伦=出发城市, 阿雷基帕=目的城市}	大行程路线
从基尔根尼去莫尔斯比港有什么方式	{莫尔斯比港=目的城市, 基尔根尼=出发城市}	大行程路线
从网走去佩奇有什么方式	{网走=出发城市, 佩奇=目的城市}	大行程路线
从弗洛姆去迈阿密有什么方式	{弗洛姆=出发城市, 迈阿密=目的城市}	大行程路线
从碧瑶去列日有什么方式	{碧瑶=出发城市, 列日=目的城市}	大行程路线
从蓝梦岛去布姆唐有什么方式	{布姆唐=目的城市, 蓝梦岛=出发城市}	大行程路线
从莫斯科去拉斯佩齐亚有什么方式	{莫斯科=出发城市, 拉斯佩齐亚=目的城市}	大行程路线
从会晒去马尔代夫有什么方式	{会晒=出发城市, 马尔代夫=目的城市}	大行程路线
从富吉拉去都柏林有什么方式	{都柏林=目的城市, 富吉拉=出发城市}	大行程路线
从尔湾去卢克索有什么方式	{尔湾=出发城市, 卢克索=目的城市}	大行程路线
从鹿特丹去爱丽丝泉有什么方式	{爱丽丝泉=目的城市, 鹿特丹=出发城市}	大行程路线
从陶尔米纳去台东有什么方式	{陶尔米纳=出发城市, 台东=目的城市}	大行程路线
从苏兹达尔去戈公有什么方式	{戈公=目的城市, 苏兹达尔=出发城市}	大行程路线
从北碧府去亭可马里有什么方式	{亭可马里=目的城市, 北碧府=出发城市}	大行程路线
从昆卡去科隆有什么方式	{昆卡=出发城市, 科隆=目的城市}	大行程路线
从皮皮岛去库特纳霍拉有什么方式	{皮皮岛=出发城市, 库特纳霍拉=目的城市}	大行程路线
从皮皮岛去巴塞卢什有什么方式	{巴塞卢什=目的城市, 皮皮岛=出发城市}	大行程路线
从万荣去多特蒙德有什么方式	{多特蒙德=目的城市, 万荣=出发城市}	大行程路线
从岘港去普吉岛有什么方式	{普吉岛=目的城市, 岘港=出发城市}	大行程路线
从布达佩斯去慕尼黑有什么方式	{布达佩斯=出发城市, 慕尼黑=目的城市}	大行程路线
从斯图加特去河内有什么方式	{斯图加特=出发城市, 河内=目的城市}	大行程路线
从奥胡斯去淡水有什么方式	{奥胡斯=出发城市, 淡水=目的城市}	大行程路线
从美里去惠灵顿有什么方式	{惠灵顿=目的城市, 美里=出发城市}	大行程路线
从良瑞去福伦丹有什么方式	{福伦丹=目的城市, 良瑞=出发城市}	大行程路线
从蒙特雷去亚庇有什么方式	{亚庇=目的城市, 蒙特雷=出发城市}	大行程路线
从特罗姆瑟去大溪地有什么方式	{大溪地=目的城市, 特罗姆瑟=出发城市}	大行程路线
从阿莱姆港去岘港有什么方式	{岘港=目的城市, 阿莱姆港=出发城市}	大行程路线
从伯尔尼去冲绳有什么方式	{伯尔尼=出发城市, 冲绳=目的城市}	大行程路线
从箱根去罗什平纳有什么方式	{箱根=出发城市, 罗什平纳=目的城市}	大行程路线
从劳特布龙嫩去格拉纳达有什么方式	{劳特布龙嫩=出发城市, 格拉纳达=目的城市}	大行程路线
从马赛马拉去温特图尔有什么方式	{温特图尔=目的城市, 马赛马拉=出发城市}	大行程路线
从奥克兰去图恩有什么方式	{图恩=目的城市, 奥克兰=出发城市}	大行程路线
从金泽去奥洛穆茨有什么方式	{奥洛穆茨=目的城市, 金泽=出发城市}	大行程路线
从马斯帕洛马斯去伊萨菲厄泽有什么方式	{伊萨菲厄泽=目的城市, 马斯帕洛马斯=出发城市}	大行程路线
从淡水去图恩有什么方式	{图恩=目的城市, 淡水=出发城市}	大行程路线
从纽卡斯尔去埃勒有什么方式	{埃勒=目的城市, 纽卡斯尔=出发城市}	大行程路线
从里约热内卢去卡斯凯什有什么方式	{卡斯凯什=目的城市, 里约热内卢=出发城市}	大行程路线
从旭川去小樽有什么方式	{小樽=目的城市, 旭川=出发城市}	大行程路线
从费城去特内里费岛有什么方式	{特内里费岛=目的城市, 费城=出发城市}	大行程路线
从海德堡去阿莱姆港有什么方式	{海德堡=出发城市, 阿莱姆港=目的城市}	大行程路线
从金门去法尤姆有什么方式	{法尤姆=目的城市, 金门=出发城市}	大行程路线
从魁北克市去捷克布杰约维采有什么方式	{魁北克市=出发城市, 捷克布杰约维采=目的城市}	大行程路线
从沙迦去嘉义有什么方式	{沙迦=出发城市, 嘉义=目的城市}	大行程路线
从辛特拉去阿蒂乌岛有什么方式	{辛特拉=出发城市, 阿蒂乌岛=目的城市}	大行程路线
从昌原去罗腾堡有什么方式	{罗腾堡=目的城市, 昌原=出发城市}	大行程路线
从淡水去鲁尔蒙德有什么方式	{淡水=出发城市, 鲁尔蒙德=目的城市}	大行程路线
从伯克利去瓦伊塔佩有什么方式	{伯克利=出发城市, 瓦伊塔佩=目的城市}	大行程路线
从毕尔巴鄂去卡塔赫纳有什么方式	{毕尔巴鄂=出发城市, 卡塔赫纳=目的城市}	大行程路线
从南特去弗雷斯诺有什么方式	{弗雷斯诺=目的城市, 南特=出发城市}	大行程路线
从八打灵再也去五渔村有什么方式	{五渔村=目的城市, 八打灵再也=出发城市}	大行程路线
从卡法亚特去圣路易斯有什么方式	{圣路易斯=目的城市, 卡法亚特=出发城市}	大行程路线
从全州去科英布拉有什么方式	{科英布拉=目的城市, 全州=出发城市}	大行程路线
从亚历山大去大叻有什么方式	{亚历山大=出发城市, 大叻=目的城市}	大行程路线
从冲绳去奥基有什么方式	{冲绳=出发城市, 奥基=目的城市}	大行程路线
从瓦纳卡去厄勒布鲁有什么方式	{瓦纳卡=出发城市, 厄勒布鲁=目的城市}	大行程路线
从赫尔辛格去赖扬有什么方式	{赖扬=目的城市, 赫尔辛格=出发城市}	大行程路线
从瓦伦西亚去东京有什么方式	{瓦伦西亚=出发城市, 东京=目的城市}	大行程路线
从维罗纳去阿努拉德普勒有什么方式	{阿努拉德普勒=目的城市, 维罗纳=出发城市}	大行程路线
从罗托鲁瓦去帕坦有什么方式	{罗托鲁瓦=出发城市, 帕坦=目的城市}	大行程路线
从纳斯卡去古晋有什么方式	{纳斯卡=出发城市, 古晋=目的城市}	大行程路线
从河内去帕坦有什么方式	{帕坦=目的城市, 河内=出发城市}	大行程路线
从巴塔利亚去诺丁汉有什么方式	{诺丁汉=目的城市, 巴塔利亚=出发城市}	大行程路线
从马赛马拉去美蕊沙有什么方式	{美蕊沙=目的城市, 马赛马拉=出发城市}	大行程路线
从苏伊士去尼斯有什么方式	{苏伊士=出发城市, 尼斯=目的城市}	大行程路线
从莫尔斯比港去谢菲尔德有什么方式	{莫尔斯比港=出发城市, 谢菲尔德=目的城市}	大行程路线
从福森去纳哈里亚有什么方式	{福森=出发城市, 纳哈里亚=目的城市}	大行程路线
从伦敦去卡法萨巴有什么方式	{伦敦=出发城市, 卡法萨巴=目的城市}	大行程路线
从高威去阿尔布费拉有什么方式	{阿尔布费拉=目的城市, 高威=出发城市}	大行程路线
从哥德堡去利物浦有什么方式	{利物浦=目的城市, 哥德堡=出发城市}	大行程路线
从清迈去罗弗敦群岛有什么方式	{罗弗敦群岛=目的城市, 清迈=出发城市}	大行程路线
从华富里去波隆纳鲁沃有什么方式	{波隆纳鲁沃=目的城市, 华富里=出发城市}	大行程路线
从宿雾去大阪有什么方式	{宿雾=出发城市, 大阪=目的城市}	大行程路线
从贝特默阿尔卑去维尔茨堡有什么方式	{贝特默阿尔卑=出发城市, 维尔茨堡=目的城市}	大行程路线
从马尔代夫去卡普里岛有什么方式	{马尔代夫=出发城市, 卡普里岛=目的城市}	大行程路线
从白马市去布姆唐有什么方式	{布姆唐=目的城市, 白马市=出发城市}	大行程路线
从普雷韦扎去蒂瑟默哈拉默有什么方式	{蒂瑟默哈拉默=目的城市, 普雷韦扎=出发城市}	大行程路线
从奈良去尼亚加拉瀑布城有什么方式	{奈良=出发城市, 尼亚加拉瀑布城=目的城市}	大行程路线
从延雪平去巴西利亚有什么方式	{延雪平=出发城市, 巴西利亚=目的城市}	大行程路线
从万鸦老去蒂瑟默哈拉默有什么方式	{蒂瑟默哈拉默=目的城市, 万鸦老=出发城市}	大行程路线
从罗弗敦群岛去云林有什么方式	{罗弗敦群岛=出发城市, 云林=目的城市}	大行程路线
从乌布去罗勇有什么方式	{乌布=出发城市, 罗勇=目的城市}	大行程路线
从海牙去特隆赫姆有什么方式	{特隆赫姆=目的城市, 海牙=出发城市}	大行程路线
从波隆纳鲁沃去台南有什么方式	{波隆纳鲁沃=出发城市, 台南=目的城市}	大行程路线
从巴生去阿蒂乌岛有什么方式	{巴生=出发城市, 阿蒂乌岛=目的城市}	大行程路线
从悉尼去玛琅有什么方式	{玛琅=目的城市, 悉尼=出发城市}	大行程路线
从象岛去塔维拉有什么方式	{塔维拉=目的城市, 象岛=出发城市}	大行程路线
从皮皮岛去南投有什么方式	{南投=目的城市, 皮皮岛=出发城市}	大行程路线
MI965航班的降落时间是？	{MI965=航班号, 降落时间=航班属性}	航班的属性
ZH9023航班的起飞时间是？	{ZH9023=航班号, 起飞时间=航班属性}	航班的属性
MI965航班的限重是？	{MI965=航班号, 限重=航班属性}	航班的属性
ZH9005航班的经停地点是？	{经停地点=航班属性, ZH9005=航班号}	航班的属性
MU2858航班的降落时间是？	{MU2858=航班号, 降落时间=航班属性}	航班的属性
FD0597航班的降落时间是？	{FD0597=航班号, 降落时间=航班属性}	航班的属性
ZH9005航班的候机位置是？	{候机位置=航班属性, ZH9005=航班号}	航班的属性
ZH9023航班的限重是？	{ZH9023=航班号, 限重=航班属性}	航班的属性
CZ6083航班的候机位置是？	{候机位置=航班属性, CZ6083=航班号}	航班的属性
MI965航班的经停地点是？	{MI965=航班号, 经停地点=航班属性}	航班的属性
ZH9005航班的降落时间是？	{降落时间=航班属性, ZH9005=航班号}	航班的属性
MU2858航班的候机位置是？	{候机位置=航班属性, MU2858=航班号}	航班的属性
ZH9023航班的降落时间是？	{ZH9023=航班号, 降落时间=航班属性}	航班的属性
ZH9023航班的候机位置是？	{ZH9023=航班号, 候机位置=航班属性}	航班的属性
MU2858航班的起飞时间是？	{MU2858=航班号, 起飞时间=航班属性}	航班的属性
FD0597航班的起飞时间是？	{FD0597=航班号, 起飞时间=航班属性}	航班的属性
FD0597航班的限重是？	{FD0597=航班号, 限重=航班属性}	航班的属性
ZH9005航班的起飞时间是？	{起飞时间=航班属性, ZH9005=航班号}	航班的属性
ZH9005航班的限重是？	{ZH9005=航班号, 限重=航班属性}	航班的属性
CZ6083航班的限重是？	{CZ6083=航班号, 限重=航班属性}	航班的属性
ZH9023航班的经停地点是？	{ZH9023=航班号, 经停地点=航班属性}	航班的属性
FD0597航班的候机位置是？	{候机位置=航班属性, FD0597=航班号}	航班的属性
MI965航班的候机位置是？	{MI965=航班号, 候机位置=航班属性}	航班的属性
FD0597航班的经停地点是？	{FD0597=航班号, 经停地点=航班属性}	航班的属性
MI965航班的起飞时间是？	{MI965=航班号, 起飞时间=航班属性}	航班的属性
告诉我MI965航班的经停地点。	{MI965=航班号, 经停地点=航班属性}	航班的属性
告诉我ZH9023航班的候机位置。	{ZH9023=航班号, 候机位置=航班属性}	航班的属性
告诉我MI965航班的起飞时间。	{MI965=航班号, 起飞时间=航班属性}	航班的属性
告诉我ZH9005航班的候机位置。	{候机位置=航班属性, ZH9005=航班号}	航班的属性
告诉我MU2858航班的经停地点。	{MU2858=航班号, 经停地点=航班属性}	航班的属性
告诉我MI965航班的降落时间。	{MI965=航班号, 降落时间=航班属性}	航班的属性
告诉我ZH9005航班的降落时间。	{降落时间=航班属性, ZH9005=航班号}	航班的属性
告诉我CZ6083航班的限重。	{CZ6083=航班号, 限重=航班属性}	航班的属性
告诉我MU2858航班的起飞时间。	{MU2858=航班号, 起飞时间=航班属性}	航班的属性
告诉我ZH9023航班的降落时间。	{ZH9023=航班号, 降落时间=航班属性}	航班的属性
告诉我MI965航班的限重。	{MI965=航班号, 限重=航班属性}	航班的属性
告诉我MU2858航班的候机位置。	{候机位置=航班属性, MU2858=航班号}	航班的属性
告诉我CZ6083航班的经停地点。	{经停地点=航班属性, CZ6083=航班号}	航班的属性
告诉我CZ6083航班的起飞时间。	{起飞时间=航班属性, CZ6083=航班号}	航班的属性
告诉我FD0597航班的降落时间。	{FD0597=航班号, 降落时间=航班属性}	航班的属性
MU2858航班什么时候起飞？	{MU2858=航班号}	航班的属性
MI965航班什么时候起飞？	{MI965=航班号}	航班的属性
ZH9023航班什么时候起飞？	{ZH9023=航班号}	航班的属性
ZH9005航班什么时候起飞？	{ZH9005=航班号}	航班的属性
FD0597航班什么时候起飞？	{FD0597=航班号}	航班的属性
FD0597航班起飞时间是什么时候？	{FD0597=航班号}	航班的属性
ZH9005航班起飞时间是什么时候？	{ZH9005=航班号}	航班的属性
MI965航班起飞时间是什么时候？	{MI965=航班号}	航班的属性
CZ6083航班起飞时间是什么时候？	{CZ6083=航班号}	航班的属性
ZH9023航班起飞时间是什么时候？	{ZH9023=航班号}	航班的属性
告诉我MU2858航班什么时候起飞。	{MU2858=航班号}	航班的属性
告诉我FD0597航班什么时候起飞。	{FD0597=航班号}	航班的属性
告诉我ZH9005航班什么时候起飞。	{ZH9005=航班号}	航班的属性
告诉我ZH9023航班什么时候起飞。	{ZH9023=航班号}	航班的属性
告诉我MI965航班什么时候起飞。	{MI965=航班号}	航班的属性
告诉我FD0597航班几点起飞。	{FD0597=航班号}	航班的属性
告诉我MI965航班几点起飞。	{MI965=航班号}	航班的属性
告诉我ZH9005航班几点起飞。	{ZH9005=航班号}	航班的属性
告诉我ZH9023航班几点起飞。	{ZH9023=航班号}	航班的属性
告诉我MU2858航班几点起飞。	{MU2858=航班号}	航班的属性
FD0597航班起飞时间是几点？	{FD0597=航班号}	航班的属性
MI965航班起飞时间是几点？	{MI965=航班号}	航班的属性
MU2858航班起飞时间是几点？	{MU2858=航班号}	航班的属性
CZ6083航班起飞时间是几点？	{CZ6083=航班号}	航班的属性
ZH9005航班起飞时间是几点？	{ZH9005=航班号}	航班的属性
FD0597航班几点起飞？	{FD0597=航班号}	航班的属性
ZH9005航班几点起飞？	{ZH9005=航班号}	航班的属性
MI965航班几点起飞？	{MI965=航班号}	航班的属性
ZH9023航班几点起飞？	{ZH9023=航班号}	航班的属性
CZ6083航班几点起飞？	{CZ6083=航班号}	航班的属性
MU2858航班几点起飞？	{MU2858=航班号}	航班的属性
CZ6083航班什么时候降落？	{CZ6083=航班号}	航班的属性
MU2858航班什么时候降落？	{MU2858=航班号}	航班的属性
ZH9023航班什么时候降落？	{ZH9023=航班号}	航班的属性
FD0597航班什么时候降落？	{FD0597=航班号}	航班的属性
ZH9005航班什么时候降落？	{ZH9005=航班号}	航班的属性
MI965航班什么时候降落？	{MI965=航班号}	航班的属性
ZH9023航班降落时间是什么时候？	{ZH9023=航班号}	航班的属性
CZ6083航班降落时间是什么时候？	{CZ6083=航班号}	航班的属性
MU2858航班降落时间是什么时候？	{MU2858=航班号}	航班的属性
MI965航班降落时间是什么时候？	{MI965=航班号}	航班的属性
ZH9005航班降落时间是什么时候？	{ZH9005=航班号}	航班的属性
告诉我ZH9023航班什么时候降落。	{ZH9023=航班号}	航班的属性
告诉我ZH9005航班什么时候降落。	{ZH9005=航班号}	航班的属性
告诉我MU2858航班什么时候降落。	{MU2858=航班号}	航班的属性
告诉我FD0597航班什么时候降落。	{FD0597=航班号}	航班的属性
告诉我MI965航班什么时候降落。	{MI965=航班号}	航班的属性
告诉我CZ6083航班什么时候降落。	{CZ6083=航班号}	航班的属性
告诉我MI965航班几点降落。	{MI965=航班号}	航班的属性
告诉我ZH9005航班几点降落。	{ZH9005=航班号}	航班的属性
告诉我CZ6083航班几点降落。	{CZ6083=航班号}	航班的属性
告诉我MU2858航班几点降落。	{MU2858=航班号}	航班的属性
告诉我FD0597航班几点降落。	{FD0597=航班号}	航班的属性
告诉我ZH9023航班几点降落。	{ZH9023=航班号}	航班的属性
CZ6083航班降落时间是几点？	{CZ6083=航班号}	航班的属性
MI965航班降落时间是几点？	{MI965=航班号}	航班的属性
FD0597航班降落时间是几点？	{FD0597=航班号}	航班的属性
ZH9023航班降落时间是几点？	{ZH9023=航班号}	航班的属性
ZH9005航班降落时间是几点？	{ZH9005=航班号}	航班的属性
MU2858航班降落时间是几点？	{MU2858=航班号}	航班的属性
ZH9005航班几点降落？	{ZH9005=航班号}	航班的属性
FD0597航班几点降落？	{FD0597=航班号}	航班的属性
MU2858航班几点降落？	{MU2858=航班号}	航班的属性
MI965航班几点降落？	{MI965=航班号}	航班的属性
ZH9023航班几点降落？	{ZH9023=航班号}	航班的属性
CZ6083航班几点降落？	{CZ6083=航班号}	航班的属性
ZH9023在哪里候机？	{ZH9023=航班号}	航班的属性
ZH9005在哪里候机？	{ZH9005=航班号}	航班的属性
MI965在哪里候机？	{MI965=航班号}	航班的属性
MU2858在哪里候机？	{MU2858=航班号}	航班的属性
CZ6083在哪里候机？	{CZ6083=航班号}	航班的属性
ZH9005候机位置在哪里？	{ZH9005=航班号}	航班的属性
ZH9023候机位置在哪里？	{ZH9023=航班号}	航班的属性
FD0597候机位置在哪里？	{FD0597=航班号}	航班的属性
MI965候机位置在哪里？	{MI965=航班号}	航班的属性
CZ6083候机位置在哪里？	{CZ6083=航班号}	航班的属性
MU2858候机位置在哪里？	{MU2858=航班号}	航班的属性
FD0597候机位置在什么地方？	{FD0597=航班号}	航班的属性
CZ6083候机位置在什么地方？	{CZ6083=航班号}	航班的属性
MU2858候机位置在什么地方？	{MU2858=航班号}	航班的属性
ZH9005候机位置在什么地方？	{ZH9005=航班号}	航班的属性
MI965候机位置在什么地方？	{MI965=航班号}	航班的属性
ZH9023候机位置在什么地方？	{ZH9023=航班号}	航班的属性
CZ6083候机位置在何处？	{CZ6083=航班号}	航班的属性
ZH9005候机位置在何处？	{ZH9005=航班号}	航班的属性
MU2858候机位置在何处？	{MU2858=航班号}	航班的属性
FD0597候机位置在何处？	{FD0597=航班号}	航班的属性
ZH9023候机位置在何处？	{ZH9023=航班号}	航班的属性
MI965候机位置在何处？	{MI965=航班号}	航班的属性
ZH9023在什么位置候机？	{ZH9023=航班号}	航班的属性
MI965在什么位置候机？	{MI965=航班号}	航班的属性
CZ6083在什么位置候机？	{CZ6083=航班号}	航班的属性
ZH9005在什么位置候机？	{ZH9005=航班号}	航班的属性
MU2858在何处候机？	{MU2858=航班号}	航班的属性
ZH9005在何处候机？	{ZH9005=航班号}	航班的属性
MI965在何处候机？	{MI965=航班号}	航班的属性
FD0597在何处候机？	{FD0597=航班号}	航班的属性
ZH9023在何处候机？	{ZH9023=航班号}	航班的属性
CZ6083在何处候机？	{CZ6083=航班号}	航班的属性
我坐MI965航班，要在什么地方候机？	{MI965=航班号}	航班的属性
我坐CZ6083航班，要在什么地方候机？	{CZ6083=航班号}	航班的属性
我坐MU2858航班，要在什么地方候机？	{MU2858=航班号}	航班的属性
我坐ZH9023航班，要在什么地方候机？	{ZH9023=航班号}	航班的属性
我坐FD0597航班，要在什么地方候机？	{FD0597=航班号}	航班的属性
我坐ZH9005航班，要在什么地方候机？	{ZH9005=航班号}	航班的属性
我坐MI965航班，要在哪里候机？	{MI965=航班号}	航班的属性
我坐ZH9005航班，要在哪里候机？	{ZH9005=航班号}	航班的属性
我坐ZH9023航班，要在哪里候机？	{ZH9023=航班号}	航班的属性
我坐MU2858航班，要在哪里候机？	{MU2858=航班号}	航班的属性
我坐CZ6083航班，要在哪里候机？	{CZ6083=航班号}	航班的属性
我坐FD0597航班，要在哪里候机？	{FD0597=航班号}	航班的属性
我坐ZH9023航班，要在何处候机？	{ZH9023=航班号}	航班的属性
我坐MI965航班，要在何处候机？	{MI965=航班号}	航班的属性
我坐CZ6083航班，要在何处候机？	{CZ6083=航班号}	航班的属性
我坐MU2858航班，要在何处候机？	{MU2858=航班号}	航班的属性
我坐FD0597航班，要在何处候机？	{FD0597=航班号}	航班的属性
我坐MU2858航班，应该在什么地方候机？	{MU2858=航班号}	航班的属性
我坐ZH9023航班，应该在什么地方候机？	{ZH9023=航班号}	航班的属性
我坐ZH9005航班，应该在什么地方候机？	{ZH9005=航班号}	航班的属性
我坐CZ6083航班，应该在什么地方候机？	{CZ6083=航班号}	航班的属性
我坐FD0597航班，应该在什么地方候机？	{FD0597=航班号}	航班的属性
我坐MI965航班，应该在什么地方候机？	{MI965=航班号}	航班的属性
我坐ZH9005航班，应该在哪里候机？	{ZH9005=航班号}	航班的属性
我坐CZ6083航班，应该在哪里候机？	{CZ6083=航班号}	航班的属性
我坐FD0597航班，应该在哪里候机？	{FD0597=航班号}	航班的属性
我坐ZH9023航班，应该在哪里候机？	{ZH9023=航班号}	航班的属性
我坐MI965航班，应该在哪里候机？	{MI965=航班号}	航班的属性
我坐MU2858航班，应该在哪里候机？	{MU2858=航班号}	航班的属性
我坐FD0597航班，应该在何处候机？	{FD0597=航班号}	航班的属性
我坐MI965航班，应该在何处候机？	{MI965=航班号}	航班的属性
我坐ZH9005航班，应该在何处候机？	{ZH9005=航班号}	航班的属性
我坐CZ6083航班，应该在何处候机？	{CZ6083=航班号}	航班的属性
我坐ZH9023航班，应该在何处候机？	{ZH9023=航班号}	航班的属性
我坐MU2858航班，应该在何处候机？	{MU2858=航班号}	航班的属性
我的航班是ZH9005，要在什么地方候机？	{ZH9005=航班号}	航班的属性
我的航班是MI965，要在什么地方候机？	{MI965=航班号}	航班的属性
我的航班是ZH9023，要在什么地方候机？	{ZH9023=航班号}	航班的属性
我的航班是MU2858，要在什么地方候机？	{MU2858=航班号}	航班的属性
我的航班是FD0597，要在什么地方候机？	{FD0597=航班号}	航班的属性
我的航班是ZH9005，要在哪里候机？	{ZH9005=航班号}	航班的属性
我的航班是CZ6083，要在哪里候机？	{CZ6083=航班号}	航班的属性
我的航班是FD0597，要在哪里候机？	{FD0597=航班号}	航班的属性
我的航班是MU2858，要在哪里候机？	{MU2858=航班号}	航班的属性
我的航班是ZH9023，要在哪里候机？	{ZH9023=航班号}	航班的属性
我的航班是MI965，要在哪里候机？	{MI965=航班号}	航班的属性
我的航班是FD0597，要在何处候机？	{FD0597=航班号}	航班的属性
我的航班是ZH9023，要在何处候机？	{ZH9023=航班号}	航班的属性
我的航班是MU2858，要在何处候机？	{MU2858=航班号}	航班的属性
我的航班是MI965，要在何处候机？	{MI965=航班号}	航班的属性
我的航班是CZ6083，应该在什么地方候机？	{CZ6083=航班号}	航班的属性
我的航班是MI965，应该在什么地方候机？	{MI965=航班号}	航班的属性
我的航班是FD0597，应该在什么地方候机？	{FD0597=航班号}	航班的属性
我的航班是ZH9005，应该在什么地方候机？	{ZH9005=航班号}	航班的属性
我的航班是MU2858，应该在什么地方候机？	{MU2858=航班号}	航班的属性
我的航班是ZH9023，应该在什么地方候机？	{ZH9023=航班号}	航班的属性
我的航班是MI965，应该在哪里候机？	{MI965=航班号}	航班的属性
我的航班是MU2858，应该在哪里候机？	{MU2858=航班号}	航班的属性
我的航班是FD0597，应该在哪里候机？	{FD0597=航班号}	航班的属性
我的航班是ZH9023，应该在哪里候机？	{ZH9023=航班号}	航班的属性
我的航班是CZ6083，应该在哪里候机？	{CZ6083=航班号}	航班的属性
我的航班是CZ6083，应该在何处候机？	{CZ6083=航班号}	航班的属性
我的航班是MU2858，应该在何处候机？	{MU2858=航班号}	航班的属性
我的航班是ZH9005，应该在何处候机？	{ZH9005=航班号}	航班的属性
我的航班是ZH9023，应该在何处候机？	{ZH9023=航班号}	航班的属性
我的航班是FD0597，应该在何处候机？	{FD0597=航班号}	航班的属性
我的航班是MI965，应该在何处候机？	{MI965=航班号}	航班的属性
MU2858行李限重多少？	{MU2858=航班号}	航班的属性
MI965行李限重多少？	{MI965=航班号}	航班的属性
CZ6083行李限重多少？	{CZ6083=航班号}	航班的属性
FD0597行李限重多少？	{FD0597=航班号}	航班的属性
ZH9023行李限重多少？	{ZH9023=航班号}	航班的属性
ZH9005行李限重多少？	{ZH9005=航班号}	航班的属性
CZ6083最多能带多少行李？	{CZ6083=航班号}	航班的属性
ZH9023最多能带多少行李？	{ZH9023=航班号}	航班的属性
MI965最多能带多少行李？	{MI965=航班号}	航班的属性
ZH9005最多能带多少行李？	{ZH9005=航班号}	航班的属性
FD0597最多能带多少行李？	{FD0597=航班号}	航班的属性
MU2858最多能带多少行李？	{MU2858=航班号}	航班的属性
MU2858最多可以带多少行李？	{MU2858=航班号}	航班的属性
ZH9005最多可以带多少行李？	{ZH9005=航班号}	航班的属性
MI965最多可以带多少行李？	{MI965=航班号}	航班的属性
CZ6083最多可以带多少行李？	{CZ6083=航班号}	航班的属性
ZH9023最多可以带多少行李？	{ZH9023=航班号}	航班的属性
FD0597最多可以带多少行李？	{FD0597=航班号}	航班的属性
MI965航班能带的行李最多是多少？	{MI965=航班号}	航班的属性
ZH9005航班能带的行李最多是多少？	{ZH9005=航班号}	航班的属性
MU2858航班能带的行李最多是多少？	{MU2858=航班号}	航班的属性
ZH9023航班能带的行李最多是多少？	{ZH9023=航班号}	航班的属性
CZ6083航班能带的行李最多是多少？	{CZ6083=航班号}	航班的属性
FD0597航班能带的行李最多是多少？	{FD0597=航班号}	航班的属性
CZ6083航班可以带的行李最多是多少？	{CZ6083=航班号}	航班的属性
ZH9023航班可以带的行李最多是多少？	{ZH9023=航班号}	航班的属性
MU2858航班可以带的行李最多是多少？	{MU2858=航班号}	航班的属性
MI965航班可以带的行李最多是多少？	{MI965=航班号}	航班的属性
ZH9005航班可以带的行李最多是多少？	{ZH9005=航班号}	航班的属性
FD0597航班可以带的行李最多是多少？	{FD0597=航班号}	航班的属性
ZH9023能带多少行李？	{ZH9023=航班号}	航班的属性
MU2858能带多少行李？	{MU2858=航班号}	航班的属性
FD0597能带多少行李？	{FD0597=航班号}	航班的属性
MI965能带多少行李？	{MI965=航班号}	航班的属性
ZH9005能带多少行李？	{ZH9005=航班号}	航班的属性
CZ6083能带多少行李？	{CZ6083=航班号}	航班的属性
ZH9023可以带多少行李？	{ZH9023=航班号}	航班的属性
MI965可以带多少行李？	{MI965=航班号}	航班的属性
ZH9005可以带多少行李？	{ZH9005=航班号}	航班的属性
MU2858可以带多少行李？	{MU2858=航班号}	航班的属性
FD0597可以带多少行李？	{FD0597=航班号}	航班的属性
CZ6083可以带多少行李？	{CZ6083=航班号}	航班的属性
我坐MU2858航班，能带多少行李？	{MU2858=航班号}	航班的属性
我坐ZH9005航班，能带多少行李？	{ZH9005=航班号}	航班的属性
我坐CZ6083航班，能带多少行李？	{CZ6083=航班号}	航班的属性
我坐MI965航班，能带多少行李？	{MI965=航班号}	航班的属性
我坐ZH9023航班，能带多少行李？	{ZH9023=航班号}	航班的属性
我坐FD0597航班，能带多少行李？	{FD0597=航班号}	航班的属性
我坐ZH9005航班，最多能带多少行李？	{ZH9005=航班号}	航班的属性
我坐FD0597航班，最多能带多少行李？	{FD0597=航班号}	航班的属性
我坐CZ6083航班，最多能带多少行李？	{CZ6083=航班号}	航班的属性
我坐MU2858航班，最多能带多少行李？	{MU2858=航班号}	航班的属性
我坐ZH9023航班，最多能带多少行李？	{ZH9023=航班号}	航班的属性
我坐MI965航班，最多能带多少行李？	{MI965=航班号}	航班的属性
我坐ZH9023航班，可以带多少行李？	{ZH9023=航班号}	航班的属性
我坐MU2858航班，可以带多少行李？	{MU2858=航班号}	航班的属性
我坐FD0597航班，可以带多少行李？	{FD0597=航班号}	航班的属性
我坐ZH9005航班，可以带多少行李？	{ZH9005=航班号}	航班的属性
我坐CZ6083航班，可以带多少行李？	{CZ6083=航班号}	航班的属性
我坐MI965航班，可以带多少行李？	{MI965=航班号}	航班的属性
我坐CZ6083航班，最多可以带多少行李？	{CZ6083=航班号}	航班的属性
我坐ZH9005航班，最多可以带多少行李？	{ZH9005=航班号}	航班的属性
我坐MU2858航班，最多可以带多少行李？	{MU2858=航班号}	航班的属性
我坐FD0597航班，最多可以带多少行李？	{FD0597=航班号}	航班的属性
我坐MI965航班，最多可以带多少行李？	{MI965=航班号}	航班的属性
我的航班是ZH9005，能带多少行李？	{ZH9005=航班号}	航班的属性
我的航班是MU2858，能带多少行李？	{MU2858=航班号}	航班的属性
我的航班是CZ6083，能带多少行李？	{CZ6083=航班号}	航班的属性
我的航班是FD0597，能带多少行李？	{FD0597=航班号}	航班的属性
我的航班是MI965，能带多少行李？	{MI965=航班号}	航班的属性
我的航班是ZH9023，能带多少行李？	{ZH9023=航班号}	航班的属性
我的航班是MU2858，最多能带多少行李？	{MU2858=航班号}	航班的属性
我的航班是FD0597，最多能带多少行李？	{FD0597=航班号}	航班的属性
我的航班是CZ6083，最多能带多少行李？	{CZ6083=航班号}	航班的属性
我的航班是ZH9023，最多能带多少行李？	{ZH9023=航班号}	航班的属性
我的航班是MI965，最多能带多少行李？	{MI965=航班号}	航班的属性
我的航班是ZH9005，可以带多少行李？	{ZH9005=航班号}	航班的属性
我的航班是FD0597，可以带多少行李？	{FD0597=航班号}	航班的属性
我的航班是ZH9023，可以带多少行李？	{ZH9023=航班号}	航班的属性
我的航班是MI965，可以带多少行李？	{MI965=航班号}	航班的属性
我的航班是MU2858，可以带多少行李？	{MU2858=航班号}	航班的属性
我的航班是FD0597，最多可以带多少行李？	{FD0597=航班号}	航班的属性
我的航班是CZ6083，最多可以带多少行李？	{CZ6083=航班号}	航班的属性
我的航班是MU2858，最多可以带多少行李？	{MU2858=航班号}	航班的属性
我的航班是ZH9023，最多可以带多少行李？	{ZH9023=航班号}	航班的属性
我的航班是ZH9005，最多可以带多少行李？	{ZH9005=航班号}	航班的属性
我的航班是MI965，最多可以带多少行李？	{MI965=航班号}	航班的属性
ZH9005怎么样？	{ZH9005=航班号}	航班的简介
FD0597怎么样？	{FD0597=航班号}	航班的简介
ZH9023怎么样？	{ZH9023=航班号}	航班的简介
CZ6083怎么样？	{CZ6083=航班号}	航班的简介
MI965怎么样？	{MI965=航班号}	航班的简介
MU2858怎么样？	{MU2858=航班号}	航班的简介
介绍一下MI965	{MI965=航班号}	航班的简介
介绍一下FD0597	{FD0597=航班号}	航班的简介
介绍一下CZ6083	{CZ6083=航班号}	航班的简介
介绍一下ZH9023	{ZH9023=航班号}	航班的简介
ZH9005好吗	{ZH9005=航班号}	航班的简介
MI965好吗	{MI965=航班号}	航班的简介
CZ6083好吗	{CZ6083=航班号}	航班的简介
MU2858好吗	{MU2858=航班号}	航班的简介
FD0597好吗	{FD0597=航班号}	航班的简介
ZH9023好吗	{ZH9023=航班号}	航班的简介
CZ6083如何	{CZ6083=航班号}	航班的简介
MU2858如何	{MU2858=航班号}	航班的简介
FD0597如何	{FD0597=航班号}	航班的简介
ZH9005如何	{ZH9005=航班号}	航班的简介
我想了解一下FD0597	{FD0597=航班号}	航班的简介
我想了解一下ZH9005	{ZH9005=航班号}	航班的简介
我想了解一下CZ6083	{CZ6083=航班号}	航班的简介
我想了解一下MI965	{MI965=航班号}	航班的简介
我想了解一下ZH9023	{ZH9023=航班号}	航班的简介
我想了解一下MU2858	{MU2858=航班号}	航班的简介
告诉我ZH9023的情况	{ZH9023=航班号}	航班的简介
告诉我MI965的情况	{MI965=航班号}	航班的简介
告诉我ZH9005的情况	{ZH9005=航班号}	航班的简介
告诉我FD0597的情况	{FD0597=航班号}	航班的简介
告诉我MI965怎么样	{MI965=航班号}	航班的简介
告诉我FD0597怎么样	{FD0597=航班号}	航班的简介
告诉我ZH9023怎么样	{ZH9023=航班号}	航班的简介
告诉我ZH9005怎么样	{ZH9005=航班号}	航班的简介
告诉我CZ6083怎么样	{CZ6083=航班号}	航班的简介
告诉我MU2858怎么样	{MU2858=航班号}	航班的简介
MU2858经济舱可以带多少行李	{MU2858=航班号, 经济舱=仓位类别}	航班的属性
MU2858头等舱可以带多少行李	{头等舱=仓位类别, MU2858=航班号}	航班的属性
MU2858商务舱可以带多少行李	{MU2858=航班号, 商务舱=仓位类别}	航班的属性
ZH9023经济舱可以带多少行李	{ZH9023=航班号, 经济舱=仓位类别}	航班的属性
CZ6083经济舱可以带多少行李	{经济舱=仓位类别, CZ6083=航班号}	航班的属性
CZ6083商务舱可以带多少行李	{商务舱=仓位类别, CZ6083=航班号}	航班的属性
ZH9005经济舱可以带多少行李	{经济舱=仓位类别, ZH9005=航班号}	航班的属性
CZ6083头等舱可以带多少行李	{头等舱=仓位类别, CZ6083=航班号}	航班的属性
ZH9023商务舱可以带多少行李	{ZH9023=航班号, 商务舱=仓位类别}	航班的属性
MI965商务舱可以带多少行李	{MI965=航班号, 商务舱=仓位类别}	航班的属性
ZH9005头等舱可以带多少行李	{头等舱=仓位类别, ZH9005=航班号}	航班的属性
FD0597头等舱可以带多少行李	{头等舱=仓位类别, FD0597=航班号}	航班的属性
FD0597商务舱可以带多少行李	{FD0597=航班号, 商务舱=仓位类别}	航班的属性
MI965经济舱可以带多少行李	{MI965=航班号, 经济舱=仓位类别}	航班的属性
MI965头等舱能带多少行李	{头等舱=仓位类别, MI965=航班号}	航班的属性
MI965商务舱能带多少行李	{MI965=航班号, 商务舱=仓位类别}	航班的属性
ZH9005头等舱能带多少行李	{头等舱=仓位类别, ZH9005=航班号}	航班的属性
ZH9023经济舱能带多少行李	{ZH9023=航班号, 经济舱=仓位类别}	航班的属性
FD0597头等舱能带多少行李	{头等舱=仓位类别, FD0597=航班号}	航班的属性
ZH9023头等舱能带多少行李	{头等舱=仓位类别, ZH9023=航班号}	航班的属性
ZH9005经济舱能带多少行李	{经济舱=仓位类别, ZH9005=航班号}	航班的属性
ZH9023商务舱能带多少行李	{ZH9023=航班号, 商务舱=仓位类别}	航班的属性
MI965经济舱能带多少行李	{MI965=航班号, 经济舱=仓位类别}	航班的属性
ZH9005商务舱能带多少行李	{商务舱=仓位类别, ZH9005=航班号}	航班的属性
CZ6083头等舱能带多少行李	{头等舱=仓位类别, CZ6083=航班号}	航班的属性
FD0597商务舱能带多少行李	{FD0597=航班号, 商务舱=仓位类别}	航班的属性
CZ6083经济舱能带多少行李	{经济舱=仓位类别, CZ6083=航班号}	航班的属性
CZ6083商务舱能带多少行李	{商务舱=仓位类别, CZ6083=航班号}	航班的属性
MU2858头等舱能带多少行李	{头等舱=仓位类别, MU2858=航班号}	航班的属性
ZH9023头等舱能够带多少行李	{头等舱=仓位类别, ZH9023=航班号}	航班的属性
CZ6083商务舱能够带多少行李	{商务舱=仓位类别, CZ6083=航班号}	航班的属性
FD0597经济舱能够带多少行李	{FD0597=航班号, 经济舱=仓位类别}	航班的属性
MU2858经济舱能够带多少行李	{MU2858=航班号, 经济舱=仓位类别}	航班的属性
ZH9005商务舱能够带多少行李	{商务舱=仓位类别, ZH9005=航班号}	航班的属性
FD0597商务舱能够带多少行李	{FD0597=航班号, 商务舱=仓位类别}	航班的属性
MU2858商务舱能够带多少行李	{MU2858=航班号, 商务舱=仓位类别}	航班的属性
ZH9023经济舱能够带多少行李	{ZH9023=航班号, 经济舱=仓位类别}	航班的属性
ZH9005头等舱能够带多少行李	{头等舱=仓位类别, ZH9005=航班号}	航班的属性
CZ6083头等舱能够带多少行李	{头等舱=仓位类别, CZ6083=航班号}	航班的属性
MU2858头等舱能够带多少行李	{头等舱=仓位类别, MU2858=航班号}	航班的属性
FD0597头等舱能够带多少行李	{头等舱=仓位类别, FD0597=航班号}	航班的属性
MI965商务舱能够带多少行李	{MI965=航班号, 商务舱=仓位类别}	航班的属性
ZH9005商务舱限重是多少	{商务舱=仓位类别, ZH9005=航班号}	航班的属性
ZH9023经济舱限重是多少	{ZH9023=航班号, 经济舱=仓位类别}	航班的属性
ZH9005头等舱限重是多少	{头等舱=仓位类别, ZH9005=航班号}	航班的属性
MU2858头等舱限重是多少	{头等舱=仓位类别, MU2858=航班号}	航班的属性
MI965经济舱限重是多少	{MI965=航班号, 经济舱=仓位类别}	航班的属性
CZ6083经济舱限重是多少	{经济舱=仓位类别, CZ6083=航班号}	航班的属性
MU2858经济舱限重是多少	{MU2858=航班号, 经济舱=仓位类别}	航班的属性
ZH9023商务舱限重是多少	{ZH9023=航班号, 商务舱=仓位类别}	航班的属性
MU2858商务舱限重是多少	{MU2858=航班号, 商务舱=仓位类别}	航班的属性
FD0597商务舱限重是多少	{FD0597=航班号, 商务舱=仓位类别}	航班的属性
MI965商务舱限重是多少	{MI965=航班号, 商务舱=仓位类别}	航班的属性
MI965头等舱限重是多少	{头等舱=仓位类别, MI965=航班号}	航班的属性
CZ6083商务舱限重是多少	{商务舱=仓位类别, CZ6083=航班号}	航班的属性
FD0597经济舱限重是多少	{FD0597=航班号, 经济舱=仓位类别}	航班的属性
ZH9005经济舱限重是多少	{经济舱=仓位类别, ZH9005=航班号}	航班的属性
FD0597头等舱限重是多少	{头等舱=仓位类别, FD0597=航班号}	航班的属性
ZH9023经济舱限重情况	{ZH9023=航班号, 经济舱=仓位类别}	航班的属性
ZH9005商务舱限重情况	{商务舱=仓位类别, ZH9005=航班号}	航班的属性
MI965商务舱限重情况	{MI965=航班号, 商务舱=仓位类别}	航班的属性
MI965头等舱限重情况	{头等舱=仓位类别, MI965=航班号}	航班的属性
CZ6083经济舱限重情况	{经济舱=仓位类别, CZ6083=航班号}	航班的属性
ZH9023商务舱限重情况	{ZH9023=航班号, 商务舱=仓位类别}	航班的属性
MU2858经济舱限重情况	{MU2858=航班号, 经济舱=仓位类别}	航班的属性
ZH9005经济舱限重情况	{经济舱=仓位类别, ZH9005=航班号}	航班的属性
MU2858头等舱限重情况	{头等舱=仓位类别, MU2858=航班号}	航班的属性
MU2858商务舱限重情况	{MU2858=航班号, 商务舱=仓位类别}	航班的属性
FD0597头等舱限重情况	{头等舱=仓位类别, FD0597=航班号}	航班的属性
FD0597经济舱限重情况	{FD0597=航班号, 经济舱=仓位类别}	航班的属性
深圳航空怎么样？	{深圳航空=航空公司}	航空公司的简介
东方航空怎么样？	{东方航空=航空公司}	航空公司的简介
上海航空怎么样？	{上海航空=航空公司}	航空公司的简介
泰国亚洲航空怎么样？	{泰国亚洲航空=航空公司}	航空公司的简介
南方航空怎么样？	{南方航空=航空公司}	航空公司的简介
新加坡胜安航空怎么样？	{新加坡胜安航空=航空公司}	航空公司的简介
介绍一下南方航空	{南方航空=航空公司}	航空公司的简介
介绍一下新加坡胜安航空	{新加坡胜安航空=航空公司}	航空公司的简介
介绍一下上海航空	{上海航空=航空公司}	航空公司的简介
介绍一下泰国亚洲航空	{泰国亚洲航空=航空公司}	航空公司的简介
介绍一下东方航空	{东方航空=航空公司}	航空公司的简介
介绍一下深圳航空	{深圳航空=航空公司}	航空公司的简介
深圳航空好吗	{深圳航空=航空公司}	航空公司的简介
东方航空好吗	{东方航空=航空公司}	航空公司的简介
南方航空好吗	{南方航空=航空公司}	航空公司的简介
新加坡胜安航空好吗	{新加坡胜安航空=航空公司}	航空公司的简介
新加坡胜安航空如何	{新加坡胜安航空=航空公司}	航空公司的简介
泰国亚洲航空如何	{泰国亚洲航空=航空公司}	航空公司的简介
深圳航空如何	{深圳航空=航空公司}	航空公司的简介
上海航空如何	{上海航空=航空公司}	航空公司的简介
东方航空如何	{东方航空=航空公司}	航空公司的简介
南方航空如何	{南方航空=航空公司}	航空公司的简介
我想了解一下泰国亚洲航空	{泰国亚洲航空=航空公司}	航空公司的简介
我想了解一下深圳航空	{深圳航空=航空公司}	航空公司的简介
我想了解一下上海航空	{上海航空=航空公司}	航空公司的简介
我想了解一下东方航空	{东方航空=航空公司}	航空公司的简介
我想了解一下新加坡胜安航空	{新加坡胜安航空=航空公司}	航空公司的简介
我想了解一下南方航空	{南方航空=航空公司}	航空公司的简介
告诉我新加坡胜安航空的情况	{新加坡胜安航空=航空公司}	航空公司的简介
告诉我深圳航空的情况	{深圳航空=航空公司}	航空公司的简介
告诉我南方航空的情况	{南方航空=航空公司}	航空公司的简介
告诉我泰国亚洲航空的情况	{泰国亚洲航空=航空公司}	航空公司的简介
告诉我上海航空的情况	{上海航空=航空公司}	航空公司的简介
告诉我深圳航空怎么样	{深圳航空=航空公司}	航空公司的简介
告诉我新加坡胜安航空怎么样	{新加坡胜安航空=航空公司}	航空公司的简介
告诉我泰国亚洲航空怎么样	{泰国亚洲航空=航空公司}	航空公司的简介
告诉我南方航空怎么样	{南方航空=航空公司}	航空公司的简介
告诉我东方航空怎么样	{东方航空=航空公司}	航空公司的简介
告诉我上海航空怎么样	{上海航空=航空公司}	航空公司的简介
从这里到白沙滩怎么走?	{这里=出发GPS, 白沙滩=目的poi名称}	小行程路线
从本地到白沙滩怎么走?	{白沙滩=目的poi名称, 本地=出发GPS}	小行程路线
从这里到鼓浪屿怎么走?	{这里=出发GPS, 鼓浪屿=目的poi名称}	小行程路线
从本地到迪斯尼怎么走?	{本地=出发GPS, 迪斯尼=目的poi名称}	小行程路线
从这儿到迪士尼怎么走?	{这儿=出发GPS, 迪士尼=目的poi名称}	小行程路线
从这里到托普卡帕宫怎么走?	{这里=出发GPS, 托普卡帕宫=目的poi名称}	小行程路线
从本地到新加坡河怎么走?	{本地=出发GPS, 新加坡河=目的poi名称}	小行程路线
从本地到景福宫怎么走?	{景福宫=目的poi名称, 本地=出发GPS}	小行程路线
从这儿到全聚德怎么走?	{全聚德=目的poi名称, 这儿=出发GPS}	小行程路线
从本地到路易港怎么走?	{本地=出发GPS, 路易港=目的poi名称}	小行程路线
从这儿到景福宫怎么走?	{景福宫=目的poi名称, 这儿=出发GPS}	小行程路线
从这里到玛黑区怎么走?	{玛黑区=目的poi名称, 这里=出发GPS}	小行程路线
从本地到迪士尼怎么走?	{本地=出发GPS, 迪士尼=目的poi名称}	小行程路线
从这儿到路易港怎么走?	{这儿=出发GPS, 路易港=目的poi名称}	小行程路线
从本地到大夏宫怎么走?	{本地=出发GPS, 大夏宫=目的poi名称}	小行程路线
从本地到猴庙怎么走?	{本地=出发GPS, 猴庙=目的poi名称}	小行程路线
从这儿到九寨沟怎么走?	{九寨沟=目的poi名称, 这儿=出发GPS}	小行程路线
从本地到九寨沟怎么走?	{九寨沟=目的poi名称, 本地=出发GPS}	小行程路线
从这里到路易港怎么走?	{这里=出发GPS, 路易港=目的poi名称}	小行程路线
从本地到莱茵河怎么走?	{莱茵河=目的poi名称, 本地=出发GPS}	小行程路线
从这儿到日月潭怎么走?	{日月潭=目的poi名称, 这儿=出发GPS}	小行程路线
从这里到荣军院怎么走?	{这里=出发GPS, 荣军院=目的poi名称}	小行程路线
从本地到密歇根湖怎么走?	{本地=出发GPS, 密歇根湖=目的poi名称}	小行程路线
从这儿到迪斯尼怎么走?	{这儿=出发GPS, 迪斯尼=目的poi名称}	小行程路线
从这里到马穆提岛怎么走?	{这里=出发GPS, 马穆提岛=目的poi名称}	小行程路线
从本地到红树怎么走?	{红树=目的poi名称, 本地=出发GPS}	小行程路线
从这里到景福宫怎么走?	{这里=出发GPS, 景福宫=目的poi名称}	小行程路线
从这里到卢浮宫怎么走?	{这里=出发GPS, 卢浮宫=目的poi名称}	小行程路线
从这儿到玛黑区怎么走?	{玛黑区=目的poi名称, 这儿=出发GPS}	小行程路线
从这里到大夏宫怎么走?	{这里=出发GPS, 大夏宫=目的poi名称}	小行程路线
从这儿到大夏宫怎么走?	{这儿=出发GPS, 大夏宫=目的poi名称}	小行程路线
从本地到金阁寺怎么走?	{本地=出发GPS, 金阁寺=目的poi名称}	小行程路线
从这儿到凯旋门怎么走?	{这儿=出发GPS, 凯旋门=目的poi名称}	小行程路线
从这儿到维港怎么走?	{维港=目的poi名称, 这儿=出发GPS}	小行程路线
从本地到全聚德怎么走?	{全聚德=目的poi名称, 本地=出发GPS}	小行程路线
从这里到莱茵河怎么走?	{莱茵河=目的poi名称, 这里=出发GPS}	小行程路线
从这里到阿尔法玛怎么走?	{这里=出发GPS, 阿尔法玛=目的poi名称}	小行程路线
从本地到青莲院怎么走?	{本地=出发GPS, 青莲院=目的poi名称}	小行程路线
从这儿到新加坡河怎么走?	{这儿=出发GPS, 新加坡河=目的poi名称}	小行程路线
从这儿到芬兰堡怎么走?	{这儿=出发GPS, 芬兰堡=目的poi名称}	小行程路线
从这里到芬兰堡怎么走?	{这里=出发GPS, 芬兰堡=目的poi名称}	小行程路线
从本地到凯旋门怎么走?	{本地=出发GPS, 凯旋门=目的poi名称}	小行程路线
从本地到玛黑区怎么走?	{玛黑区=目的poi名称, 本地=出发GPS}	小行程路线
从本地到芬兰堡怎么走?	{本地=出发GPS, 芬兰堡=目的poi名称}	小行程路线
从这里到猴庙怎么走?	{这里=出发GPS, 猴庙=目的poi名称}	小行程路线
从本地到卢浮宫怎么走?	{本地=出发GPS, 卢浮宫=目的poi名称}	小行程路线
从这里到日月潭怎么走?	{日月潭=目的poi名称, 这里=出发GPS}	小行程路线
从这里到新加坡河怎么走?	{这里=出发GPS, 新加坡河=目的poi名称}	小行程路线
从这儿到光明寺怎么走?	{这儿=出发GPS, 光明寺=目的poi名称}	小行程路线
从这儿到鼓浪屿怎么走?	{这儿=出发GPS, 鼓浪屿=目的poi名称}	小行程路线
从这里到凯旋门怎么走?	{这里=出发GPS, 凯旋门=目的poi名称}	小行程路线
从这里到密歇根湖怎么走?	{这里=出发GPS, 密歇根湖=目的poi名称}	小行程路线
从本地怎么去路易港	{本地=出发GPS, 路易港=目的poi名称}	小行程路线
从这里怎么去莱茵河	{莱茵河=目的poi名称, 这里=出发GPS}	小行程路线
从这儿怎么去托普卡帕宫	{这儿=出发GPS, 托普卡帕宫=目的poi名称}	小行程路线
从这里怎么去红树	{红树=目的poi名称, 这里=出发GPS}	小行程路线
从本地怎么去托普卡帕宫	{本地=出发GPS, 托普卡帕宫=目的poi名称}	小行程路线
从这里怎么去迪斯尼	{这里=出发GPS, 迪斯尼=目的poi名称}	小行程路线
从这儿怎么去青莲院	{这儿=出发GPS, 青莲院=目的poi名称}	小行程路线
从本地怎么去新加坡河	{本地=出发GPS, 新加坡河=目的poi名称}	小行程路线
从这里怎么去新加坡河	{这里=出发GPS, 新加坡河=目的poi名称}	小行程路线
从这里怎么去密歇根湖	{这里=出发GPS, 密歇根湖=目的poi名称}	小行程路线
从这儿怎么去凯旋门	{这儿=出发GPS, 凯旋门=目的poi名称}	小行程路线
从本地怎么去大夏宫	{本地=出发GPS, 大夏宫=目的poi名称}	小行程路线
从本地怎么去迪斯尼	{本地=出发GPS, 迪斯尼=目的poi名称}	小行程路线
从这儿怎么去景福宫	{景福宫=目的poi名称, 这儿=出发GPS}	小行程路线
从这里怎么去金阁寺	{这里=出发GPS, 金阁寺=目的poi名称}	小行程路线
从本地怎么去九寨沟	{九寨沟=目的poi名称, 本地=出发GPS}	小行程路线
从这儿怎么去密歇根湖	{这儿=出发GPS, 密歇根湖=目的poi名称}	小行程路线
从这儿怎么去路易港	{这儿=出发GPS, 路易港=目的poi名称}	小行程路线
从这里怎么去青莲院	{这里=出发GPS, 青莲院=目的poi名称}	小行程路线
从这儿怎么去荣军院	{这儿=出发GPS, 荣军院=目的poi名称}	小行程路线
从这里怎么去大夏宫	{这里=出发GPS, 大夏宫=目的poi名称}	小行程路线
从这里怎么去凯旋门	{这里=出发GPS, 凯旋门=目的poi名称}	小行程路线
从这里怎么去路易港	{这里=出发GPS, 路易港=目的poi名称}	小行程路线
从这里怎么去托普卡帕宫	{这里=出发GPS, 托普卡帕宫=目的poi名称}	小行程路线
从这儿怎么去马穆提岛	{这儿=出发GPS, 马穆提岛=目的poi名称}	小行程路线
从这儿怎么去阿尔法玛	{这儿=出发GPS, 阿尔法玛=目的poi名称}	小行程路线
从本地怎么去唐人街	{唐人街=目的poi名称, 本地=出发GPS}	小行程路线
从这儿怎么去红树	{红树=目的poi名称, 这儿=出发GPS}	小行程路线
从这里怎么去光明寺	{这里=出发GPS, 光明寺=目的poi名称}	小行程路线
从这儿怎么去维多利亚港	{这儿=出发GPS, 维多利亚港=目的poi名称}	小行程路线
从本地怎么去卢浮宫	{本地=出发GPS, 卢浮宫=目的poi名称}	小行程路线
从这儿怎么去猴庙	{这儿=出发GPS, 猴庙=目的poi名称}	小行程路线
从这里怎么去猴庙	{这里=出发GPS, 猴庙=目的poi名称}	小行程路线
从本地怎么去多瑙河	{本地=出发GPS, 多瑙河=目的poi名称}	小行程路线
从本地怎么去芬兰堡	{本地=出发GPS, 芬兰堡=目的poi名称}	小行程路线
从本地怎么去白沙滩	{白沙滩=目的poi名称, 本地=出发GPS}	小行程路线
从这儿怎么去全聚德	{全聚德=目的poi名称, 这儿=出发GPS}	小行程路线
从本地怎么去莱茵河	{莱茵河=目的poi名称, 本地=出发GPS}	小行程路线
从本地怎么去红树	{红树=目的poi名称, 本地=出发GPS}	小行程路线
从本地怎么去维港	{维港=目的poi名称, 本地=出发GPS}	小行程路线
从这里怎么去维港	{这里=出发GPS, 维港=目的poi名称}	小行程路线
从这里怎么去白沙滩	{这里=出发GPS, 白沙滩=目的poi名称}	小行程路线
从这里怎么去维多利亚港	{这里=出发GPS, 维多利亚港=目的poi名称}	小行程路线
从本地怎么去日月潭	{日月潭=目的poi名称, 本地=出发GPS}	小行程路线
从这儿怎么去迪斯尼	{这儿=出发GPS, 迪斯尼=目的poi名称}	小行程路线
从这里怎么去荣军院	{这里=出发GPS, 荣军院=目的poi名称}	小行程路线
从本地怎么去阿尔法玛	{本地=出发GPS, 阿尔法玛=目的poi名称}	小行程路线
从这里怎么去孚日宫	{这里=出发GPS, 孚日宫=目的poi名称}	小行程路线
从这儿怎么去光明寺	{这儿=出发GPS, 光明寺=目的poi名称}	小行程路线
从本地怎么去荣军院	{本地=出发GPS, 荣军院=目的poi名称}	小行程路线
从这里怎么去唐人街	{这里=出发GPS, 唐人街=目的poi名称}	小行程路线
从本地怎么去全聚德	{全聚德=目的poi名称, 本地=出发GPS}	小行程路线
从本地怎么去维多利亚港	{维多利亚港=目的poi名称, 本地=出发GPS}	小行程路线
维多利亚港怎么走	{维多利亚港=目的poi名称}	小行程路线
凯旋门怎么走	{凯旋门=目的poi名称}	小行程路线
密歇根湖怎么走	{密歇根湖=目的poi名称}	小行程路线
鼓浪屿怎么走	{鼓浪屿=目的poi名称}	小行程路线
多瑙河怎么走	{多瑙河=目的poi名称}	小行程路线
托普卡帕宫怎么走	{托普卡帕宫=目的poi名称}	小行程路线
卢浮宫怎么走	{卢浮宫=目的poi名称}	小行程路线
唐人街怎么走	{唐人街=目的poi名称}	小行程路线
猴庙怎么走	{猴庙=目的poi名称}	小行程路线
白沙滩怎么走	{白沙滩=目的poi名称}	小行程路线
孚日宫怎么走	{孚日宫=目的poi名称}	小行程路线
日月潭怎么走	{日月潭=目的poi名称}	小行程路线
维港怎么走	{维港=目的poi名称}	小行程路线
莱茵河怎么走	{莱茵河=目的poi名称}	小行程路线
荣军院怎么走	{荣军院=目的poi名称}	小行程路线
路易港怎么走	{路易港=目的poi名称}	小行程路线
青莲院怎么走	{青莲院=目的poi名称}	小行程路线
阿尔法玛怎么走	{阿尔法玛=目的poi名称}	小行程路线
金阁寺怎么走	{金阁寺=目的poi名称}	小行程路线
莱茵河怎么去	{莱茵河=目的poi名称}	小行程路线
唐人街怎么去	{唐人街=目的poi名称}	小行程路线
托普卡帕宫怎么去	{托普卡帕宫=目的poi名称}	小行程路线
维港怎么去	{维港=目的poi名称}	小行程路线
多瑙河怎么去	{多瑙河=目的poi名称}	小行程路线
新加坡河怎么去	{新加坡河=目的poi名称}	小行程路线
路易港怎么去	{路易港=目的poi名称}	小行程路线
玛黑区怎么去	{玛黑区=目的poi名称}	小行程路线
凯旋门怎么去	{凯旋门=目的poi名称}	小行程路线
阿尔法玛怎么去	{阿尔法玛=目的poi名称}	小行程路线
日月潭怎么去	{日月潭=目的poi名称}	小行程路线
鼓浪屿怎么去	{鼓浪屿=目的poi名称}	小行程路线
维多利亚港怎么去	{维多利亚港=目的poi名称}	小行程路线
白沙滩怎么去	{白沙滩=目的poi名称}	小行程路线
迪斯尼怎么去	{迪斯尼=目的poi名称}	小行程路线
卢浮宫怎么去	{卢浮宫=目的poi名称}	小行程路线
猴庙怎么去	{猴庙=目的poi名称}	小行程路线
全聚德怎么去	{全聚德=目的poi名称}	小行程路线
红树怎么去	{红树=目的poi名称}	小行程路线
荣军院怎么去	{荣军院=目的poi名称}	小行程路线
大夏宫怎么去	{大夏宫=目的poi名称}	小行程路线
九寨沟怎么去	{九寨沟=目的poi名称}	小行程路线
芬兰堡怎么去	{芬兰堡=目的poi名称}	小行程路线
孚日宫怎么去	{孚日宫=目的poi名称}	小行程路线
青莲院怎么去	{青莲院=目的poi名称}	小行程路线
如何去往维多利亚港	{维多利亚港=目的poi名称}	小行程路线
如何去往猴庙	{猴庙=目的poi名称}	小行程路线
如何去往卢浮宫	{卢浮宫=目的poi名称}	小行程路线
如何去往路易港	{路易港=目的poi名称}	小行程路线
如何去往芬兰堡	{芬兰堡=目的poi名称}	小行程路线
如何去往日月潭	{日月潭=目的poi名称}	小行程路线
如何去往新加坡河	{新加坡河=目的poi名称}	小行程路线
如何去往大夏宫	{大夏宫=目的poi名称}	小行程路线
如何去往迪斯尼	{迪斯尼=目的poi名称}	小行程路线
如何去往阿尔法玛	{阿尔法玛=目的poi名称}	小行程路线
如何去往红树	{红树=目的poi名称}	小行程路线
如何去往迪士尼	{迪士尼=目的poi名称}	小行程路线
如何去往九寨沟	{九寨沟=目的poi名称}	小行程路线
如何去往唐人街	{唐人街=目的poi名称}	小行程路线
如何去往光明寺	{光明寺=目的poi名称}	小行程路线
如何去往金阁寺	{金阁寺=目的poi名称}	小行程路线
如何去往密歇根湖	{密歇根湖=目的poi名称}	小行程路线
如何去往全聚德	{全聚德=目的poi名称}	小行程路线
如何去往孚日宫	{孚日宫=目的poi名称}	小行程路线
如何去往托普卡帕宫	{托普卡帕宫=目的poi名称}	小行程路线
如何去往青莲院	{青莲院=目的poi名称}	小行程路线
如何去往景福宫	{景福宫=目的poi名称}	小行程路线
如何去往凯旋门	{凯旋门=目的poi名称}	小行程路线
如何去往白沙滩	{白沙滩=目的poi名称}	小行程路线
如何去往维港	{维港=目的poi名称}	小行程路线
如何去往莱茵河	{莱茵河=目的poi名称}	小行程路线
如何去往玛黑区	{玛黑区=目的poi名称}	小行程路线
我想去芬兰堡，怎么走	{芬兰堡=目的poi名称}	小行程路线
我想去卢浮宫，怎么走	{卢浮宫=目的poi名称}	小行程路线
我想去景福宫，怎么走	{景福宫=目的poi名称}	小行程路线
我想去玛黑区，怎么走	{玛黑区=目的poi名称}	小行程路线
我想去迪士尼，怎么走	{迪士尼=目的poi名称}	小行程路线
我想去日月潭，怎么走	{日月潭=目的poi名称}	小行程路线
我想去大夏宫，怎么走	{大夏宫=目的poi名称}	小行程路线
我想去唐人街，怎么走	{唐人街=目的poi名称}	小行程路线
我想去孚日宫，怎么走	{孚日宫=目的poi名称}	小行程路线
我想去托普卡帕宫，怎么走	{托普卡帕宫=目的poi名称}	小行程路线
我想去路易港，怎么走	{路易港=目的poi名称}	小行程路线
我想去凯旋门，怎么走	{凯旋门=目的poi名称}	小行程路线
我想去红树，怎么走	{红树=目的poi名称}	小行程路线
我想去密歇根湖，怎么走	{密歇根湖=目的poi名称}	小行程路线
我想去白沙滩，怎么走	{白沙滩=目的poi名称}	小行程路线
我想去光明寺，怎么走	{光明寺=目的poi名称}	小行程路线
推荐怎么去景福宫	{景福宫=目的poi名称}	小行程路线
推荐怎么去密歇根湖	{密歇根湖=目的poi名称}	小行程路线
推荐怎么去孚日宫	{孚日宫=目的poi名称}	小行程路线
推荐怎么去日月潭	{日月潭=目的poi名称}	小行程路线
推荐怎么去红树	{红树=目的poi名称}	小行程路线
推荐怎么去多瑙河	{多瑙河=目的poi名称}	小行程路线
推荐怎么去莱茵河	{莱茵河=目的poi名称}	小行程路线
推荐怎么去凯旋门	{凯旋门=目的poi名称}	小行程路线
推荐怎么去迪士尼	{迪士尼=目的poi名称}	小行程路线
推荐怎么去阿尔法玛	{阿尔法玛=目的poi名称}	小行程路线
推荐怎么去路易港	{路易港=目的poi名称}	小行程路线
推荐怎么去玛黑区	{玛黑区=目的poi名称}	小行程路线
推荐怎么去维多利亚港	{维多利亚港=目的poi名称}	小行程路线
推荐怎么去维港	{维港=目的poi名称}	小行程路线
推荐怎么去芬兰堡	{芬兰堡=目的poi名称}	小行程路线
推荐怎么去九寨沟	{九寨沟=目的poi名称}	小行程路线
推荐怎么去全聚德	{全聚德=目的poi名称}	小行程路线
推荐怎么去光明寺	{光明寺=目的poi名称}	小行程路线
推荐怎么去白沙滩	{白沙滩=目的poi名称}	小行程路线
推荐怎么去托普卡帕宫	{托普卡帕宫=目的poi名称}	小行程路线
推荐怎么去唐人街	{唐人街=目的poi名称}	小行程路线
推荐怎么去新加坡河	{新加坡河=目的poi名称}	小行程路线
推荐怎么去青莲院	{青莲院=目的poi名称}	小行程路线
推荐怎么去猴庙	{猴庙=目的poi名称}	小行程路线
推荐怎么去马穆提岛	{马穆提岛=目的poi名称}	小行程路线
推荐怎么去大夏宫	{大夏宫=目的poi名称}	小行程路线
推荐去光明寺的交通方式	{光明寺=目的poi名称}	小行程路线
推荐去新加坡河的交通方式	{新加坡河=目的poi名称}	小行程路线
推荐去托普卡帕宫的交通方式	{托普卡帕宫=目的poi名称}	小行程路线
推荐去猴庙的交通方式	{猴庙=目的poi名称}	小行程路线
推荐去唐人街的交通方式	{唐人街=目的poi名称}	小行程路线
推荐去白沙滩的交通方式	{白沙滩=目的poi名称}	小行程路线
推荐去红树的交通方式	{红树=目的poi名称}	小行程路线
推荐去马穆提岛的交通方式	{马穆提岛=目的poi名称}	小行程路线
推荐去大夏宫的交通方式	{大夏宫=目的poi名称}	小行程路线
推荐去芬兰堡的交通方式	{芬兰堡=目的poi名称}	小行程路线
推荐去路易港的交通方式	{路易港=目的poi名称}	小行程路线
推荐去青莲院的交通方式	{青莲院=目的poi名称}	小行程路线
推荐去多瑙河的交通方式	{多瑙河=目的poi名称}	小行程路线
推荐去金阁寺的交通方式	{金阁寺=目的poi名称}	小行程路线
推荐去鼓浪屿的交通方式	{鼓浪屿=目的poi名称}	小行程路线
推荐去卢浮宫的交通方式	{卢浮宫=目的poi名称}	小行程路线
推荐去维多利亚港的交通方式	{维多利亚港=目的poi名称}	小行程路线
推荐去日月潭的交通方式	{日月潭=目的poi名称}	小行程路线
推荐去密歇根湖的交通方式	{密歇根湖=目的poi名称}	小行程路线
推荐去九寨沟的交通方式	{九寨沟=目的poi名称}	小行程路线
推荐去莱茵河的交通方式	{莱茵河=目的poi名称}	小行程路线
推荐去阿尔法玛的交通方式	{阿尔法玛=目的poi名称}	小行程路线
推荐去维港的交通方式	{维港=目的poi名称}	小行程路线
从维港怎么去九寨沟？	{维港=出发poi名称, 九寨沟=目的poi名称}	小行程路线
从红树怎么去迪士尼？	{红树=出发poi名称, 迪士尼=目的poi名称}	小行程路线
从荣军院怎么去青莲院？	{青莲院=目的poi名称, 荣军院=出发poi名称}	小行程路线
从密歇根湖怎么去大夏宫？	{密歇根湖=出发poi名称, 大夏宫=目的poi名称}	小行程路线
从迪斯尼怎么去青莲院？	{青莲院=目的poi名称, 迪斯尼=出发poi名称}	小行程路线
从莱茵河怎么去红树？	{红树=目的poi名称, 莱茵河=出发poi名称}	小行程路线
从荣军院怎么去景福宫？	{景福宫=目的poi名称, 荣军院=出发poi名称}	小行程路线
从日月潭怎么去唐人街？	{日月潭=出发poi名称, 唐人街=目的poi名称}	小行程路线
从玛黑区怎么去金阁寺？	{玛黑区=出发poi名称, 金阁寺=目的poi名称}	小行程路线
从阿尔法玛怎么去鼓浪屿？	{阿尔法玛=出发poi名称, 鼓浪屿=目的poi名称}	小行程路线
从迪斯尼怎么去大夏宫？	{大夏宫=目的poi名称, 迪斯尼=出发poi名称}	小行程路线
从凯旋门怎么去荣军院？	{凯旋门=出发poi名称, 荣军院=目的poi名称}	小行程路线
从维港怎么去凯旋门？	{维港=出发poi名称, 凯旋门=目的poi名称}	小行程路线
从全聚德怎么去托普卡帕宫？	{全聚德=出发poi名称, 托普卡帕宫=目的poi名称}	小行程路线
从荣军院怎么去维多利亚港？	{维多利亚港=目的poi名称, 荣军院=出发poi名称}	小行程路线
从多瑙河怎么去迪士尼？	{多瑙河=出发poi名称, 迪士尼=目的poi名称}	小行程路线
从金阁寺怎么去托普卡帕宫？	{托普卡帕宫=目的poi名称, 金阁寺=出发poi名称}	小行程路线
从阿尔法玛怎么去莱茵河？	{莱茵河=目的poi名称, 阿尔法玛=出发poi名称}	小行程路线
从青莲院怎么去白沙滩？	{白沙滩=目的poi名称, 青莲院=出发poi名称}	小行程路线
从大夏宫怎么去日月潭？	{日月潭=目的poi名称, 大夏宫=出发poi名称}	小行程路线
从猴庙怎么去玛黑区？	{玛黑区=目的poi名称, 猴庙=出发poi名称}	小行程路线
从马穆提岛怎么去日月潭？	{日月潭=目的poi名称, 马穆提岛=出发poi名称}	小行程路线
从金阁寺怎么去鼓浪屿？	{鼓浪屿=目的poi名称, 金阁寺=出发poi名称}	小行程路线
从鼓浪屿怎么去九寨沟？	{九寨沟=目的poi名称, 鼓浪屿=出发poi名称}	小行程路线
从密歇根湖怎么去孚日宫？	{孚日宫=目的poi名称, 密歇根湖=出发poi名称}	小行程路线
从密歇根湖怎么去白沙滩？	{白沙滩=目的poi名称, 密歇根湖=出发poi名称}	小行程路线
从金阁寺怎么去猴庙？	{猴庙=目的poi名称, 金阁寺=出发poi名称}	小行程路线
从荣军院怎么去维港？	{维港=目的poi名称, 荣军院=出发poi名称}	小行程路线
从全聚德怎么去密歇根湖？	{全聚德=出发poi名称, 密歇根湖=目的poi名称}	小行程路线
从九寨沟怎么去金阁寺？	{九寨沟=出发poi名称, 金阁寺=目的poi名称}	小行程路线
从多瑙河怎么去维港？	{维港=目的poi名称, 多瑙河=出发poi名称}	小行程路线
从芬兰堡怎么去景福宫？	{景福宫=目的poi名称, 芬兰堡=出发poi名称}	小行程路线
从大夏宫怎么去托普卡帕宫？	{大夏宫=出发poi名称, 托普卡帕宫=目的poi名称}	小行程路线
从红树怎么去迪斯尼？	{红树=出发poi名称, 迪斯尼=目的poi名称}	小行程路线
从马穆提岛怎么去维港？	{维港=目的poi名称, 马穆提岛=出发poi名称}	小行程路线
从唐人街怎么去路易港？	{唐人街=出发poi名称, 路易港=目的poi名称}	小行程路线
从莱茵河怎么去芬兰堡？	{莱茵河=出发poi名称, 芬兰堡=目的poi名称}	小行程路线
从鼓浪屿怎么去荣军院？	{鼓浪屿=出发poi名称, 荣军院=目的poi名称}	小行程路线
从维多利亚港怎么去荣军院？	{维多利亚港=出发poi名称, 荣军院=目的poi名称}	小行程路线
从路易港怎么去唐人街？	{唐人街=目的poi名称, 路易港=出发poi名称}	小行程路线
从新加坡河怎么去托普卡帕宫？	{新加坡河=出发poi名称, 托普卡帕宫=目的poi名称}	小行程路线
从凯旋门怎么去芬兰堡？	{芬兰堡=目的poi名称, 凯旋门=出发poi名称}	小行程路线
从马穆提岛怎么去孚日宫？	{孚日宫=目的poi名称, 马穆提岛=出发poi名称}	小行程路线
从卢浮宫怎么去荣军院？	{卢浮宫=出发poi名称, 荣军院=目的poi名称}	小行程路线
从九寨沟怎么去日月潭？	{日月潭=目的poi名称, 九寨沟=出发poi名称}	小行程路线
从托普卡帕宫怎么去维多利亚港？	{维多利亚港=目的poi名称, 托普卡帕宫=出发poi名称}	小行程路线
从日月潭怎么去九寨沟？	{日月潭=出发poi名称, 九寨沟=目的poi名称}	小行程路线
从维港怎么去维多利亚港？	{维港=出发poi名称, 维多利亚港=目的poi名称}	小行程路线
从猴庙怎么去迪斯尼？	{猴庙=出发poi名称, 迪斯尼=目的poi名称}	小行程路线
从托普卡帕宫怎么去青莲院？	{青莲院=目的poi名称, 托普卡帕宫=出发poi名称}	小行程路线
从凯旋门怎么去路易港？	{路易港=目的poi名称, 凯旋门=出发poi名称}	小行程路线
从荣军院怎么去玛黑区？	{玛黑区=目的poi名称, 荣军院=出发poi名称}	小行程路线
从荣军院怎么去九寨沟？	{九寨沟=目的poi名称, 荣军院=出发poi名称}	小行程路线
从维港怎么去托普卡帕宫？	{维港=出发poi名称, 托普卡帕宫=目的poi名称}	小行程路线
从九寨沟怎么去多瑙河？	{九寨沟=出发poi名称, 多瑙河=目的poi名称}	小行程路线
从阿尔法玛怎么去青莲院？	{阿尔法玛=出发poi名称, 青莲院=目的poi名称}	小行程路线
从景福宫怎么去密歇根湖？	{景福宫=出发poi名称, 密歇根湖=目的poi名称}	小行程路线
从唐人街怎么去鼓浪屿？	{唐人街=出发poi名称, 鼓浪屿=目的poi名称}	小行程路线
从路易港怎么去新加坡河？	{新加坡河=目的poi名称, 路易港=出发poi名称}	小行程路线
从密歇根湖怎么去日月潭？	{日月潭=目的poi名称, 密歇根湖=出发poi名称}	小行程路线
从新加坡河怎么去密歇根湖？	{新加坡河=出发poi名称, 密歇根湖=目的poi名称}	小行程路线
从鼓浪屿怎么去阿尔法玛？	{阿尔法玛=目的poi名称, 鼓浪屿=出发poi名称}	小行程路线
从金阁寺怎么去维港？	{维港=目的poi名称, 金阁寺=出发poi名称}	小行程路线
从迪士尼怎么去唐人街？	{唐人街=目的poi名称, 迪士尼=出发poi名称}	小行程路线
从白沙滩怎么去日月潭？	{日月潭=目的poi名称, 白沙滩=出发poi名称}	小行程路线
从大夏宫怎么去景福宫？	{景福宫=目的poi名称, 大夏宫=出发poi名称}	小行程路线
从凯旋门怎么去光明寺？	{光明寺=目的poi名称, 凯旋门=出发poi名称}	小行程路线
从卢浮宫怎么去光明寺？	{光明寺=目的poi名称, 卢浮宫=出发poi名称}	小行程路线
从维港怎么去白沙滩？	{维港=出发poi名称, 白沙滩=目的poi名称}	小行程路线
从大夏宫怎么去金阁寺？	{大夏宫=出发poi名称, 金阁寺=目的poi名称}	小行程路线
从青莲院怎么去唐人街？	{唐人街=目的poi名称, 青莲院=出发poi名称}	小行程路线
从托普卡帕宫怎么去全聚德？	{全聚德=目的poi名称, 托普卡帕宫=出发poi名称}	小行程路线
从托普卡帕宫怎么去路易港？	{路易港=目的poi名称, 托普卡帕宫=出发poi名称}	小行程路线
从维港怎么去芬兰堡？	{维港=出发poi名称, 芬兰堡=目的poi名称}	小行程路线
从马穆提岛怎么去红树？	{红树=目的poi名称, 马穆提岛=出发poi名称}	小行程路线
从孚日宫怎么去荣军院？	{孚日宫=出发poi名称, 荣军院=目的poi名称}	小行程路线
从玛黑区怎么去路易港？	{玛黑区=出发poi名称, 路易港=目的poi名称}	小行程路线
从荣军院怎么去托普卡帕宫？	{荣军院=出发poi名称, 托普卡帕宫=目的poi名称}	小行程路线
从景福宫怎么去光明寺？	{景福宫=出发poi名称, 光明寺=目的poi名称}	小行程路线
从路易港怎么去迪斯尼？	{路易港=出发poi名称, 迪斯尼=目的poi名称}	小行程路线
从卢浮宫怎么去新加坡河？	{新加坡河=目的poi名称, 卢浮宫=出发poi名称}	小行程路线
从维多利亚港怎么去迪斯尼？	{维多利亚港=出发poi名称, 迪斯尼=目的poi名称}	小行程路线
从景福宫怎么去红树？	{红树=目的poi名称, 景福宫=出发poi名称}	小行程路线
从唐人街怎么去金阁寺？	{唐人街=出发poi名称, 金阁寺=目的poi名称}	小行程路线
从唐人街怎么去新加坡河？	{唐人街=出发poi名称, 新加坡河=目的poi名称}	小行程路线
从日月潭怎么去马穆提岛？	{日月潭=出发poi名称, 马穆提岛=目的poi名称}	小行程路线
从金阁寺怎么去唐人街？	{唐人街=目的poi名称, 金阁寺=出发poi名称}	小行程路线
从唐人街怎么去凯旋门？	{唐人街=出发poi名称, 凯旋门=目的poi名称}	小行程路线
从青莲院怎么去迪斯尼？	{青莲院=出发poi名称, 迪斯尼=目的poi名称}	小行程路线
从日月潭怎么去金阁寺？	{日月潭=出发poi名称, 金阁寺=目的poi名称}	小行程路线
从白沙滩怎么去全聚德？	{全聚德=目的poi名称, 白沙滩=出发poi名称}	小行程路线
从卢浮宫怎么去全聚德？	{全聚德=目的poi名称, 卢浮宫=出发poi名称}	小行程路线
从芬兰堡怎么去密歇根湖？	{芬兰堡=出发poi名称, 密歇根湖=目的poi名称}	小行程路线
从猴庙怎么去马穆提岛？	{猴庙=出发poi名称, 马穆提岛=目的poi名称}	小行程路线
从日月潭怎么去维港？	{日月潭=出发poi名称, 维港=目的poi名称}	小行程路线
从阿尔法玛怎么去迪士尼？	{阿尔法玛=出发poi名称, 迪士尼=目的poi名称}	小行程路线
从大夏宫怎么去猴庙？	{大夏宫=出发poi名称, 猴庙=目的poi名称}	小行程路线
从景福宫怎么去青莲院？	{景福宫=出发poi名称, 青莲院=目的poi名称}	小行程路线
从卢浮宫怎么去红树？	{红树=目的poi名称, 卢浮宫=出发poi名称}	小行程路线
从荣军院怎么去唐人街？	{唐人街=目的poi名称, 荣军院=出发poi名称}	小行程路线
怎么从红树到维多利亚港	{红树=出发poi名称, 维多利亚港=目的poi名称}	小行程路线
怎么从密歇根湖到玛黑区	{玛黑区=目的poi名称, 密歇根湖=出发poi名称}	小行程路线
怎么从光明寺到芬兰堡	{光明寺=出发poi名称, 芬兰堡=目的poi名称}	小行程路线
怎么从密歇根湖到青莲院	{密歇根湖=出发poi名称, 青莲院=目的poi名称}	小行程路线
怎么从芬兰堡到迪士尼	{芬兰堡=出发poi名称, 迪士尼=目的poi名称}	小行程路线
怎么从迪士尼到马穆提岛	{迪士尼=出发poi名称, 马穆提岛=目的poi名称}	小行程路线
怎么从凯旋门到白沙滩	{白沙滩=目的poi名称, 凯旋门=出发poi名称}	小行程路线
怎么从迪士尼到阿尔法玛	{阿尔法玛=目的poi名称, 迪士尼=出发poi名称}	小行程路线
怎么从凯旋门到芬兰堡	{芬兰堡=目的poi名称, 凯旋门=出发poi名称}	小行程路线
怎么从白沙滩到光明寺	{白沙滩=出发poi名称, 光明寺=目的poi名称}	小行程路线
怎么从多瑙河到唐人街	{唐人街=目的poi名称, 多瑙河=出发poi名称}	小行程路线
怎么从迪士尼到鼓浪屿	{鼓浪屿=目的poi名称, 迪士尼=出发poi名称}	小行程路线
怎么从荣军院到新加坡河	{新加坡河=目的poi名称, 荣军院=出发poi名称}	小行程路线
怎么从光明寺到维多利亚港	{维多利亚港=目的poi名称, 光明寺=出发poi名称}	小行程路线
怎么从日月潭到密歇根湖	{日月潭=出发poi名称, 密歇根湖=目的poi名称}	小行程路线
怎么从迪士尼到红树	{红树=目的poi名称, 迪士尼=出发poi名称}	小行程路线
怎么从金阁寺到猴庙	{猴庙=目的poi名称, 金阁寺=出发poi名称}	小行程路线
怎么从密歇根湖到鼓浪屿	{密歇根湖=出发poi名称, 鼓浪屿=目的poi名称}	小行程路线
怎么从猴庙到金阁寺	{猴庙=出发poi名称, 金阁寺=目的poi名称}	小行程路线
怎么从多瑙河到荣军院	{多瑙河=出发poi名称, 荣军院=目的poi名称}	小行程路线
怎么从九寨沟到维港	{维港=目的poi名称, 九寨沟=出发poi名称}	小行程路线
怎么从白沙滩到维港	{维港=目的poi名称, 白沙滩=出发poi名称}	小行程路线
怎么从唐人街到迪士尼	{唐人街=出发poi名称, 迪士尼=目的poi名称}	小行程路线
怎么从鼓浪屿到红树	{红树=目的poi名称, 鼓浪屿=出发poi名称}	小行程路线
怎么从托普卡帕宫到密歇根湖	{密歇根湖=目的poi名称, 托普卡帕宫=出发poi名称}	小行程路线
怎么从多瑙河到马穆提岛	{多瑙河=出发poi名称, 马穆提岛=目的poi名称}	小行程路线
怎么从全聚德到光明寺	{全聚德=出发poi名称, 光明寺=目的poi名称}	小行程路线
怎么从猴庙到芬兰堡	{芬兰堡=目的poi名称, 猴庙=出发poi名称}	小行程路线
怎么从新加坡河到光明寺	{新加坡河=出发poi名称, 光明寺=目的poi名称}	小行程路线
怎么从景福宫到芬兰堡	{景福宫=出发poi名称, 芬兰堡=目的poi名称}	小行程路线
怎么从维多利亚港到托普卡帕宫	{维多利亚港=出发poi名称, 托普卡帕宫=目的poi名称}	小行程路线
怎么从景福宫到密歇根湖	{景福宫=出发poi名称, 密歇根湖=目的poi名称}	小行程路线
怎么从路易港到密歇根湖	{密歇根湖=目的poi名称, 路易港=出发poi名称}	小行程路线
怎么从密歇根湖到阿尔法玛	{阿尔法玛=目的poi名称, 密歇根湖=出发poi名称}	小行程路线
怎么从鼓浪屿到路易港	{鼓浪屿=出发poi名称, 路易港=目的poi名称}	小行程路线
怎么从路易港到迪士尼	{路易港=出发poi名称, 迪士尼=目的poi名称}	小行程路线
怎么从金阁寺到凯旋门	{凯旋门=目的poi名称, 金阁寺=出发poi名称}	小行程路线
怎么从青莲院到大夏宫	{青莲院=出发poi名称, 大夏宫=目的poi名称}	小行程路线
怎么从猴庙到玛黑区	{玛黑区=目的poi名称, 猴庙=出发poi名称}	小行程路线
怎么从阿尔法玛到凯旋门	{阿尔法玛=出发poi名称, 凯旋门=目的poi名称}	小行程路线
怎么从凯旋门到全聚德	{全聚德=目的poi名称, 凯旋门=出发poi名称}	小行程路线
怎么从青莲院到马穆提岛	{青莲院=出发poi名称, 马穆提岛=目的poi名称}	小行程路线
怎么从密歇根湖到九寨沟	{九寨沟=目的poi名称, 密歇根湖=出发poi名称}	小行程路线
怎么从马穆提岛到阿尔法玛	{阿尔法玛=目的poi名称, 马穆提岛=出发poi名称}	小行程路线
怎么从鼓浪屿到托普卡帕宫	{鼓浪屿=出发poi名称, 托普卡帕宫=目的poi名称}	小行程路线
怎么从荣军院到九寨沟	{九寨沟=目的poi名称, 荣军院=出发poi名称}	小行程路线
怎么从新加坡河到维港	{维港=目的poi名称, 新加坡河=出发poi名称}	小行程路线
怎么从卢浮宫到莱茵河	{莱茵河=目的poi名称, 卢浮宫=出发poi名称}	小行程路线
怎么从路易港到大夏宫	{路易港=出发poi名称, 大夏宫=目的poi名称}	小行程路线
怎么从日月潭到路易港	{日月潭=出发poi名称, 路易港=目的poi名称}	小行程路线
怎么从景福宫到唐人街	{景福宫=出发poi名称, 唐人街=目的poi名称}	小行程路线
怎么从孚日宫到全聚德	{孚日宫=出发poi名称, 全聚德=目的poi名称}	小行程路线
怎么从白沙滩到凯旋门	{白沙滩=出发poi名称, 凯旋门=目的poi名称}	小行程路线
怎么从维港到路易港	{维港=出发poi名称, 路易港=目的poi名称}	小行程路线
怎么从莱茵河到鼓浪屿	{莱茵河=出发poi名称, 鼓浪屿=目的poi名称}	小行程路线
怎么从路易港到红树	{红树=目的poi名称, 路易港=出发poi名称}	小行程路线
怎么从维多利亚港到红树	{红树=目的poi名称, 维多利亚港=出发poi名称}	小行程路线
怎么从唐人街到鼓浪屿	{唐人街=出发poi名称, 鼓浪屿=目的poi名称}	小行程路线
怎么从托普卡帕宫到孚日宫	{孚日宫=目的poi名称, 托普卡帕宫=出发poi名称}	小行程路线
怎么从阿尔法玛到猴庙	{阿尔法玛=出发poi名称, 猴庙=目的poi名称}	小行程路线
怎么从白沙滩到新加坡河	{白沙滩=出发poi名称, 新加坡河=目的poi名称}	小行程路线
怎么从全聚德到卢浮宫	{全聚德=出发poi名称, 卢浮宫=目的poi名称}	小行程路线
怎么从鼓浪屿到玛黑区	{玛黑区=目的poi名称, 鼓浪屿=出发poi名称}	小行程路线
怎么从凯旋门到迪斯尼	{凯旋门=出发poi名称, 迪斯尼=目的poi名称}	小行程路线
怎么从维多利亚港到路易港	{维多利亚港=出发poi名称, 路易港=目的poi名称}	小行程路线
怎么从白沙滩到密歇根湖	{白沙滩=出发poi名称, 密歇根湖=目的poi名称}	小行程路线
怎么从新加坡河到密歇根湖	{新加坡河=出发poi名称, 密歇根湖=目的poi名称}	小行程路线
怎么从多瑙河到迪士尼	{多瑙河=出发poi名称, 迪士尼=目的poi名称}	小行程路线
怎么从荣军院到阿尔法玛	{阿尔法玛=目的poi名称, 荣军院=出发poi名称}	小行程路线
怎么从芬兰堡到青莲院	{芬兰堡=出发poi名称, 青莲院=目的poi名称}	小行程路线
怎么从红树到维港	{红树=出发poi名称, 维港=目的poi名称}	小行程路线
怎么从迪士尼到芬兰堡	{芬兰堡=目的poi名称, 迪士尼=出发poi名称}	小行程路线
怎么从青莲院到荣军院	{青莲院=出发poi名称, 荣军院=目的poi名称}	小行程路线
怎么从维多利亚港到阿尔法玛	{维多利亚港=出发poi名称, 阿尔法玛=目的poi名称}	小行程路线
怎么从日月潭到白沙滩	{日月潭=出发poi名称, 白沙滩=目的poi名称}	小行程路线
怎么从新加坡河到迪斯尼	{新加坡河=出发poi名称, 迪斯尼=目的poi名称}	小行程路线
怎么从大夏宫到红树	{红树=目的poi名称, 大夏宫=出发poi名称}	小行程路线
怎么从白沙滩到景福宫	{景福宫=目的poi名称, 白沙滩=出发poi名称}	小行程路线
怎么从孚日宫到红树	{红树=目的poi名称, 孚日宫=出发poi名称}	小行程路线
怎么从唐人街到新加坡河	{唐人街=出发poi名称, 新加坡河=目的poi名称}	小行程路线
怎么从卢浮宫到金阁寺	{卢浮宫=出发poi名称, 金阁寺=目的poi名称}	小行程路线
怎么从莱茵河到卢浮宫	{莱茵河=出发poi名称, 卢浮宫=目的poi名称}	小行程路线
怎么从阿尔法玛到卢浮宫	{阿尔法玛=出发poi名称, 卢浮宫=目的poi名称}	小行程路线
怎么从莱茵河到红树	{红树=目的poi名称, 莱茵河=出发poi名称}	小行程路线
怎么从荣军院到青莲院	{青莲院=目的poi名称, 荣军院=出发poi名称}	小行程路线
怎么从维多利亚港到迪士尼	{维多利亚港=出发poi名称, 迪士尼=目的poi名称}	小行程路线
怎么从托普卡帕宫到迪斯尼	{托普卡帕宫=出发poi名称, 迪斯尼=目的poi名称}	小行程路线
怎么从孚日宫到景福宫	{孚日宫=出发poi名称, 景福宫=目的poi名称}	小行程路线
怎么从景福宫到多瑙河	{景福宫=出发poi名称, 多瑙河=目的poi名称}	小行程路线
怎么从维多利亚港到猴庙	{维多利亚港=出发poi名称, 猴庙=目的poi名称}	小行程路线
怎么从猴庙到孚日宫	{孚日宫=目的poi名称, 猴庙=出发poi名称}	小行程路线
怎么从大夏宫到多瑙河	{多瑙河=目的poi名称, 大夏宫=出发poi名称}	小行程路线
怎么从路易港到全聚德	{全聚德=目的poi名称, 路易港=出发poi名称}	小行程路线
怎么从迪斯尼到阿尔法玛	{阿尔法玛=目的poi名称, 迪斯尼=出发poi名称}	小行程路线
怎么从猴庙到荣军院	{猴庙=出发poi名称, 荣军院=目的poi名称}	小行程路线
怎么从白沙滩到猴庙	{白沙滩=出发poi名称, 猴庙=目的poi名称}	小行程路线
怎么从维多利亚港到青莲院	{维多利亚港=出发poi名称, 青莲院=目的poi名称}	小行程路线
怎么从阿尔法玛到莱茵河	{莱茵河=目的poi名称, 阿尔法玛=出发poi名称}	小行程路线
怎么从路易港到青莲院	{路易港=出发poi名称, 青莲院=目的poi名称}	小行程路线
怎么从凯旋门到马穆提岛	{凯旋门=出发poi名称, 马穆提岛=目的poi名称}	小行程路线
我想去豪尔	{豪尔=目的城市}	大行程路线
我想去加德满都	{加德满都=目的城市}	大行程路线
我想去清莱	{清莱=目的城市}	大行程路线
我想去贝特默阿尔卑	{贝特默阿尔卑=目的城市}	大行程路线
我想去华盛顿	{华盛顿=目的城市}	大行程路线
我想去新不列颠岛	{新不列颠岛=目的城市}	大行程路线
我想去昌原	{昌原=目的城市}	大行程路线
我想去康提	{康提=目的城市}	大行程路线
我想去拿撒勒	{拿撒勒=目的城市}	大行程路线
我想去凡尔赛	{凡尔赛=目的城市}	大行程路线
我想去赫尔辛堡	{赫尔辛堡=目的城市}	大行程路线
我想去戈罗卡	{戈罗卡=目的城市}	大行程路线
我想去梅赫伦	{梅赫伦=目的城市}	大行程路线
我想去迪拜	{迪拜=目的城市}	大行程路线
我想去龙仁市	{龙仁市=目的城市}	大行程路线
我想去里斯本	{里斯本=目的城市}	大行程路线
我想去杜塞尔多夫	{杜塞尔多夫=目的城市}	大行程路线
我想去胡阿希内岛	{胡阿希内岛=目的城市}	大行程路线
我想去神户	{神户=目的城市}	大行程路线
我想去木尔坦	{木尔坦=目的城市}	大行程路线
我想去万象	{万象=目的城市}	大行程路线
我想去南安普顿	{南安普顿=目的城市}	大行程路线
我想去雷斯蒙	{雷斯蒙=目的城市}	大行程路线
我想去洛桑	{洛桑=目的城市}	大行程路线
我想去塔哈岛	{塔哈岛=目的城市}	大行程路线
我想去阿卡	{阿卡=目的城市}	大行程路线
我想去高威	{高威=目的城市}	大行程路线
我想去马德里	{马德里=目的城市}	大行程路线
我想去开罗	{开罗=目的城市}	大行程路线
我想去奥克兰	{奥克兰=目的城市}	大行程路线
我想去萨尔瓦多	{萨尔瓦多=目的城市}	大行程路线
我想去毛凯岛	{毛凯岛=目的城市}	大行程路线
我想去伊拉克利翁	{伊拉克利翁=目的城市}	大行程路线
我想去巴斯	{巴斯=目的城市}	大行程路线
我想去白沙瓦	{白沙瓦=目的城市}	大行程路线
我想去毕尔巴鄂	{毕尔巴鄂=目的城市}	大行程路线
我想去锡尔赫特	{锡尔赫特=目的城市}	大行程路线
我想去马洛卡帕尔马	{马洛卡帕尔马=目的城市}	大行程路线
我想去盐湖城	{盐湖城=目的城市}	大行程路线
我想去杰尔	{杰尔=目的城市}	大行程路线
我想去萨法加	{萨法加=目的城市}	大行程路线
我想去新山	{新山=目的城市}	大行程路线
我想去吉达	{吉达=目的城市}	大行程路线
我想去北宾	{北宾=目的城市}	大行程路线
我想去干尼亚	{干尼亚=目的城市}	大行程路线
我想去旧金山	{旧金山=目的城市}	大行程路线
我想去卡梅尔	{卡梅尔=目的城市}	大行程路线
我想去道格拉斯港	{道格拉斯港=目的城市}	大行程路线
我想去斯蒂基斯霍尔米	{斯蒂基斯霍尔米=目的城市}	大行程路线
我想去圣路易斯	{圣路易斯=目的城市}	大行程路线
我想去瓦纳卡	{瓦纳卡=目的城市}	大行程路线
我想去网走	{网走=目的城市}	大行程路线
我想去阿巴斯港	{阿巴斯港=目的城市}	大行程路线
我想去城南市	{城南市=目的城市}	大行程路线
我想去艾恩	{艾恩=目的城市}	大行程路线
我想去阿斯旺	{阿斯旺=目的城市}	大行程路线
我想去锡切斯	{锡切斯=目的城市}	大行程路线
我想去里尔	{里尔=目的城市}	大行程路线
我想去赫达	{赫达=目的城市}	大行程路线
我想去芝加哥	{芝加哥=目的城市}	大行程路线
我想去拉斯海马	{拉斯海马=目的城市}	大行程路线
我想去布鲁日	{布鲁日=目的城市}	大行程路线
我想去奥斯坦德	{奥斯坦德=目的城市}	大行程路线
我想去施瓦茨	{施瓦茨=目的城市}	大行程路线
我想去亚历山大	{亚历山大=目的城市}	大行程路线
我想去蒂卡普湖	{蒂卡普湖=目的城市}	大行程路线
我想去波隆纳鲁沃	{波隆纳鲁沃=目的城市}	大行程路线
我想去撒丁岛	{撒丁岛=目的城市}	大行程路线
我想去耶路撒冷	{耶路撒冷=目的城市}	大行程路线
我想去清州	{清州=目的城市}	大行程路线
我想去维也纳	{维也纳=目的城市}	大行程路线
我想去内比都	{内比都=目的城市}	大行程路线
我想去米湖	{米湖=目的城市}	大行程路线
我想去设拉子	{设拉子=目的城市}	大行程路线
我想去大分	{大分=目的城市}	大行程路线
我想去罗瓦涅米	{罗瓦涅米=目的城市}	大行程路线
我想去皮皮岛	{皮皮岛=目的城市}	大行程路线
我想去美因茨	{美因茨=目的城市}	大行程路线
我想去维谢格拉德	{维谢格拉德=目的城市}	大行程路线
我想去索伦托	{索伦托=目的城市}	大行程路线
我想去乌斯怀亚	{乌斯怀亚=目的城市}	大行程路线
我想去列治文	{列治文=目的城市}	大行程路线
我想去格雷茅斯	{格雷茅斯=目的城市}	大行程路线
我想去汉密尔顿	{汉密尔顿=目的城市}	大行程路线
我想去新竹	{新竹=目的城市}	大行程路线
我想去里约热内卢	{里约热内卢=目的城市}	大行程路线
我想去晋州市	{晋州市=目的城市}	大行程路线
我想去塞哥维亚	{塞哥维亚=目的城市}	大行程路线
我想去贝尼多姆	{贝尼多姆=目的城市}	大行程路线
我想去普雷韦扎	{普雷韦扎=目的城市}	大行程路线
我想去旭川	{旭川=目的城市}	大行程路线
我想去合艾	{合艾=目的城市}	大行程路线
我想去德尔斐	{德尔斐=目的城市}	大行程路线
我想去班贝格	{班贝格=目的城市}	大行程路线
我想去首尔	{首尔=目的城市}	大行程路线
我想去卡塔尼亚	{卡塔尼亚=目的城市}	大行程路线
我想去圣地亚哥-德孔波斯特拉	{圣地亚哥-德孔波斯特拉=目的城市}	大行程路线
我想去阿蒂乌岛	{阿蒂乌岛=目的城市}	大行程路线
我想去美瑛	{美瑛=目的城市}	大行程路线
我想去波贝	{波贝=目的城市}	大行程路线
我要去斯图加特	{斯图加特=目的城市}	大行程路线
我要去五渔村	{五渔村=目的城市}	大行程路线
我要去法尤姆	{法尤姆=目的城市}	大行程路线
我要去乌鲁班巴	{乌鲁班巴=目的城市}	大行程路线
我要去全州	{全州=目的城市}	大行程路线
我要去罗斯基勒	{罗斯基勒=目的城市}	大行程路线
我要去桑尼维尔	{桑尼维尔=目的城市}	大行程路线
我要去蒂豪尼	{蒂豪尼=目的城市}	大行程路线
我要去鹿港	{鹿港=目的城市}	大行程路线
我要去基尔根尼	{基尔根尼=目的城市}	大行程路线
我要去都灵	{都灵=目的城市}	大行程路线
我要去奥卢	{奥卢=目的城市}	大行程路线
我要去巴拉顿菲赖德	{巴拉顿菲赖德=目的城市}	大行程路线
我要去伊瓜苏港	{伊瓜苏港=目的城市}	大行程路线
我要去提比里亚	{提比里亚=目的城市}	大行程路线
我要去姬路	{姬路=目的城市}	大行程路线
我要去拉瓦格	{拉瓦格=目的城市}	大行程路线
我要去阿巴斯港	{阿巴斯港=目的城市}	大行程路线
我要去华盛顿	{华盛顿=目的城市}	大行程路线
我要去威尼斯	{威尼斯=目的城市}	大行程路线
我要去彭措林	{彭措林=目的城市}	大行程路线
我要去兹沃勒	{兹沃勒=目的城市}	大行程路线
我要去爱丽丝泉	{爱丽丝泉=目的城市}	大行程路线
我要去马尼拉	{马尼拉=目的城市}	大行程路线
我要去里弗赛德	{里弗赛德=目的城市}	大行程路线
我要去民丹岛	{民丹岛=目的城市}	大行程路线
我要去卡利	{卡利=目的城市}	大行程路线
我要去摩尔曼斯克	{摩尔曼斯克=目的城市}	大行程路线
我要去马六甲	{马六甲=目的城市}	大行程路线
我要去柏林	{柏林=目的城市}	大行程路线
我要去圣玛尔塔	{圣玛尔塔=目的城市}	大行程路线
我要去宇治	{宇治=目的城市}	大行程路线
我要去阿布扎比	{阿布扎比=目的城市}	大行程路线
我要去沙湾拿吉	{沙湾拿吉=目的城市}	大行程路线
我要去会晒	{会晒=目的城市}	大行程路线
我要去金门	{金门=目的城市}	大行程路线
我要去霍尼亚拉	{霍尼亚拉=目的城市}	大行程路线
我要去克拉斯诺达尔	{克拉斯诺达尔=目的城市}	大行程路线
我要去蒙特利尔	{蒙特利尔=目的城市}	大行程路线
我要去蔚山	{蔚山=目的城市}	大行程路线
我要去俄斯特拉发	{俄斯特拉发=目的城市}	大行程路线
我要去采尔马特	{采尔马特=目的城市}	大行程路线
我要去蒙达	{蒙达=目的城市}	大行程路线
我要去因特拉肯	{因特拉肯=目的城市}	大行程路线
我要去杜马盖地	{杜马盖地=目的城市}	大行程路线
我要去丰沙湾	{丰沙湾=目的城市}	大行程路线
我要去圣路易奥比斯波	{圣路易奥比斯波=目的城市}	大行程路线
我要去希拉	{希拉=目的城市}	大行程路线
我要去迈泰奥拉	{迈泰奥拉=目的城市}	大行程路线
我要去比萨	{比萨=目的城市}	大行程路线
我要去丁格尔	{丁格尔=目的城市}	大行程路线
我要去内坦亚	{内坦亚=目的城市}	大行程路线
我要去惠灵顿	{惠灵顿=目的城市}	大行程路线
我要去纳哈里亚	{纳哈里亚=目的城市}	大行程路线
我要去特拉维夫	{特拉维夫=目的城市}	大行程路线
我要去素可泰	{素可泰=目的城市}	大行程路线
我要去南设得兰群岛	{南设得兰群岛=目的城市}	大行程路线
我要去伊兹密尔	{伊兹密尔=目的城市}	大行程路线
我要去鲁尔蒙德	{鲁尔蒙德=目的城市}	大行程路线
我要去蒙特勒	{蒙特勒=目的城市}	大行程路线
我要去波蓬德塔	{波蓬德塔=目的城市}	大行程路线
我要去里雄莱锡安	{里雄莱锡安=目的城市}	大行程路线
我要去阿蒂乌岛	{阿蒂乌岛=目的城市}	大行程路线
我要去萨拉戈萨	{萨拉戈萨=目的城市}	大行程路线
我要去格拉斯哥	{格拉斯哥=目的城市}	大行程路线
我要去皮皮岛	{皮皮岛=目的城市}	大行程路线
我要去萨拉曼卡	{萨拉曼卡=目的城市}	大行程路线
我要去喀山	{喀山=目的城市}	大行程路线
我要去波贝	{波贝=目的城市}	大行程路线
我要去布法罗	{布法罗=目的城市}	大行程路线
我要去沃特福德	{沃特福德=目的城市}	大行程路线
我要去巴盖尔哈德	{巴盖尔哈德=目的城市}	大行程路线
我要去卡梅尔	{卡梅尔=目的城市}	大行程路线
我要去春川	{春川=目的城市}	大行程路线
我要去北碧府	{北碧府=目的城市}	大行程路线
我要去帕岸岛	{帕岸岛=目的城市}	大行程路线
我要去香港	{香港=目的城市}	大行程路线
我要去萨能	{萨能=目的城市}	大行程路线
我要去拿骚	{拿骚=目的城市}	大行程路线
我要去莫斯科	{莫斯科=目的城市}	大行程路线
我要去束草	{束草=目的城市}	大行程路线
我要去奥比都斯	{奥比都斯=目的城市}	大行程路线
我要去利贝雷茨	{利贝雷茨=目的城市}	大行程路线
我要去阿纳帕	{阿纳帕=目的城市}	大行程路线
我要去卡普里岛	{卡普里岛=目的城市}	大行程路线
我要去赫尔辛基	{赫尔辛基=目的城市}	大行程路线
我要去罗马	{罗马=目的城市}	大行程路线
我要去卡拉奇	{卡拉奇=目的城市}	大行程路线
我要去圣何塞	{圣何塞=目的城市}	大行程路线
我要去象岛	{象岛=目的城市}	大行程路线
我要去法蒂玛	{法蒂玛=目的城市}	大行程路线
我要去克里特岛	{克里特岛=目的城市}	大行程路线
我要去迪南	{迪南=目的城市}	大行程路线
我要去墨尔本	{墨尔本=目的城市}	大行程路线
我要去华富里	{华富里=目的城市}	大行程路线
我要去苏伊士	{苏伊士=目的城市}	大行程路线
我要去基洛纳	{基洛纳=目的城市}	大行程路线
我要去热那亚	{热那亚=目的城市}	大行程路线
我要去棉花堡	{棉花堡=目的城市}	大行程路线
我要去雷斯蒙	{雷斯蒙=目的城市}	大行程路线
我想去维多利亚港	{维多利亚港=目的poi名称}	小行程路线
我想去玛黑区	{玛黑区=目的poi名称}	小行程路线
我想去大夏宫	{大夏宫=目的poi名称}	小行程路线
我想去莱茵河	{莱茵河=目的poi名称}	小行程路线
我想去迪斯尼	{迪斯尼=目的poi名称}	小行程路线
我想去景福宫	{景福宫=目的poi名称}	小行程路线
我想去金阁寺	{金阁寺=目的poi名称}	小行程路线
我想去唐人街	{唐人街=目的poi名称}	小行程路线
我想去白沙滩	{白沙滩=目的poi名称}	小行程路线
我想去全聚德	{全聚德=目的poi名称}	小行程路线
我想去光明寺	{光明寺=目的poi名称}	小行程路线
我想去多瑙河	{多瑙河=目的poi名称}	小行程路线
我想去九寨沟	{九寨沟=目的poi名称}	小行程路线
我想去孚日宫	{孚日宫=目的poi名称}	小行程路线
我想去新加坡河	{新加坡河=目的poi名称}	小行程路线
我想去青莲院	{青莲院=目的poi名称}	小行程路线
我想去鼓浪屿	{鼓浪屿=目的poi名称}	小行程路线
我想去密歇根湖	{密歇根湖=目的poi名称}	小行程路线
我想去路易港	{路易港=目的poi名称}	小行程路线
我想去阿尔法玛	{阿尔法玛=目的poi名称}	小行程路线
我想去日月潭	{日月潭=目的poi名称}	小行程路线
我想去芬兰堡	{芬兰堡=目的poi名称}	小行程路线
我想去托普卡帕宫	{托普卡帕宫=目的poi名称}	小行程路线
我想去红树	{红树=目的poi名称}	小行程路线
我想去凯旋门	{凯旋门=目的poi名称}	小行程路线
我想去猴庙	{猴庙=目的poi名称}	小行程路线
我想去马穆提岛	{马穆提岛=目的poi名称}	小行程路线
我想去维港	{维港=目的poi名称}	小行程路线
我要去孚日宫	{孚日宫=目的poi名称}	小行程路线
我要去青莲院	{青莲院=目的poi名称}	小行程路线
我要去日月潭	{日月潭=目的poi名称}	小行程路线
我要去路易港	{路易港=目的poi名称}	小行程路线
我要去维港	{维港=目的poi名称}	小行程路线
我要去唐人街	{唐人街=目的poi名称}	小行程路线
我要去白沙滩	{白沙滩=目的poi名称}	小行程路线
我要去芬兰堡	{芬兰堡=目的poi名称}	小行程路线
我要去光明寺	{光明寺=目的poi名称}	小行程路线
我要去大夏宫	{大夏宫=目的poi名称}	小行程路线
我要去景福宫	{景福宫=目的poi名称}	小行程路线
我要去马穆提岛	{马穆提岛=目的poi名称}	小行程路线
火车到迪斯尼要多久	{火车=交通方式, 迪斯尼=目的poi名称}	行程属性
地铁到红树要多久	{红树=目的poi名称, 地铁=交通方式}	行程属性
飞机到维多利亚港要多久	{维多利亚港=目的poi名称, 飞机=交通方式}	行程属性
火车到密歇根湖要多久	{火车=交通方式, 密歇根湖=目的poi名称}	行程属性
飞机到大夏宫要多久	{大夏宫=目的poi名称, 飞机=交通方式}	行程属性
飞机到托普卡帕宫要多久	{托普卡帕宫=目的poi名称, 飞机=交通方式}	行程属性
大巴车到青莲院要多久	{大巴车=交通方式, 青莲院=目的poi名称}	行程属性
火车到大夏宫要多久	{火车=交通方式, 大夏宫=目的poi名称}	行程属性
火车到景福宫要多久	{景福宫=目的poi名称, 火车=交通方式}	行程属性
地铁到马穆提岛要多久	{地铁=交通方式, 马穆提岛=目的poi名称}	行程属性
大巴车到鼓浪屿要多久	{大巴车=交通方式, 鼓浪屿=目的poi名称}	行程属性
火车到维多利亚港要多久	{火车=交通方式, 维多利亚港=目的poi名称}	行程属性
地铁到芬兰堡要多久	{芬兰堡=目的poi名称, 地铁=交通方式}	行程属性
大巴车到维多利亚港要多久	{大巴车=交通方式, 维多利亚港=目的poi名称}	行程属性
火车到芬兰堡要多久	{火车=交通方式, 芬兰堡=目的poi名称}	行程属性
地铁到青莲院要多久	{地铁=交通方式, 青莲院=目的poi名称}	行程属性
大巴车到迪士尼要多久	{大巴车=交通方式, 迪士尼=目的poi名称}	行程属性
大巴车到孚日宫要多久	{大巴车=交通方式, 孚日宫=目的poi名称}	行程属性
地铁到大夏宫要多久	{地铁=交通方式, 大夏宫=目的poi名称}	行程属性
飞机到迪斯尼要多久	{飞机=交通方式, 迪斯尼=目的poi名称}	行程属性
大巴车到猴庙要多久	{大巴车=交通方式, 猴庙=目的poi名称}	行程属性
火车到路易港要多久	{火车=交通方式, 路易港=目的poi名称}	行程属性
飞机到维港要多久	{维港=目的poi名称, 飞机=交通方式}	行程属性
飞机到荣军院要多久	{荣军院=目的poi名称, 飞机=交通方式}	行程属性
大巴车到光明寺要多久	{大巴车=交通方式, 光明寺=目的poi名称}	行程属性
飞机到凯旋门要多久	{凯旋门=目的poi名称, 飞机=交通方式}	行程属性
地铁到阿尔法玛要多久	{阿尔法玛=目的poi名称, 地铁=交通方式}	行程属性
地铁到多瑙河要多久	{多瑙河=目的poi名称, 地铁=交通方式}	行程属性
大巴车到九寨沟要多久	{大巴车=交通方式, 九寨沟=目的poi名称}	行程属性
地铁到迪斯尼要多久	{地铁=交通方式, 迪斯尼=目的poi名称}	行程属性
大巴车到红树要多久	{红树=目的poi名称, 大巴车=交通方式}	行程属性
地铁到九寨沟要多久	{九寨沟=目的poi名称, 地铁=交通方式}	行程属性
大巴车到托普卡帕宫要多久	{大巴车=交通方式, 托普卡帕宫=目的poi名称}	行程属性
飞机到唐人街要多久	{唐人街=目的poi名称, 飞机=交通方式}	行程属性
飞机到景福宫要多久	{景福宫=目的poi名称, 飞机=交通方式}	行程属性
地铁到猴庙要多久	{地铁=交通方式, 猴庙=目的poi名称}	行程属性
火车到迪士尼要多久	{火车=交通方式, 迪士尼=目的poi名称}	行程属性
大巴车到迪斯尼要多久	{大巴车=交通方式, 迪斯尼=目的poi名称}	行程属性
火车到卢浮宫要多久	{火车=交通方式, 卢浮宫=目的poi名称}	行程属性
大巴车到玛黑区要多久	{玛黑区=目的poi名称, 大巴车=交通方式}	行程属性
大巴车到密歇根湖要多久	{大巴车=交通方式, 密歇根湖=目的poi名称}	行程属性
飞机到阿尔法玛要多久	{阿尔法玛=目的poi名称, 飞机=交通方式}	行程属性
地铁到莱茵河要多久	{莱茵河=目的poi名称, 地铁=交通方式}	行程属性
大巴车到马穆提岛要多久	{大巴车=交通方式, 马穆提岛=目的poi名称}	行程属性
火车到荣军院要多久	{火车=交通方式, 荣军院=目的poi名称}	行程属性
大巴车到景福宫要多久	{大巴车=交通方式, 景福宫=目的poi名称}	行程属性
飞机到猴庙要多久	{猴庙=目的poi名称, 飞机=交通方式}	行程属性
地铁到玛黑区要多久	{玛黑区=目的poi名称, 地铁=交通方式}	行程属性
地铁到金阁寺要多久	{地铁=交通方式, 金阁寺=目的poi名称}	行程属性
火车到鼓浪屿要多久	{火车=交通方式, 鼓浪屿=目的poi名称}	行程属性
地铁到维多利亚港要多久	{维多利亚港=目的poi名称, 地铁=交通方式}	行程属性
火车到阿尔法玛要多久	{火车=交通方式, 阿尔法玛=目的poi名称}	行程属性
火车到青莲院要多久	{火车=交通方式, 青莲院=目的poi名称}	行程属性
地铁到托普卡帕宫要多久	{地铁=交通方式, 托普卡帕宫=目的poi名称}	行程属性
飞机到玛黑区要多久	{玛黑区=目的poi名称, 飞机=交通方式}	行程属性
飞机到全聚德要多久	{全聚德=目的poi名称, 飞机=交通方式}	行程属性
火车到凯旋门要多久	{火车=交通方式, 凯旋门=目的poi名称}	行程属性
大巴车到大夏宫要多久	{大巴车=交通方式, 大夏宫=目的poi名称}	行程属性
火车到金阁寺要多久	{火车=交通方式, 金阁寺=目的poi名称}	行程属性
火车到红树要多久	{红树=目的poi名称, 火车=交通方式}	行程属性
火车到唐人街要多久	{唐人街=目的poi名称, 火车=交通方式}	行程属性
地铁到密歇根湖要多久	{密歇根湖=目的poi名称, 地铁=交通方式}	行程属性
大巴车到路易港要多久	{大巴车=交通方式, 路易港=目的poi名称}	行程属性
火车到白沙滩要多久	{火车=交通方式, 白沙滩=目的poi名称}	行程属性
飞机到青莲院要多久	{青莲院=目的poi名称, 飞机=交通方式}	行程属性
大巴车到莱茵河要多久	{莱茵河=目的poi名称, 大巴车=交通方式}	行程属性
地铁到迪士尼要多久	{地铁=交通方式, 迪士尼=目的poi名称}	行程属性
飞机到莱茵河要多久	{莱茵河=目的poi名称, 飞机=交通方式}	行程属性
火车到日月潭要多久	{日月潭=目的poi名称, 火车=交通方式}	行程属性
地铁到卢浮宫要多久	{卢浮宫=目的poi名称, 地铁=交通方式}	行程属性
飞机到卢浮宫要多久	{卢浮宫=目的poi名称, 飞机=交通方式}	行程属性
飞机到马穆提岛要多久	{马穆提岛=目的poi名称, 飞机=交通方式}	行程属性
飞机到九寨沟要多久	{九寨沟=目的poi名称, 飞机=交通方式}	行程属性
大巴车到全聚德要多久	{大巴车=交通方式, 全聚德=目的poi名称}	行程属性
火车到玛黑区要多久	{玛黑区=目的poi名称, 火车=交通方式}	行程属性
火车到光明寺要多久	{火车=交通方式, 光明寺=目的poi名称}	行程属性
地铁去凯旋门要多长时间	{地铁=交通方式, 凯旋门=目的poi名称}	行程属性
飞机去多瑙河要多长时间	{多瑙河=目的poi名称, 飞机=交通方式}	行程属性
地铁去玛黑区要多长时间	{玛黑区=目的poi名称, 地铁=交通方式}	行程属性
大巴车去光明寺要多长时间	{大巴车=交通方式, 光明寺=目的poi名称}	行程属性
地铁去维港要多长时间	{维港=目的poi名称, 地铁=交通方式}	行程属性
地铁去日月潭要多长时间	{日月潭=目的poi名称, 地铁=交通方式}	行程属性
火车去青莲院要多长时间	{火车=交通方式, 青莲院=目的poi名称}	行程属性
地铁去阿尔法玛要多长时间	{阿尔法玛=目的poi名称, 地铁=交通方式}	行程属性
飞机去芬兰堡要多长时间	{芬兰堡=目的poi名称, 飞机=交通方式}	行程属性
飞机去托普卡帕宫要多长时间	{托普卡帕宫=目的poi名称, 飞机=交通方式}	行程属性
飞机去日月潭要多长时间	{日月潭=目的poi名称, 飞机=交通方式}	行程属性
飞机去路易港要多长时间	{路易港=目的poi名称, 飞机=交通方式}	行程属性
地铁去路易港要多长时间	{地铁=交通方式, 路易港=目的poi名称}	行程属性
火车去日月潭要多长时间	{日月潭=目的poi名称, 火车=交通方式}	行程属性
火车去马穆提岛要多长时间	{火车=交通方式, 马穆提岛=目的poi名称}	行程属性
飞机去光明寺要多长时间	{光明寺=目的poi名称, 飞机=交通方式}	行程属性
飞机去孚日宫要多长时间	{孚日宫=目的poi名称, 飞机=交通方式}	行程属性
地铁去马穆提岛要多长时间	{地铁=交通方式, 马穆提岛=目的poi名称}	行程属性
地铁去芬兰堡要多长时间	{芬兰堡=目的poi名称, 地铁=交通方式}	行程属性
大巴车去猴庙要多长时间	{大巴车=交通方式, 猴庙=目的poi名称}	行程属性
地铁去金阁寺要多长时间	{地铁=交通方式, 金阁寺=目的poi名称}	行程属性
火车去金阁寺要多长时间	{火车=交通方式, 金阁寺=目的poi名称}	行程属性
大巴车去白沙滩要多长时间	{大巴车=交通方式, 白沙滩=目的poi名称}	行程属性
大巴车去新加坡河要多长时间	{大巴车=交通方式, 新加坡河=目的poi名称}	行程属性
飞机去凯旋门要多长时间	{凯旋门=目的poi名称, 飞机=交通方式}	行程属性
飞机去新加坡河要多长时间	{新加坡河=目的poi名称, 飞机=交通方式}	行程属性
火车去鼓浪屿要多长时间	{火车=交通方式, 鼓浪屿=目的poi名称}	行程属性
飞机去唐人街要多长时间	{唐人街=目的poi名称, 飞机=交通方式}	行程属性
火车去猴庙要多长时间	{火车=交通方式, 猴庙=目的poi名称}	行程属性
火车去密歇根湖要多长时间	{火车=交通方式, 密歇根湖=目的poi名称}	行程属性
飞机去白沙滩要多长时间	{白沙滩=目的poi名称, 飞机=交通方式}	行程属性
飞机去卢浮宫要多长时间	{卢浮宫=目的poi名称, 飞机=交通方式}	行程属性
地铁去唐人街要多长时间	{唐人街=目的poi名称, 地铁=交通方式}	行程属性
大巴车去九寨沟要多长时间	{大巴车=交通方式, 九寨沟=目的poi名称}	行程属性
大巴车去密歇根湖要多长时间	{大巴车=交通方式, 密歇根湖=目的poi名称}	行程属性
火车去维港要多长时间	{维港=目的poi名称, 火车=交通方式}	行程属性
火车去路易港要多长时间	{火车=交通方式, 路易港=目的poi名称}	行程属性
地铁去全聚德要多长时间	{全聚德=目的poi名称, 地铁=交通方式}	行程属性
飞机去荣军院要多长时间	{荣军院=目的poi名称, 飞机=交通方式}	行程属性
大巴车去大夏宫要多长时间	{大巴车=交通方式, 大夏宫=目的poi名称}	行程属性
大巴车去马穆提岛要多长时间	{大巴车=交通方式, 马穆提岛=目的poi名称}	行程属性
地铁去景福宫要多长时间	{景福宫=目的poi名称, 地铁=交通方式}	行程属性
火车去玛黑区要多长时间	{玛黑区=目的poi名称, 火车=交通方式}	行程属性
飞机去九寨沟要多长时间	{九寨沟=目的poi名称, 飞机=交通方式}	行程属性
火车去九寨沟要多长时间	{火车=交通方式, 九寨沟=目的poi名称}	行程属性
地铁去青莲院要多长时间	{地铁=交通方式, 青莲院=目的poi名称}	行程属性
火车去红树要多长时间	{红树=目的poi名称, 火车=交通方式}	行程属性
大巴车去维多利亚港要多长时间	{大巴车=交通方式, 维多利亚港=目的poi名称}	行程属性
大巴车去日月潭要多长时间	{日月潭=目的poi名称, 大巴车=交通方式}	行程属性
大巴车去路易港要多长时间	{大巴车=交通方式, 路易港=目的poi名称}	行程属性
大巴车去芬兰堡要多长时间	{大巴车=交通方式, 芬兰堡=目的poi名称}	行程属性
火车去光明寺要多长时间	{火车=交通方式, 光明寺=目的poi名称}	行程属性
飞机去马穆提岛要多长时间	{马穆提岛=目的poi名称, 飞机=交通方式}	行程属性
地铁去鼓浪屿要多长时间	{地铁=交通方式, 鼓浪屿=目的poi名称}	行程属性
火车去维多利亚港要多长时间	{火车=交通方式, 维多利亚港=目的poi名称}	行程属性
火车去白沙滩要多长时间	{火车=交通方式, 白沙滩=目的poi名称}	行程属性
地铁去卢浮宫要多长时间	{卢浮宫=目的poi名称, 地铁=交通方式}	行程属性
飞机去维港要多长时间	{维港=目的poi名称, 飞机=交通方式}	行程属性
飞机去密歇根湖要多长时间	{密歇根湖=目的poi名称, 飞机=交通方式}	行程属性
地铁去大夏宫要多长时间	{地铁=交通方式, 大夏宫=目的poi名称}	行程属性
飞机去全聚德要多长时间	{全聚德=目的poi名称, 飞机=交通方式}	行程属性
大巴车去全聚德要多长时间	{大巴车=交通方式, 全聚德=目的poi名称}	行程属性
地铁去猴庙要多长时间	{地铁=交通方式, 猴庙=目的poi名称}	行程属性
飞机去玛黑区要多长时间	{玛黑区=目的poi名称, 飞机=交通方式}	行程属性
地铁去莱茵河要多长时间	{莱茵河=目的poi名称, 地铁=交通方式}	行程属性
地铁去白沙滩要多长时间	{白沙滩=目的poi名称, 地铁=交通方式}	行程属性
飞机去金阁寺要多长时间	{飞机=交通方式, 金阁寺=目的poi名称}	行程属性
大巴车去托普卡帕宫要多长时间	{大巴车=交通方式, 托普卡帕宫=目的poi名称}	行程属性
飞机去大夏宫要多长时间	{大夏宫=目的poi名称, 飞机=交通方式}	行程属性
飞机去鼓浪屿要多长时间	{鼓浪屿=目的poi名称, 飞机=交通方式}	行程属性
地铁去新加坡河要多长时间	{新加坡河=目的poi名称, 地铁=交通方式}	行程属性
地铁去维多利亚港要多长时间	{维多利亚港=目的poi名称, 地铁=交通方式}	行程属性
火车去孚日宫要多长时间	{孚日宫=目的poi名称, 火车=交通方式}	行程属性
飞机去阿尔法玛要多长时间	{阿尔法玛=目的poi名称, 飞机=交通方式}	行程属性
地铁去迪斯尼要多长时间	{地铁=交通方式, 迪斯尼=目的poi名称}	行程属性
飞机去迪士尼要多长时间	{迪士尼=目的poi名称, 飞机=交通方式}	行程属性
大巴车去卢浮宫要多长时间	{大巴车=交通方式, 卢浮宫=目的poi名称}	行程属性
大巴车去金阁寺要多长时间	{大巴车=交通方式, 金阁寺=目的poi名称}	行程属性
火车去景福宫要多长时间	{景福宫=目的poi名称, 火车=交通方式}	行程属性
飞机去红树要多长时间	{红树=目的poi名称, 飞机=交通方式}	行程属性
火车去卢浮宫要多长时间	{火车=交通方式, 卢浮宫=目的poi名称}	行程属性
大巴车去迪斯尼要多长时间	{大巴车=交通方式, 迪斯尼=目的poi名称}	行程属性
火车去凯旋门要多长时间	{火车=交通方式, 凯旋门=目的poi名称}	行程属性
大巴车去玛黑区要多长时间	{玛黑区=目的poi名称, 大巴车=交通方式}	行程属性
大巴车去莱茵河要多长时间	{莱茵河=目的poi名称, 大巴车=交通方式}	行程属性
飞机去维多利亚港要多长时间	{维多利亚港=目的poi名称, 飞机=交通方式}	行程属性
火车去多瑙河要多长时间	{火车=交通方式, 多瑙河=目的poi名称}	行程属性
地铁多长时间能到青莲院	{地铁=交通方式, 青莲院=目的poi名称}	行程属性
地铁多长时间能到新加坡河	{新加坡河=目的poi名称, 地铁=交通方式}	行程属性
地铁多长时间能到景福宫	{景福宫=目的poi名称, 地铁=交通方式}	行程属性
大巴车多长时间能到路易港	{大巴车=交通方式, 路易港=目的poi名称}	行程属性
火车多长时间能到迪斯尼	{火车=交通方式, 迪斯尼=目的poi名称}	行程属性
飞机多长时间能到九寨沟	{九寨沟=目的poi名称, 飞机=交通方式}	行程属性
飞机多长时间能到多瑙河	{多瑙河=目的poi名称, 飞机=交通方式}	行程属性
大巴车多长时间能到荣军院	{大巴车=交通方式, 荣军院=目的poi名称}	行程属性
火车多长时间能到玛黑区	{玛黑区=目的poi名称, 火车=交通方式}	行程属性
飞机多长时间能到迪士尼	{迪士尼=目的poi名称, 飞机=交通方式}	行程属性
火车多长时间能到荣军院	{火车=交通方式, 荣军院=目的poi名称}	行程属性
大巴车多长时间能到凯旋门	{大巴车=交通方式, 凯旋门=目的poi名称}	行程属性
火车多长时间能到猴庙	{火车=交通方式, 猴庙=目的poi名称}	行程属性
飞机多长时间能到红树	{红树=目的poi名称, 飞机=交通方式}	行程属性
火车多长时间能到唐人街	{唐人街=目的poi名称, 火车=交通方式}	行程属性
地铁多长时间能到猴庙	{地铁=交通方式, 猴庙=目的poi名称}	行程属性
火车多长时间能到路易港	{火车=交通方式, 路易港=目的poi名称}	行程属性
地铁多长时间能到多瑙河	{多瑙河=目的poi名称, 地铁=交通方式}	行程属性
大巴车多长时间能到青莲院	{大巴车=交通方式, 青莲院=目的poi名称}	行程属性
火车多长时间能到大夏宫	{火车=交通方式, 大夏宫=目的poi名称}	行程属性
地铁多长时间能到红树	{红树=目的poi名称, 地铁=交通方式}	行程属性
飞机多长时间能到大夏宫	{大夏宫=目的poi名称, 飞机=交通方式}	行程属性
地铁多长时间能到日月潭	{日月潭=目的poi名称, 地铁=交通方式}	行程属性
火车多长时间能到光明寺	{火车=交通方式, 光明寺=目的poi名称}	行程属性
大巴车多长时间能到维多利亚港	{大巴车=交通方式, 维多利亚港=目的poi名称}	行程属性
大巴车多长时间能到金阁寺	{大巴车=交通方式, 金阁寺=目的poi名称}	行程属性
火车多长时间能到青莲院	{火车=交通方式, 青莲院=目的poi名称}	行程属性
地铁多长时间能到荣军院	{地铁=交通方式, 荣军院=目的poi名称}	行程属性
飞机多长时间能到景福宫	{景福宫=目的poi名称, 飞机=交通方式}	行程属性
地铁多长时间能到卢浮宫	{卢浮宫=目的poi名称, 地铁=交通方式}	行程属性
地铁多长时间能到阿尔法玛	{阿尔法玛=目的poi名称, 地铁=交通方式}	行程属性
地铁多长时间能到孚日宫	{孚日宫=目的poi名称, 地铁=交通方式}	行程属性
大巴车多长时间能到玛黑区	{玛黑区=目的poi名称, 大巴车=交通方式}	行程属性
飞机多长时间能到全聚德	{全聚德=目的poi名称, 飞机=交通方式}	行程属性
飞机多长时间能到莱茵河	{莱茵河=目的poi名称, 飞机=交通方式}	行程属性
大巴车多长时间能到唐人街	{大巴车=交通方式, 唐人街=目的poi名称}	行程属性
飞机多长时间能到马穆提岛	{马穆提岛=目的poi名称, 飞机=交通方式}	行程属性
大巴车多长时间能到光明寺	{大巴车=交通方式, 光明寺=目的poi名称}	行程属性
火车多长时间能到密歇根湖	{火车=交通方式, 密歇根湖=目的poi名称}	行程属性
飞机多长时间能到光明寺	{光明寺=目的poi名称, 飞机=交通方式}	行程属性
飞机多长时间能到玛黑区	{玛黑区=目的poi名称, 飞机=交通方式}	行程属性
地铁多长时间能到凯旋门	{地铁=交通方式, 凯旋门=目的poi名称}	行程属性
火车多长时间能到金阁寺	{火车=交通方式, 金阁寺=目的poi名称}	行程属性
飞机多长时间能到密歇根湖	{密歇根湖=目的poi名称, 飞机=交通方式}	行程属性
地铁多长时间能到白沙滩	{白沙滩=目的poi名称, 地铁=交通方式}	行程属性
大巴车多长时间能到九寨沟	{大巴车=交通方式, 九寨沟=目的poi名称}	行程属性
大巴车多长时间能到日月潭	{日月潭=目的poi名称, 大巴车=交通方式}	行程属性
飞机多长时间能到荣军院	{荣军院=目的poi名称, 飞机=交通方式}	行程属性
火车多长时间能到马穆提岛	{火车=交通方式, 马穆提岛=目的poi名称}	行程属性
地铁多长时间能到维多利亚港	{维多利亚港=目的poi名称, 地铁=交通方式}	行程属性
飞机多长时间能到路易港	{路易港=目的poi名称, 飞机=交通方式}	行程属性
火车多长时间能到鼓浪屿	{火车=交通方式, 鼓浪屿=目的poi名称}	行程属性
飞机多长时间能到白沙滩	{白沙滩=目的poi名称, 飞机=交通方式}	行程属性
大巴车多长时间能到新加坡河	{大巴车=交通方式, 新加坡河=目的poi名称}	行程属性
飞机多长时间能到维港	{维港=目的poi名称, 飞机=交通方式}	行程属性
大巴车多长时间能到阿尔法玛	{大巴车=交通方式, 阿尔法玛=目的poi名称}	行程属性
大巴车多长时间能到莱茵河	{莱茵河=目的poi名称, 大巴车=交通方式}	行程属性
飞机多长时间能到凯旋门	{凯旋门=目的poi名称, 飞机=交通方式}	行程属性
飞机多长时间能到维多利亚港	{维多利亚港=目的poi名称, 飞机=交通方式}	行程属性
地铁多长时间能到密歇根湖	{密歇根湖=目的poi名称, 地铁=交通方式}	行程属性
大巴车多长时间能到大夏宫	{大巴车=交通方式, 大夏宫=目的poi名称}	行程属性
地铁多长时间能到迪斯尼	{地铁=交通方式, 迪斯尼=目的poi名称}	行程属性
飞机多长时间能到鼓浪屿	{鼓浪屿=目的poi名称, 飞机=交通方式}	行程属性
火车多长时间能到孚日宫	{孚日宫=目的poi名称, 火车=交通方式}	行程属性
大巴车多长时间能到孚日宫	{大巴车=交通方式, 孚日宫=目的poi名称}	行程属性
飞机多长时间能到芬兰堡	{芬兰堡=目的poi名称, 飞机=交通方式}	行程属性
火车多长时间能到九寨沟	{火车=交通方式, 九寨沟=目的poi名称}	行程属性
大巴车多长时间能到多瑙河	{大巴车=交通方式, 多瑙河=目的poi名称}	行程属性
火车多长时间能到维多利亚港	{火车=交通方式, 维多利亚港=目的poi名称}	行程属性
大巴车多长时间能到马穆提岛	{大巴车=交通方式, 马穆提岛=目的poi名称}	行程属性
地铁多长时间能到芬兰堡	{芬兰堡=目的poi名称, 地铁=交通方式}	行程属性
大巴车多长时间能到猴庙	{大巴车=交通方式, 猴庙=目的poi名称}	行程属性
地铁多长时间能到九寨沟	{九寨沟=目的poi名称, 地铁=交通方式}	行程属性
火车多长时间能到维港	{维港=目的poi名称, 火车=交通方式}	行程属性
火车多长时间能到芬兰堡	{火车=交通方式, 芬兰堡=目的poi名称}	行程属性
飞机多长时间能到新加坡河	{新加坡河=目的poi名称, 飞机=交通方式}	行程属性
飞机多长时间能到唐人街	{唐人街=目的poi名称, 飞机=交通方式}	行程属性
从本地大巴车到新加坡河需要多久	{大巴车=交通方式, 本地=出发GPS, 新加坡河=目的poi名称}	行程属性
从本地火车到唐人街需要多久	{唐人街=目的poi名称, 火车=交通方式, 本地=出发GPS}	行程属性
从这儿飞机到孚日宫需要多久	{孚日宫=目的poi名称, 这儿=出发GPS, 飞机=交通方式}	行程属性
从本地飞机到多瑙河需要多久	{本地=出发GPS, 多瑙河=目的poi名称, 飞机=交通方式}	行程属性
从这里飞机到莱茵河需要多久	{莱茵河=目的poi名称, 这里=出发GPS, 飞机=交通方式}	行程属性
从这儿地铁到红树需要多久	{红树=目的poi名称, 这儿=出发GPS, 地铁=交通方式}	行程属性
从本地飞机到荣军院需要多久	{本地=出发GPS, 荣军院=目的poi名称, 飞机=交通方式}	行程属性
从这儿飞机到托普卡帕宫需要多久	{这儿=出发GPS, 托普卡帕宫=目的poi名称, 飞机=交通方式}	行程属性
从这里火车到玛黑区需要多久	{玛黑区=目的poi名称, 这里=出发GPS, 火车=交通方式}	行程属性
从本地大巴车到托普卡帕宫需要多久	{大巴车=交通方式, 本地=出发GPS, 托普卡帕宫=目的poi名称}	行程属性
从这里地铁到凯旋门需要多久	{这里=出发GPS, 地铁=交通方式, 凯旋门=目的poi名称}	行程属性
从本地飞机到玛黑区需要多久	{玛黑区=目的poi名称, 本地=出发GPS, 飞机=交通方式}	行程属性
从这里飞机到迪斯尼需要多久	{这里=出发GPS, 飞机=交通方式, 迪斯尼=目的poi名称}	行程属性
从这儿大巴车到玛黑区需要多久	{玛黑区=目的poi名称, 大巴车=交通方式, 这儿=出发GPS}	行程属性
从这儿大巴车到莱茵河需要多久	{莱茵河=目的poi名称, 大巴车=交通方式, 这儿=出发GPS}	行程属性
从这里地铁到多瑙河需要多久	{这里=出发GPS, 多瑙河=目的poi名称, 地铁=交通方式}	行程属性
从本地火车到金阁寺需要多久	{火车=交通方式, 本地=出发GPS, 金阁寺=目的poi名称}	行程属性
从这儿地铁到密歇根湖需要多久	{这儿=出发GPS, 密歇根湖=目的poi名称, 地铁=交通方式}	行程属性
从这儿地铁到鼓浪屿需要多久	{这儿=出发GPS, 地铁=交通方式, 鼓浪屿=目的poi名称}	行程属性
从这儿地铁到新加坡河需要多久	{这儿=出发GPS, 新加坡河=目的poi名称, 地铁=交通方式}	行程属性
从本地大巴车到白沙滩需要多久	{大巴车=交通方式, 白沙滩=目的poi名称, 本地=出发GPS}	行程属性
从本地火车到光明寺需要多久	{火车=交通方式, 本地=出发GPS, 光明寺=目的poi名称}	行程属性
从这儿飞机到迪士尼需要多久	{这儿=出发GPS, 迪士尼=目的poi名称, 飞机=交通方式}	行程属性
从本地地铁到荣军院需要多久	{本地=出发GPS, 地铁=交通方式, 荣军院=目的poi名称}	行程属性
从这儿火车到猴庙需要多久	{火车=交通方式, 这儿=出发GPS, 猴庙=目的poi名称}	行程属性
从这里火车到马穆提岛需要多久	{这里=出发GPS, 火车=交通方式, 马穆提岛=目的poi名称}	行程属性
从这里飞机到红树需要多久	{红树=目的poi名称, 这里=出发GPS, 飞机=交通方式}	行程属性
从本地地铁到密歇根湖需要多久	{本地=出发GPS, 密歇根湖=目的poi名称, 地铁=交通方式}	行程属性
从本地火车到全聚德需要多久	{全聚德=目的poi名称, 火车=交通方式, 本地=出发GPS}	行程属性
从本地火车到路易港需要多久	{火车=交通方式, 本地=出发GPS, 路易港=目的poi名称}	行程属性
从这里大巴车到芬兰堡需要多久	{这里=出发GPS, 大巴车=交通方式, 芬兰堡=目的poi名称}	行程属性
从本地地铁到青莲院需要多久	{本地=出发GPS, 地铁=交通方式, 青莲院=目的poi名称}	行程属性
从本地地铁到全聚德需要多久	{全聚德=目的poi名称, 本地=出发GPS, 地铁=交通方式}	行程属性
从这里地铁到鼓浪屿需要多久	{这里=出发GPS, 地铁=交通方式, 鼓浪屿=目的poi名称}	行程属性
从本地地铁到维港需要多久	{维港=目的poi名称, 本地=出发GPS, 地铁=交通方式}	行程属性
从本地飞机到白沙滩需要多久	{白沙滩=目的poi名称, 本地=出发GPS, 飞机=交通方式}	行程属性
从本地飞机到光明寺需要多久	{本地=出发GPS, 光明寺=目的poi名称, 飞机=交通方式}	行程属性
从这里飞机到孚日宫需要多久	{这里=出发GPS, 孚日宫=目的poi名称, 飞机=交通方式}	行程属性
从这儿火车到托普卡帕宫需要多久	{火车=交通方式, 这儿=出发GPS, 托普卡帕宫=目的poi名称}	行程属性
从这儿大巴车到芬兰堡需要多久	{大巴车=交通方式, 这儿=出发GPS, 芬兰堡=目的poi名称}	行程属性
从本地火车到密歇根湖需要多久	{火车=交通方式, 本地=出发GPS, 密歇根湖=目的poi名称}	行程属性
从这儿飞机到九寨沟需要多久	{九寨沟=目的poi名称, 这儿=出发GPS, 飞机=交通方式}	行程属性
从本地地铁到阿尔法玛需要多久	{本地=出发GPS, 阿尔法玛=目的poi名称, 地铁=交通方式}	行程属性
从这儿火车到维多利亚港需要多久	{火车=交通方式, 这儿=出发GPS, 维多利亚港=目的poi名称}	行程属性
从本地飞机到日月潭需要多久	{日月潭=目的poi名称, 本地=出发GPS, 飞机=交通方式}	行程属性
从本地地铁到红树需要多久	{红树=目的poi名称, 本地=出发GPS, 地铁=交通方式}	行程属性
从这里地铁到迪士尼需要多久	{这里=出发GPS, 地铁=交通方式, 迪士尼=目的poi名称}	行程属性
从这里地铁到芬兰堡需要多久	{这里=出发GPS, 芬兰堡=目的poi名称, 地铁=交通方式}	行程属性
从本地火车到鼓浪屿需要多久	{火车=交通方式, 本地=出发GPS, 鼓浪屿=目的poi名称}	行程属性
从这儿地铁到白沙滩需要多久	{这儿=出发GPS, 白沙滩=目的poi名称, 地铁=交通方式}	行程属性
从这里地铁到阿尔法玛需要多久	{这里=出发GPS, 阿尔法玛=目的poi名称, 地铁=交通方式}	行程属性
从这里火车到维港需要多久	{这里=出发GPS, 维港=目的poi名称, 火车=交通方式}	行程属性
从这儿地铁到荣军院需要多久	{这儿=出发GPS, 地铁=交通方式, 荣军院=目的poi名称}	行程属性
从这儿地铁到唐人街需要多久	{唐人街=目的poi名称, 这儿=出发GPS, 地铁=交通方式}	行程属性
从这儿火车到阿尔法玛需要多久	{火车=交通方式, 这儿=出发GPS, 阿尔法玛=目的poi名称}	行程属性
从本地地铁到鼓浪屿需要多久	{本地=出发GPS, 地铁=交通方式, 鼓浪屿=目的poi名称}	行程属性
从本地地铁到多瑙河需要多久	{本地=出发GPS, 多瑙河=目的poi名称, 地铁=交通方式}	行程属性
从这儿飞机到维港需要多久	{维港=目的poi名称, 这儿=出发GPS, 飞机=交通方式}	行程属性
从这里地铁到维多利亚港需要多久	{这里=出发GPS, 维多利亚港=目的poi名称, 地铁=交通方式}	行程属性
从这里地铁到孚日宫需要多久	{这里=出发GPS, 孚日宫=目的poi名称, 地铁=交通方式}	行程属性
从这里火车到九寨沟需要多久	{这里=出发GPS, 火车=交通方式, 九寨沟=目的poi名称}	行程属性
从本地火车到维港需要多久	{维港=目的poi名称, 火车=交通方式, 本地=出发GPS}	行程属性
从本地飞机到金阁寺需要多久	{本地=出发GPS, 飞机=交通方式, 金阁寺=目的poi名称}	行程属性
从这里飞机到阿尔法玛需要多久	{这里=出发GPS, 阿尔法玛=目的poi名称, 飞机=交通方式}	行程属性
从本地大巴车到全聚德需要多久	{大巴车=交通方式, 全聚德=目的poi名称, 本地=出发GPS}	行程属性
从这儿火车到白沙滩需要多久	{火车=交通方式, 这儿=出发GPS, 白沙滩=目的poi名称}	行程属性
从本地飞机到青莲院需要多久	{本地=出发GPS, 青莲院=目的poi名称, 飞机=交通方式}	行程属性
从这里大巴车到红树需要多久	{红树=目的poi名称, 这里=出发GPS, 大巴车=交通方式}	行程属性
从这里火车到荣军院需要多久	{这里=出发GPS, 火车=交通方式, 荣军院=目的poi名称}	行程属性
从本地飞机到九寨沟需要多久	{九寨沟=目的poi名称, 本地=出发GPS, 飞机=交通方式}	行程属性
从这里地铁到光明寺需要多久	{这里=出发GPS, 光明寺=目的poi名称, 地铁=交通方式}	行程属性
从本地大巴车到金阁寺需要多久	{大巴车=交通方式, 本地=出发GPS, 金阁寺=目的poi名称}	行程属性
从本地飞机到莱茵河需要多久	{莱茵河=目的poi名称, 本地=出发GPS, 飞机=交通方式}	行程属性
从本地飞机到迪士尼需要多久	{本地=出发GPS, 迪士尼=目的poi名称, 飞机=交通方式}	行程属性
从本地飞机到鼓浪屿需要多久	{本地=出发GPS, 鼓浪屿=目的poi名称, 飞机=交通方式}	行程属性
从这儿大巴车到凯旋门需要多久	{大巴车=交通方式, 这儿=出发GPS, 凯旋门=目的poi名称}	行程属性
从这儿地铁到青莲院需要多久	{这儿=出发GPS, 地铁=交通方式, 青莲院=目的poi名称}	行程属性
从这儿火车到全聚德需要多久	{全聚德=目的poi名称, 火车=交通方式, 这儿=出发GPS}	行程属性
从这儿大巴车到唐人街需要多久	{大巴车=交通方式, 唐人街=目的poi名称, 这儿=出发GPS}	行程属性
从这里火车到卢浮宫需要多久	{这里=出发GPS, 火车=交通方式, 卢浮宫=目的poi名称}	行程属性
从这儿大巴车到维港需要多久	{大巴车=交通方式, 维港=目的poi名称, 这儿=出发GPS}	行程属性
从这里大巴车到托普卡帕宫需要多久	{这里=出发GPS, 大巴车=交通方式, 托普卡帕宫=目的poi名称}	行程属性
从本地火车到孚日宫需要多久	{孚日宫=目的poi名称, 火车=交通方式, 本地=出发GPS}	行程属性
从这儿火车到莱茵河需要多久	{莱茵河=目的poi名称, 火车=交通方式, 这儿=出发GPS}	行程属性
从这儿火车到新加坡河需要多久	{火车=交通方式, 这儿=出发GPS, 新加坡河=目的poi名称}	行程属性
从这里火车到孚日宫需要多久	{这里=出发GPS, 孚日宫=目的poi名称, 火车=交通方式}	行程属性
从这里大巴车到白沙滩需要多久	{这里=出发GPS, 大巴车=交通方式, 白沙滩=目的poi名称}	行程属性
从这儿地铁到托普卡帕宫需要多久	{这儿=出发GPS, 地铁=交通方式, 托普卡帕宫=目的poi名称}	行程属性
从本地大巴车到马穆提岛需要多久	{大巴车=交通方式, 本地=出发GPS, 马穆提岛=目的poi名称}	行程属性
从这里地铁到唐人街需要多久	{这里=出发GPS, 唐人街=目的poi名称, 地铁=交通方式}	行程属性
从本地大巴车到维多利亚港需要多久	{大巴车=交通方式, 维多利亚港=目的poi名称, 本地=出发GPS}	行程属性
从这里飞机到唐人街需要多久	{这里=出发GPS, 唐人街=目的poi名称, 飞机=交通方式}	行程属性
从这里大巴车到莱茵河需要多久	{莱茵河=目的poi名称, 这里=出发GPS, 大巴车=交通方式}	行程属性
从这儿飞机到凯旋门需要多久	{这儿=出发GPS, 凯旋门=目的poi名称, 飞机=交通方式}	行程属性
从这儿火车到唐人街需要多久	{唐人街=目的poi名称, 火车=交通方式, 这儿=出发GPS}	行程属性
从这儿火车到马穆提岛需要多久	{火车=交通方式, 这儿=出发GPS, 马穆提岛=目的poi名称}	行程属性
从这儿地铁到多瑙河需要多久	{这儿=出发GPS, 多瑙河=目的poi名称, 地铁=交通方式}	行程属性
从这里地铁到景福宫需要多久	{这里=出发GPS, 景福宫=目的poi名称, 地铁=交通方式}	行程属性
从这儿火车到景福宫需要多久	{景福宫=目的poi名称, 火车=交通方式, 这儿=出发GPS}	行程属性
从这里大巴车到唐人街需要多久	{这里=出发GPS, 大巴车=交通方式, 唐人街=目的poi名称}	行程属性
从这里火车多久能到芬兰堡	{这里=出发GPS, 火车=交通方式, 芬兰堡=目的poi名称}	行程属性
从这里飞机多久能到芬兰堡	{这里=出发GPS, 芬兰堡=目的poi名称, 飞机=交通方式}	行程属性
从本地地铁多久能到白沙滩	{白沙滩=目的poi名称, 本地=出发GPS, 地铁=交通方式}	行程属性
从本地飞机多久能到光明寺	{本地=出发GPS, 光明寺=目的poi名称, 飞机=交通方式}	行程属性
从这儿飞机多久能到多瑙河	{这儿=出发GPS, 多瑙河=目的poi名称, 飞机=交通方式}	行程属性
从本地火车多久能到全聚德	{全聚德=目的poi名称, 火车=交通方式, 本地=出发GPS}	行程属性
从这里飞机多久能到卢浮宫	{这里=出发GPS, 卢浮宫=目的poi名称, 飞机=交通方式}	行程属性
从本地飞机多久能到迪士尼	{本地=出发GPS, 迪士尼=目的poi名称, 飞机=交通方式}	行程属性
从这里飞机多久能到金阁寺	{这里=出发GPS, 飞机=交通方式, 金阁寺=目的poi名称}	行程属性
从这里火车多久能到莱茵河	{莱茵河=目的poi名称, 这里=出发GPS, 火车=交通方式}	行程属性
从这儿地铁多久能到莱茵河	{莱茵河=目的poi名称, 这儿=出发GPS, 地铁=交通方式}	行程属性
从本地飞机多久能到莱茵河	{莱茵河=目的poi名称, 本地=出发GPS, 飞机=交通方式}	行程属性
从这儿飞机多久能到红树	{红树=目的poi名称, 这儿=出发GPS, 飞机=交通方式}	行程属性
从这里地铁多久能到唐人街	{这里=出发GPS, 唐人街=目的poi名称, 地铁=交通方式}	行程属性
从这里飞机多久能到大夏宫	{这里=出发GPS, 大夏宫=目的poi名称, 飞机=交通方式}	行程属性
从这儿飞机多久能到迪斯尼	{这儿=出发GPS, 飞机=交通方式, 迪斯尼=目的poi名称}	行程属性
从本地火车多久能到红树	{红树=目的poi名称, 火车=交通方式, 本地=出发GPS}	行程属性
从这里地铁多久能到鼓浪屿	{这里=出发GPS, 地铁=交通方式, 鼓浪屿=目的poi名称}	行程属性
从这里飞机多久能到密歇根湖	{这里=出发GPS, 密歇根湖=目的poi名称, 飞机=交通方式}	行程属性
从本地地铁多久能到玛黑区	{玛黑区=目的poi名称, 本地=出发GPS, 地铁=交通方式}	行程属性
从这儿地铁多久能到迪斯尼	{这儿=出发GPS, 地铁=交通方式, 迪斯尼=目的poi名称}	行程属性
从本地大巴车多久能到九寨沟	{大巴车=交通方式, 九寨沟=目的poi名称, 本地=出发GPS}	行程属性
从这里火车多久能到路易港	{这里=出发GPS, 火车=交通方式, 路易港=目的poi名称}	行程属性
从这里火车多久能到阿尔法玛	{这里=出发GPS, 火车=交通方式, 阿尔法玛=目的poi名称}	行程属性
从本地地铁多久能到景福宫	{景福宫=目的poi名称, 本地=出发GPS, 地铁=交通方式}	行程属性
从本地飞机多久能到阿尔法玛	{本地=出发GPS, 阿尔法玛=目的poi名称, 飞机=交通方式}	行程属性
从本地大巴车多久能到猴庙	{大巴车=交通方式, 本地=出发GPS, 猴庙=目的poi名称}	行程属性
从这儿大巴车多久能到马穆提岛	{大巴车=交通方式, 这儿=出发GPS, 马穆提岛=目的poi名称}	行程属性
从本地大巴车多久能到维多利亚港	{大巴车=交通方式, 维多利亚港=目的poi名称, 本地=出发GPS}	行程属性
从这儿大巴车多久能到维港	{大巴车=交通方式, 维港=目的poi名称, 这儿=出发GPS}	行程属性
从这里飞机多久能到鼓浪屿	{这里=出发GPS, 鼓浪屿=目的poi名称, 飞机=交通方式}	行程属性
从这里大巴车多久能到多瑙河	{这里=出发GPS, 大巴车=交通方式, 多瑙河=目的poi名称}	行程属性
从这里地铁多久能到芬兰堡	{这里=出发GPS, 芬兰堡=目的poi名称, 地铁=交通方式}	行程属性
从本地地铁多久能到卢浮宫	{本地=出发GPS, 卢浮宫=目的poi名称, 地铁=交通方式}	行程属性
从这儿大巴车多久能到鼓浪屿	{大巴车=交通方式, 这儿=出发GPS, 鼓浪屿=目的poi名称}	行程属性
从这里飞机多久能到阿尔法玛	{这里=出发GPS, 阿尔法玛=目的poi名称, 飞机=交通方式}	行程属性
从这里大巴车多久能到密歇根湖	{这里=出发GPS, 大巴车=交通方式, 密歇根湖=目的poi名称}	行程属性
从这儿大巴车多久能到金阁寺	{大巴车=交通方式, 这儿=出发GPS, 金阁寺=目的poi名称}	行程属性
从这儿飞机多久能到迪士尼	{这儿=出发GPS, 迪士尼=目的poi名称, 飞机=交通方式}	行程属性
从本地飞机多久能到芬兰堡	{本地=出发GPS, 芬兰堡=目的poi名称, 飞机=交通方式}	行程属性
从这儿大巴车多久能到孚日宫	{大巴车=交通方式, 孚日宫=目的poi名称, 这儿=出发GPS}	行程属性
从本地地铁多久能到马穆提岛	{本地=出发GPS, 地铁=交通方式, 马穆提岛=目的poi名称}	行程属性
从这里地铁多久能到莱茵河	{莱茵河=目的poi名称, 这里=出发GPS, 地铁=交通方式}	行程属性
从这儿火车多久能到维港	{维港=目的poi名称, 火车=交通方式, 这儿=出发GPS}	行程属性
从这里大巴车多久能到猴庙	{这里=出发GPS, 大巴车=交通方式, 猴庙=目的poi名称}	行程属性
从这里大巴车多久能到迪士尼	{这里=出发GPS, 大巴车=交通方式, 迪士尼=目的poi名称}	行程属性
从这儿飞机多久能到孚日宫	{孚日宫=目的poi名称, 这儿=出发GPS, 飞机=交通方式}	行程属性
从这里火车多久能到光明寺	{这里=出发GPS, 火车=交通方式, 光明寺=目的poi名称}	行程属性
从这儿飞机多久能到密歇根湖	{这儿=出发GPS, 密歇根湖=目的poi名称, 飞机=交通方式}	行程属性
从这儿大巴车多久能到大夏宫	{大巴车=交通方式, 这儿=出发GPS, 大夏宫=目的poi名称}	行程属性
从这里火车多久能到大夏宫	{这里=出发GPS, 火车=交通方式, 大夏宫=目的poi名称}	行程属性
从本地火车多久能到九寨沟	{火车=交通方式, 九寨沟=目的poi名称, 本地=出发GPS}	行程属性
从这儿地铁多久能到九寨沟	{九寨沟=目的poi名称, 这儿=出发GPS, 地铁=交通方式}	行程属性
从这里大巴车多久能到鼓浪屿	{这里=出发GPS, 大巴车=交通方式, 鼓浪屿=目的poi名称}	行程属性
从本地大巴车多久能到鼓浪屿	{大巴车=交通方式, 本地=出发GPS, 鼓浪屿=目的poi名称}	行程属性
从这里大巴车多久能到托普卡帕宫	{这里=出发GPS, 大巴车=交通方式, 托普卡帕宫=目的poi名称}	行程属性
从本地飞机多久能到金阁寺	{本地=出发GPS, 飞机=交通方式, 金阁寺=目的poi名称}	行程属性
从这里飞机多久能到维港	{这里=出发GPS, 维港=目的poi名称, 飞机=交通方式}	行程属性
从这里地铁多久能到景福宫	{这里=出发GPS, 景福宫=目的poi名称, 地铁=交通方式}	行程属性
从这儿火车多久能到密歇根湖	{火车=交通方式, 这儿=出发GPS, 密歇根湖=目的poi名称}	行程属性
从本地地铁多久能到多瑙河	{本地=出发GPS, 多瑙河=目的poi名称, 地铁=交通方式}	行程属性
从本地火车多久能到猴庙	{火车=交通方式, 本地=出发GPS, 猴庙=目的poi名称}	行程属性
从这儿火车多久能到阿尔法玛	{火车=交通方式, 这儿=出发GPS, 阿尔法玛=目的poi名称}	行程属性
从这里大巴车多久能到九寨沟	{这里=出发GPS, 大巴车=交通方式, 九寨沟=目的poi名称}	行程属性
从这里飞机多久能到红树	{红树=目的poi名称, 这里=出发GPS, 飞机=交通方式}	行程属性
从这儿地铁多久能到荣军院	{这儿=出发GPS, 地铁=交通方式, 荣军院=目的poi名称}	行程属性
从本地大巴车多久能到阿尔法玛	{大巴车=交通方式, 本地=出发GPS, 阿尔法玛=目的poi名称}	行程属性
从本地飞机多久能到猴庙	{本地=出发GPS, 猴庙=目的poi名称, 飞机=交通方式}	行程属性
从本地大巴车多久能到维港	{大巴车=交通方式, 维港=目的poi名称, 本地=出发GPS}	行程属性
从这儿大巴车多久能到新加坡河	{大巴车=交通方式, 这儿=出发GPS, 新加坡河=目的poi名称}	行程属性
从这里地铁多久能到维港	{这里=出发GPS, 维港=目的poi名称, 地铁=交通方式}	行程属性
从本地大巴车多久能到荣军院	{大巴车=交通方式, 本地=出发GPS, 荣军院=目的poi名称}	行程属性
从本地飞机多久能到唐人街	{唐人街=目的poi名称, 本地=出发GPS, 飞机=交通方式}	行程属性
从本地地铁多久能到唐人街	{唐人街=目的poi名称, 本地=出发GPS, 地铁=交通方式}	行程属性
从本地大巴车多久能到多瑙河	{大巴车=交通方式, 本地=出发GPS, 多瑙河=目的poi名称}	行程属性
从这里火车多久能到白沙滩	{这里=出发GPS, 火车=交通方式, 白沙滩=目的poi名称}	行程属性
从本地火车多久能到孚日宫	{孚日宫=目的poi名称, 火车=交通方式, 本地=出发GPS}	行程属性
从本地地铁多久能到维港	{维港=目的poi名称, 本地=出发GPS, 地铁=交通方式}	行程属性
从这里地铁多久能到托普卡帕宫	{这里=出发GPS, 地铁=交通方式, 托普卡帕宫=目的poi名称}	行程属性
从这儿飞机多久能到芬兰堡	{这儿=出发GPS, 芬兰堡=目的poi名称, 飞机=交通方式}	行程属性
从这儿火车多久能到多瑙河	{火车=交通方式, 这儿=出发GPS, 多瑙河=目的poi名称}	行程属性
从这儿火车多久能到新加坡河	{火车=交通方式, 这儿=出发GPS, 新加坡河=目的poi名称}	行程属性
从这里大巴车多久能到白沙滩	{这里=出发GPS, 大巴车=交通方式, 白沙滩=目的poi名称}	行程属性
从本地地铁多久能到迪士尼	{本地=出发GPS, 地铁=交通方式, 迪士尼=目的poi名称}	行程属性
从本地地铁多久能到路易港	{本地=出发GPS, 地铁=交通方式, 路易港=目的poi名称}	行程属性
从这里地铁多久能到卢浮宫	{这里=出发GPS, 卢浮宫=目的poi名称, 地铁=交通方式}	行程属性
从这儿火车多久能到卢浮宫	{火车=交通方式, 这儿=出发GPS, 卢浮宫=目的poi名称}	行程属性
从这里大巴车多久能到玛黑区	{玛黑区=目的poi名称, 这里=出发GPS, 大巴车=交通方式}	行程属性
从本地火车多久能到维多利亚港	{火车=交通方式, 维多利亚港=目的poi名称, 本地=出发GPS}	行程属性
从本地飞机多久能到玛黑区	{玛黑区=目的poi名称, 本地=出发GPS, 飞机=交通方式}	行程属性
从本地火车多久能到马穆提岛	{火车=交通方式, 本地=出发GPS, 马穆提岛=目的poi名称}	行程属性
从这里大巴车多久能到莱茵河	{莱茵河=目的poi名称, 这里=出发GPS, 大巴车=交通方式}	行程属性
从这里大巴车多久能到孚日宫	{这里=出发GPS, 大巴车=交通方式, 孚日宫=目的poi名称}	行程属性
从这里大巴车多久能到大夏宫	{这里=出发GPS, 大巴车=交通方式, 大夏宫=目的poi名称}	行程属性
从这儿大巴车多久能到全聚德	{大巴车=交通方式, 全聚德=目的poi名称, 这儿=出发GPS}	行程属性
从这里飞机多久能到迪斯尼	{这里=出发GPS, 飞机=交通方式, 迪斯尼=目的poi名称}	行程属性
从这儿大巴车多久能到唐人街	{大巴车=交通方式, 唐人街=目的poi名称, 这儿=出发GPS}	行程属性
从本地大巴车多久能到景福宫	{大巴车=交通方式, 景福宫=目的poi名称, 本地=出发GPS}	行程属性
从这里地铁多久能到日月潭	{日月潭=目的poi名称, 这里=出发GPS, 地铁=交通方式}	行程属性
从这儿飞机多久能到鼓浪屿	{这儿=出发GPS, 鼓浪屿=目的poi名称, 飞机=交通方式}	行程属性
从这里飞机用多长时间到荣军院	{这里=出发GPS, 荣军院=目的poi名称, 飞机=交通方式}	行程属性
从本地飞机用多长时间到全聚德	{全聚德=目的poi名称, 本地=出发GPS, 飞机=交通方式}	行程属性
从本地火车用多长时间到红树	{红树=目的poi名称, 火车=交通方式, 本地=出发GPS}	行程属性
从这儿飞机用多长时间到九寨沟	{九寨沟=目的poi名称, 这儿=出发GPS, 飞机=交通方式}	行程属性
从这儿火车用多长时间到托普卡帕宫	{火车=交通方式, 这儿=出发GPS, 托普卡帕宫=目的poi名称}	行程属性
从这里大巴车用多长时间到马穆提岛	{这里=出发GPS, 大巴车=交通方式, 马穆提岛=目的poi名称}	行程属性
从本地火车用多长时间到新加坡河	{火车=交通方式, 本地=出发GPS, 新加坡河=目的poi名称}	行程属性
从这里火车用多长时间到迪斯尼	{这里=出发GPS, 火车=交通方式, 迪斯尼=目的poi名称}	行程属性
从这里飞机用多长时间到凯旋门	{这里=出发GPS, 凯旋门=目的poi名称, 飞机=交通方式}	行程属性
从这里火车用多长时间到维港	{这里=出发GPS, 维港=目的poi名称, 火车=交通方式}	行程属性
从这儿火车用多长时间到光明寺	{火车=交通方式, 这儿=出发GPS, 光明寺=目的poi名称}	行程属性
从这里大巴车用多长时间到阿尔法玛	{这里=出发GPS, 大巴车=交通方式, 阿尔法玛=目的poi名称}	行程属性
从本地飞机用多长时间到金阁寺	{本地=出发GPS, 飞机=交通方式, 金阁寺=目的poi名称}	行程属性
从这儿飞机用多长时间到全聚德	{全聚德=目的poi名称, 这儿=出发GPS, 飞机=交通方式}	行程属性
从这儿地铁用多长时间到迪士尼	{这儿=出发GPS, 地铁=交通方式, 迪士尼=目的poi名称}	行程属性
从本地大巴车用多长时间到荣军院	{大巴车=交通方式, 本地=出发GPS, 荣军院=目的poi名称}	行程属性
从本地飞机用多长时间到鼓浪屿	{本地=出发GPS, 鼓浪屿=目的poi名称, 飞机=交通方式}	行程属性
从这儿大巴车用多长时间到景福宫	{大巴车=交通方式, 景福宫=目的poi名称, 这儿=出发GPS}	行程属性
从这儿飞机用多长时间到鼓浪屿	{这儿=出发GPS, 鼓浪屿=目的poi名称, 飞机=交通方式}	行程属性
从这里火车用多长时间到芬兰堡	{这里=出发GPS, 火车=交通方式, 芬兰堡=目的poi名称}	行程属性
从这儿火车用多长时间到日月潭	{日月潭=目的poi名称, 火车=交通方式, 这儿=出发GPS}	行程属性
从这里地铁用多长时间到青莲院	{这里=出发GPS, 地铁=交通方式, 青莲院=目的poi名称}	行程属性
从这儿飞机用多长时间到卢浮宫	{这儿=出发GPS, 卢浮宫=目的poi名称, 飞机=交通方式}	行程属性
从这里火车用多长时间到玛黑区	{玛黑区=目的poi名称, 这里=出发GPS, 火车=交通方式}	行程属性
从这里大巴车用多长时间到光明寺	{这里=出发GPS, 大巴车=交通方式, 光明寺=目的poi名称}	行程属性
从这里大巴车用多长时间到凯旋门	{这里=出发GPS, 大巴车=交通方式, 凯旋门=目的poi名称}	行程属性
从本地大巴车用多长时间到大夏宫	{大巴车=交通方式, 本地=出发GPS, 大夏宫=目的poi名称}	行程属性
从这里火车用多长时间到马穆提岛	{这里=出发GPS, 火车=交通方式, 马穆提岛=目的poi名称}	行程属性
从本地地铁用多长时间到路易港	{本地=出发GPS, 地铁=交通方式, 路易港=目的poi名称}	行程属性
从这儿地铁用多长时间到维多利亚港	{这儿=出发GPS, 维多利亚港=目的poi名称, 地铁=交通方式}	行程属性
从这儿飞机用多长时间到多瑙河	{这儿=出发GPS, 多瑙河=目的poi名称, 飞机=交通方式}	行程属性
从这里火车用多长时间到景福宫	{这里=出发GPS, 景福宫=目的poi名称, 火车=交通方式}	行程属性
从这儿大巴车用多长时间到新加坡河	{大巴车=交通方式, 这儿=出发GPS, 新加坡河=目的poi名称}	行程属性
从本地火车用多长时间到阿尔法玛	{火车=交通方式, 本地=出发GPS, 阿尔法玛=目的poi名称}	行程属性
从这里大巴车用多长时间到迪斯尼	{这里=出发GPS, 大巴车=交通方式, 迪斯尼=目的poi名称}	行程属性
从本地大巴车用多长时间到日月潭	{日月潭=目的poi名称, 大巴车=交通方式, 本地=出发GPS}	行程属性
从这里火车用多长时间到光明寺	{这里=出发GPS, 火车=交通方式, 光明寺=目的poi名称}	行程属性
从本地火车用多长时间到芬兰堡	{火车=交通方式, 本地=出发GPS, 芬兰堡=目的poi名称}	行程属性
从这里地铁用多长时间到鼓浪屿	{这里=出发GPS, 地铁=交通方式, 鼓浪屿=目的poi名称}	行程属性
从这儿地铁用多长时间到孚日宫	{孚日宫=目的poi名称, 这儿=出发GPS, 地铁=交通方式}	行程属性
从本地火车用多长时间到猴庙	{火车=交通方式, 本地=出发GPS, 猴庙=目的poi名称}	行程属性
从这里飞机用多长时间到鼓浪屿	{这里=出发GPS, 鼓浪屿=目的poi名称, 飞机=交通方式}	行程属性
从本地飞机用多长时间到青莲院	{本地=出发GPS, 青莲院=目的poi名称, 飞机=交通方式}	行程属性
从本地火车用多长时间到托普卡帕宫	{火车=交通方式, 本地=出发GPS, 托普卡帕宫=目的poi名称}	行程属性
从本地飞机用多长时间到荣军院	{本地=出发GPS, 荣军院=目的poi名称, 飞机=交通方式}	行程属性
从本地飞机用多长时间到马穆提岛	{本地=出发GPS, 马穆提岛=目的poi名称, 飞机=交通方式}	行程属性
从这里大巴车用多长时间到全聚德	{这里=出发GPS, 大巴车=交通方式, 全聚德=目的poi名称}	行程属性
从本地飞机用多长时间到景福宫	{景福宫=目的poi名称, 本地=出发GPS, 飞机=交通方式}	行程属性
从本地火车用多长时间到玛黑区	{玛黑区=目的poi名称, 火车=交通方式, 本地=出发GPS}	行程属性
从这儿地铁用多长时间到日月潭	{日月潭=目的poi名称, 这儿=出发GPS, 地铁=交通方式}	行程属性
从本地火车用多长时间到密歇根湖	{火车=交通方式, 本地=出发GPS, 密歇根湖=目的poi名称}	行程属性
从本地大巴车用多长时间到维港	{大巴车=交通方式, 维港=目的poi名称, 本地=出发GPS}	行程属性
从本地大巴车用多长时间到迪斯尼	{大巴车=交通方式, 本地=出发GPS, 迪斯尼=目的poi名称}	行程属性
从这儿火车用多长时间到密歇根湖	{火车=交通方式, 这儿=出发GPS, 密歇根湖=目的poi名称}	行程属性
从本地地铁用多长时间到白沙滩	{白沙滩=目的poi名称, 本地=出发GPS, 地铁=交通方式}	行程属性
从这里地铁用多长时间到维多利亚港	{这里=出发GPS, 维多利亚港=目的poi名称, 地铁=交通方式}	行程属性
从本地飞机用多长时间到玛黑区	{玛黑区=目的poi名称, 本地=出发GPS, 飞机=交通方式}	行程属性
从这里大巴车用多长时间到九寨沟	{这里=出发GPS, 大巴车=交通方式, 九寨沟=目的poi名称}	行程属性
从这里火车用多长时间到迪士尼	{这里=出发GPS, 火车=交通方式, 迪士尼=目的poi名称}	行程属性
从这儿大巴车用多长时间到孚日宫	{大巴车=交通方式, 孚日宫=目的poi名称, 这儿=出发GPS}	行程属性
从本地飞机用多长时间到托普卡帕宫	{本地=出发GPS, 托普卡帕宫=目的poi名称, 飞机=交通方式}	行程属性
从这儿火车用多长时间到马穆提岛	{火车=交通方式, 这儿=出发GPS, 马穆提岛=目的poi名称}	行程属性
从这儿飞机用多长时间到青莲院	{这儿=出发GPS, 青莲院=目的poi名称, 飞机=交通方式}	行程属性
从本地火车用多长时间到大夏宫	{火车=交通方式, 本地=出发GPS, 大夏宫=目的poi名称}	行程属性
从本地地铁用多长时间到玛黑区	{玛黑区=目的poi名称, 本地=出发GPS, 地铁=交通方式}	行程属性
从这儿火车用多长时间到青莲院	{火车=交通方式, 这儿=出发GPS, 青莲院=目的poi名称}	行程属性
从本地飞机用多长时间到维港	{维港=目的poi名称, 本地=出发GPS, 飞机=交通方式}	行程属性
从这儿火车用多长时间到凯旋门	{火车=交通方式, 这儿=出发GPS, 凯旋门=目的poi名称}	行程属性
从这儿飞机用多长时间到密歇根湖	{这儿=出发GPS, 密歇根湖=目的poi名称, 飞机=交通方式}	行程属性
从本地火车用多长时间到凯旋门	{火车=交通方式, 本地=出发GPS, 凯旋门=目的poi名称}	行程属性
从本地大巴车用多长时间到九寨沟	{大巴车=交通方式, 九寨沟=目的poi名称, 本地=出发GPS}	行程属性
从本地大巴车用多长时间到红树	{红树=目的poi名称, 大巴车=交通方式, 本地=出发GPS}	行程属性
从这里飞机用多长时间到孚日宫	{这里=出发GPS, 孚日宫=目的poi名称, 飞机=交通方式}	行程属性
从本地大巴车用多长时间到多瑙河	{大巴车=交通方式, 本地=出发GPS, 多瑙河=目的poi名称}	行程属性
从这儿火车用多长时间到玛黑区	{玛黑区=目的poi名称, 火车=交通方式, 这儿=出发GPS}	行程属性
从这儿大巴车用多长时间到迪士尼	{大巴车=交通方式, 这儿=出发GPS, 迪士尼=目的poi名称}	行程属性
从本地地铁用多长时间到芬兰堡	{本地=出发GPS, 芬兰堡=目的poi名称, 地铁=交通方式}	行程属性
从这儿地铁用多长时间到卢浮宫	{这儿=出发GPS, 卢浮宫=目的poi名称, 地铁=交通方式}	行程属性
从这儿地铁用多长时间到大夏宫	{这儿=出发GPS, 地铁=交通方式, 大夏宫=目的poi名称}	行程属性
从本地大巴车用多长时间到路易港	{大巴车=交通方式, 本地=出发GPS, 路易港=目的poi名称}	行程属性
从这里地铁用多长时间到迪斯尼	{这里=出发GPS, 地铁=交通方式, 迪斯尼=目的poi名称}	行程属性
从这里火车用多长时间到全聚德	{这里=出发GPS, 全聚德=目的poi名称, 火车=交通方式}	行程属性
从本地飞机用多长时间到白沙滩	{白沙滩=目的poi名称, 本地=出发GPS, 飞机=交通方式}	行程属性
从这儿大巴车用多长时间到凯旋门	{大巴车=交通方式, 这儿=出发GPS, 凯旋门=目的poi名称}	行程属性
从这儿飞机用多长时间到红树	{红树=目的poi名称, 这儿=出发GPS, 飞机=交通方式}	行程属性
从这儿火车用多长时间到鼓浪屿	{火车=交通方式, 这儿=出发GPS, 鼓浪屿=目的poi名称}	行程属性
从这儿大巴车用多长时间到青莲院	{大巴车=交通方式, 这儿=出发GPS, 青莲院=目的poi名称}	行程属性
从这里火车用多长时间到路易港	{这里=出发GPS, 火车=交通方式, 路易港=目的poi名称}	行程属性
从这里大巴车用多长时间到玛黑区	{玛黑区=目的poi名称, 这里=出发GPS, 大巴车=交通方式}	行程属性
从这儿大巴车用多长时间到全聚德	{大巴车=交通方式, 全聚德=目的poi名称, 这儿=出发GPS}	行程属性
从本地飞机用多长时间到密歇根湖	{本地=出发GPS, 密歇根湖=目的poi名称, 飞机=交通方式}	行程属性
从这里飞机用多长时间到维多利亚港	{这里=出发GPS, 维多利亚港=目的poi名称, 飞机=交通方式}	行程属性
从本地地铁用多长时间到托普卡帕宫	{本地=出发GPS, 地铁=交通方式, 托普卡帕宫=目的poi名称}	行程属性
从本地地铁用多长时间到迪士尼	{本地=出发GPS, 地铁=交通方式, 迪士尼=目的poi名称}	行程属性
从本地大巴车用多长时间到莱茵河	{莱茵河=目的poi名称, 大巴车=交通方式, 本地=出发GPS}	行程属性
从这儿大巴车用多长时间到玛黑区	{玛黑区=目的poi名称, 大巴车=交通方式, 这儿=出发GPS}	行程属性
从本地火车用多长时间到孚日宫	{孚日宫=目的poi名称, 火车=交通方式, 本地=出发GPS}	行程属性
从这里火车用多长时间到维多利亚港	{这里=出发GPS, 火车=交通方式, 维多利亚港=目的poi名称}	行程属性
从本地火车用多长时间到全聚德	{全聚德=目的poi名称, 火车=交通方式, 本地=出发GPS}	行程属性
从本地地铁用多长时间到唐人街	{唐人街=目的poi名称, 本地=出发GPS, 地铁=交通方式}	行程属性
从唐人街到密歇根湖飞机需要多久	{唐人街=出发poi名称, 密歇根湖=目的poi名称, 飞机=交通方式}	行程属性
从维多利亚港到多瑙河飞机需要多久	{维多利亚港=出发poi名称, 多瑙河=目的poi名称, 飞机=交通方式}	行程属性
从景福宫到全聚德飞机需要多久	{景福宫=出发poi名称, 全聚德=目的poi名称, 飞机=交通方式}	行程属性
从白沙滩到路易港火车需要多久	{火车=交通方式, 白沙滩=出发poi名称, 路易港=目的poi名称}	行程属性
从维港到玛黑区地铁需要多久	{玛黑区=目的poi名称, 维港=出发poi名称, 地铁=交通方式}	行程属性
从九寨沟到托普卡帕宫大巴车需要多久	{大巴车=交通方式, 九寨沟=出发poi名称, 托普卡帕宫=目的poi名称}	行程属性
从芬兰堡到红树飞机需要多久	{红树=目的poi名称, 芬兰堡=出发poi名称, 飞机=交通方式}	行程属性
从莱茵河到红树飞机需要多久	{红树=目的poi名称, 莱茵河=出发poi名称, 飞机=交通方式}	行程属性
从马穆提岛到光明寺地铁需要多久	{光明寺=目的poi名称, 地铁=交通方式, 马穆提岛=出发poi名称}	行程属性
从芬兰堡到托普卡帕宫火车需要多久	{火车=交通方式, 芬兰堡=出发poi名称, 托普卡帕宫=目的poi名称}	行程属性
从芬兰堡到鼓浪屿火车需要多久	{火车=交通方式, 芬兰堡=出发poi名称, 鼓浪屿=目的poi名称}	行程属性
从卢浮宫到光明寺火车需要多久	{火车=交通方式, 光明寺=目的poi名称, 卢浮宫=出发poi名称}	行程属性
从凯旋门到九寨沟地铁需要多久	{九寨沟=目的poi名称, 地铁=交通方式, 凯旋门=出发poi名称}	行程属性
从玛黑区到九寨沟地铁需要多久	{玛黑区=出发poi名称, 九寨沟=目的poi名称, 地铁=交通方式}	行程属性
从托普卡帕宫到鼓浪屿火车需要多久	{火车=交通方式, 鼓浪屿=目的poi名称, 托普卡帕宫=出发poi名称}	行程属性
从大夏宫到猴庙大巴车需要多久	{大巴车=交通方式, 大夏宫=出发poi名称, 猴庙=目的poi名称}	行程属性
从马穆提岛到青莲院火车需要多久	{火车=交通方式, 青莲院=目的poi名称, 马穆提岛=出发poi名称}	行程属性
从青莲院到多瑙河飞机需要多久	{多瑙河=目的poi名称, 青莲院=出发poi名称, 飞机=交通方式}	行程属性
从荣军院到孚日宫飞机需要多久	{孚日宫=目的poi名称, 荣军院=出发poi名称, 飞机=交通方式}	行程属性
从维多利亚港到维港飞机需要多久	{维港=目的poi名称, 维多利亚港=出发poi名称, 飞机=交通方式}	行程属性
从卢浮宫到维港火车需要多久	{维港=目的poi名称, 火车=交通方式, 卢浮宫=出发poi名称}	行程属性
从玛黑区到孚日宫地铁需要多久	{玛黑区=出发poi名称, 孚日宫=目的poi名称, 地铁=交通方式}	行程属性
从阿尔法玛到迪士尼火车需要多久	{火车=交通方式, 阿尔法玛=出发poi名称, 迪士尼=目的poi名称}	行程属性
从迪斯尼到红树大巴车需要多久	{红树=目的poi名称, 大巴车=交通方式, 迪斯尼=出发poi名称}	行程属性
从维多利亚港到芬兰堡飞机需要多久	{维多利亚港=出发poi名称, 芬兰堡=目的poi名称, 飞机=交通方式}	行程属性
从日月潭到光明寺大巴车需要多久	{日月潭=出发poi名称, 大巴车=交通方式, 光明寺=目的poi名称}	行程属性
从唐人街到莱茵河大巴车需要多久	{莱茵河=目的poi名称, 大巴车=交通方式, 唐人街=出发poi名称}	行程属性
从光明寺到马穆提岛大巴车需要多久	{大巴车=交通方式, 光明寺=出发poi名称, 马穆提岛=目的poi名称}	行程属性
从多瑙河到莱茵河火车需要多久	{莱茵河=目的poi名称, 火车=交通方式, 多瑙河=出发poi名称}	行程属性
从新加坡河到全聚德飞机需要多久	{全聚德=目的poi名称, 新加坡河=出发poi名称, 飞机=交通方式}	行程属性
从路易港到维多利亚港火车需要多久	{火车=交通方式, 维多利亚港=目的poi名称, 路易港=出发poi名称}	行程属性
从迪士尼到猴庙地铁需要多久	{地铁=交通方式, 猴庙=目的poi名称, 迪士尼=出发poi名称}	行程属性
从莱茵河到鼓浪屿地铁需要多久	{莱茵河=出发poi名称, 鼓浪屿=目的poi名称, 地铁=交通方式}	行程属性
从光明寺到维多利亚港大巴车需要多久	{大巴车=交通方式, 维多利亚港=目的poi名称, 光明寺=出发poi名称}	行程属性
从阿尔法玛到莱茵河大巴车需要多久	{莱茵河=目的poi名称, 大巴车=交通方式, 阿尔法玛=出发poi名称}	行程属性
从红树到新加坡河大巴车需要多久	{红树=出发poi名称, 大巴车=交通方式, 新加坡河=目的poi名称}	行程属性
从芬兰堡到鼓浪屿地铁需要多久	{芬兰堡=出发poi名称, 鼓浪屿=目的poi名称, 地铁=交通方式}	行程属性
从新加坡河到青莲院大巴车需要多久	{大巴车=交通方式, 新加坡河=出发poi名称, 青莲院=目的poi名称}	行程属性
从白沙滩到迪士尼地铁需要多久	{白沙滩=出发poi名称, 地铁=交通方式, 迪士尼=目的poi名称}	行程属性
从日月潭到红树地铁需要多久	{红树=目的poi名称, 日月潭=出发poi名称, 地铁=交通方式}	行程属性
从莱茵河到迪士尼大巴车需要多久	{莱茵河=出发poi名称, 大巴车=交通方式, 迪士尼=目的poi名称}	行程属性
从九寨沟到托普卡帕宫飞机需要多久	{九寨沟=出发poi名称, 托普卡帕宫=目的poi名称, 飞机=交通方式}	行程属性
从阿尔法玛到鼓浪屿大巴车需要多久	{大巴车=交通方式, 阿尔法玛=出发poi名称, 鼓浪屿=目的poi名称}	行程属性
从景福宫到白沙滩火车需要多久	{景福宫=出发poi名称, 火车=交通方式, 白沙滩=目的poi名称}	行程属性
从金阁寺到红树地铁需要多久	{红树=目的poi名称, 地铁=交通方式, 金阁寺=出发poi名称}	行程属性
从凯旋门到猴庙大巴车需要多久	{大巴车=交通方式, 猴庙=目的poi名称, 凯旋门=出发poi名称}	行程属性
从密歇根湖到卢浮宫飞机需要多久	{密歇根湖=出发poi名称, 卢浮宫=目的poi名称, 飞机=交通方式}	行程属性
从托普卡帕宫到九寨沟地铁需要多久	{九寨沟=目的poi名称, 地铁=交通方式, 托普卡帕宫=出发poi名称}	行程属性
从猴庙到鼓浪屿大巴车需要多久	{大巴车=交通方式, 鼓浪屿=目的poi名称, 猴庙=出发poi名称}	行程属性
从景福宫到唐人街地铁需要多久	{景福宫=出发poi名称, 唐人街=目的poi名称, 地铁=交通方式}	行程属性
从迪斯尼到新加坡河火车需要多久	{火车=交通方式, 新加坡河=目的poi名称, 迪斯尼=出发poi名称}	行程属性
从维港到大夏宫火车需要多久	{维港=出发poi名称, 火车=交通方式, 大夏宫=目的poi名称}	行程属性
从卢浮宫到维多利亚港大巴车需要多久	{大巴车=交通方式, 维多利亚港=目的poi名称, 卢浮宫=出发poi名称}	行程属性
从唐人街到莱茵河飞机需要多久	{莱茵河=目的poi名称, 唐人街=出发poi名称, 飞机=交通方式}	行程属性
从光明寺到景福宫大巴车需要多久	{大巴车=交通方式, 景福宫=目的poi名称, 光明寺=出发poi名称}	行程属性
从密歇根湖到鼓浪屿飞机需要多久	{密歇根湖=出发poi名称, 鼓浪屿=目的poi名称, 飞机=交通方式}	行程属性
从全聚德到迪士尼地铁需要多久	{全聚德=出发poi名称, 地铁=交通方式, 迪士尼=目的poi名称}	行程属性
从迪士尼到维多利亚港飞机需要多久	{维多利亚港=目的poi名称, 迪士尼=出发poi名称, 飞机=交通方式}	行程属性
从多瑙河到金阁寺火车需要多久	{火车=交通方式, 多瑙河=出发poi名称, 金阁寺=目的poi名称}	行程属性
从红树到马穆提岛地铁需要多久	{红树=出发poi名称, 地铁=交通方式, 马穆提岛=目的poi名称}	行程属性
从日月潭到猴庙火车需要多久	{日月潭=出发poi名称, 火车=交通方式, 猴庙=目的poi名称}	行程属性
从鼓浪屿到凯旋门大巴车需要多久	{大巴车=交通方式, 鼓浪屿=出发poi名称, 凯旋门=目的poi名称}	行程属性
从全聚德到红树飞机需要多久	{红树=目的poi名称, 全聚德=出发poi名称, 飞机=交通方式}	行程属性
从玛黑区到猴庙火车需要多久	{玛黑区=出发poi名称, 火车=交通方式, 猴庙=目的poi名称}	行程属性
从日月潭到全聚德飞机需要多久	{日月潭=出发poi名称, 全聚德=目的poi名称, 飞机=交通方式}	行程属性
从全聚德到红树大巴车需要多久	{红树=目的poi名称, 大巴车=交通方式, 全聚德=出发poi名称}	行程属性
从日月潭到白沙滩大巴车需要多久	{日月潭=出发poi名称, 大巴车=交通方式, 白沙滩=目的poi名称}	行程属性
从玛黑区到白沙滩大巴车需要多久	{玛黑区=出发poi名称, 大巴车=交通方式, 白沙滩=目的poi名称}	行程属性
从九寨沟到凯旋门大巴车需要多久	{大巴车=交通方式, 九寨沟=出发poi名称, 凯旋门=目的poi名称}	行程属性
从玛黑区到路易港地铁需要多久	{玛黑区=出发poi名称, 路易港=目的poi名称, 地铁=交通方式}	行程属性
从大夏宫到红树火车需要多久	{红树=目的poi名称, 火车=交通方式, 大夏宫=出发poi名称}	行程属性
从迪斯尼到全聚德飞机需要多久	{全聚德=目的poi名称, 飞机=交通方式, 迪斯尼=出发poi名称}	行程属性
从白沙滩到景福宫火车需要多久	{景福宫=目的poi名称, 火车=交通方式, 白沙滩=出发poi名称}	行程属性
从维港到白沙滩大巴车需要多久	{大巴车=交通方式, 维港=出发poi名称, 白沙滩=目的poi名称}	行程属性
从新加坡河到多瑙河飞机需要多久	{新加坡河=出发poi名称, 多瑙河=目的poi名称, 飞机=交通方式}	行程属性
从鼓浪屿到唐人街飞机需要多久	{唐人街=目的poi名称, 鼓浪屿=出发poi名称, 飞机=交通方式}	行程属性
从孚日宫到景福宫大巴车需要多久	{孚日宫=出发poi名称, 大巴车=交通方式, 景福宫=目的poi名称}	行程属性
从日月潭到全聚德火车需要多久	{日月潭=出发poi名称, 全聚德=目的poi名称, 火车=交通方式}	行程属性
从白沙滩到马穆提岛大巴车需要多久	{大巴车=交通方式, 白沙滩=出发poi名称, 马穆提岛=目的poi名称}	行程属性
从日月潭到大夏宫地铁需要多久	{日月潭=出发poi名称, 大夏宫=目的poi名称, 地铁=交通方式}	行程属性
从孚日宫到景福宫飞机需要多久	{孚日宫=出发poi名称, 景福宫=目的poi名称, 飞机=交通方式}	行程属性
从迪斯尼到白沙滩地铁需要多久	{白沙滩=目的poi名称, 地铁=交通方式, 迪斯尼=出发poi名称}	行程属性
从猴庙到九寨沟火车需要多久	{九寨沟=目的poi名称, 火车=交通方式, 猴庙=出发poi名称}	行程属性
从马穆提岛到鼓浪屿大巴车需要多久	{大巴车=交通方式, 鼓浪屿=目的poi名称, 马穆提岛=出发poi名称}	行程属性
从青莲院到路易港火车需要多久	{火车=交通方式, 青莲院=出发poi名称, 路易港=目的poi名称}	行程属性
从孚日宫到托普卡帕宫火车需要多久	{孚日宫=出发poi名称, 火车=交通方式, 托普卡帕宫=目的poi名称}	行程属性
从密歇根湖到猴庙地铁需要多久	{密歇根湖=出发poi名称, 地铁=交通方式, 猴庙=目的poi名称}	行程属性
从猴庙到芬兰堡飞机需要多久	{芬兰堡=目的poi名称, 猴庙=出发poi名称, 飞机=交通方式}	行程属性
从日月潭到新加坡河地铁需要多久	{日月潭=出发poi名称, 新加坡河=目的poi名称, 地铁=交通方式}	行程属性
从红树到青莲院大巴车需要多久	{红树=出发poi名称, 大巴车=交通方式, 青莲院=目的poi名称}	行程属性
从唐人街到马穆提岛大巴车需要多久	{大巴车=交通方式, 唐人街=出发poi名称, 马穆提岛=目的poi名称}	行程属性
从莱茵河到多瑙河火车需要多久	{莱茵河=出发poi名称, 火车=交通方式, 多瑙河=目的poi名称}	行程属性
从白沙滩到卢浮宫火车需要多久	{火车=交通方式, 白沙滩=出发poi名称, 卢浮宫=目的poi名称}	行程属性
从青莲院到维港大巴车需要多久	{大巴车=交通方式, 维港=目的poi名称, 青莲院=出发poi名称}	行程属性
从红树到卢浮宫地铁需要多久	{红树=出发poi名称, 卢浮宫=目的poi名称, 地铁=交通方式}	行程属性
从玛黑区到迪士尼大巴车需要多久	{玛黑区=出发poi名称, 大巴车=交通方式, 迪士尼=目的poi名称}	行程属性
从新加坡河到荣军院地铁需要多久	{新加坡河=出发poi名称, 地铁=交通方式, 荣军院=目的poi名称}	行程属性
从日月潭到迪斯尼火车需要多久	{日月潭=出发poi名称, 火车=交通方式, 迪斯尼=目的poi名称}	行程属性
从密歇根湖到新加坡河飞机需要多久	{新加坡河=目的poi名称, 密歇根湖=出发poi名称, 飞机=交通方式}	行程属性
从迪士尼到密歇根湖大巴车需要多久	{大巴车=交通方式, 密歇根湖=目的poi名称, 迪士尼=出发poi名称}	行程属性
从芬兰堡飞机大概需要多久能到红树	{红树=目的poi名称, 芬兰堡=出发poi名称, 飞机=交通方式}	行程属性
从迪士尼大巴车大概需要多久能到光明寺	{大巴车=交通方式, 光明寺=目的poi名称, 迪士尼=出发poi名称}	行程属性
从青莲院地铁大概需要多久能到芬兰堡	{芬兰堡=目的poi名称, 青莲院=出发poi名称, 地铁=交通方式}	行程属性
从维港火车大概需要多久能到唐人街	{维港=出发poi名称, 唐人街=目的poi名称, 火车=交通方式}	行程属性
从白沙滩地铁大概需要多久能到密歇根湖	{白沙滩=出发poi名称, 密歇根湖=目的poi名称, 地铁=交通方式}	行程属性
从维多利亚港火车大概需要多久能到凯旋门	{火车=交通方式, 维多利亚港=出发poi名称, 凯旋门=目的poi名称}	行程属性
从白沙滩大巴车大概需要多久能到维港	{大巴车=交通方式, 维港=目的poi名称, 白沙滩=出发poi名称}	行程属性
从迪斯尼飞机大概需要多久能到莱茵河	{莱茵河=目的poi名称, 飞机=交通方式, 迪斯尼=出发poi名称}	行程属性
从荣军院飞机大概需要多久能到光明寺	{光明寺=目的poi名称, 荣军院=出发poi名称, 飞机=交通方式}	行程属性
从新加坡河地铁大概需要多久能到大夏宫	{新加坡河=出发poi名称, 大夏宫=目的poi名称, 地铁=交通方式}	行程属性
从莱茵河大巴车大概需要多久能到马穆提岛	{莱茵河=出发poi名称, 大巴车=交通方式, 马穆提岛=目的poi名称}	行程属性
从金阁寺飞机大概需要多久能到九寨沟	{九寨沟=目的poi名称, 飞机=交通方式, 金阁寺=出发poi名称}	行程属性
从全聚德地铁大概需要多久能到迪斯尼	{全聚德=出发poi名称, 地铁=交通方式, 迪斯尼=目的poi名称}	行程属性
从维港大巴车大概需要多久能到迪斯尼	{大巴车=交通方式, 维港=出发poi名称, 迪斯尼=目的poi名称}	行程属性
从红树大巴车大概需要多久能到唐人街	{红树=出发poi名称, 大巴车=交通方式, 唐人街=目的poi名称}	行程属性
从白沙滩大巴车大概需要多久能到荣军院	{大巴车=交通方式, 白沙滩=出发poi名称, 荣军院=目的poi名称}	行程属性
从阿尔法玛地铁大概需要多久能到新加坡河	{阿尔法玛=出发poi名称, 新加坡河=目的poi名称, 地铁=交通方式}	行程属性
从多瑙河火车大概需要多久能到鼓浪屿	{火车=交通方式, 多瑙河=出发poi名称, 鼓浪屿=目的poi名称}	行程属性
从凯旋门飞机大概需要多久能到青莲院	{青莲院=目的poi名称, 凯旋门=出发poi名称, 飞机=交通方式}	行程属性
从芬兰堡大巴车大概需要多久能到日月潭	{日月潭=目的poi名称, 大巴车=交通方式, 芬兰堡=出发poi名称}	行程属性
从景福宫地铁大概需要多久能到日月潭	{日月潭=目的poi名称, 景福宫=出发poi名称, 地铁=交通方式}	行程属性
从芬兰堡大巴车大概需要多久能到莱茵河	{莱茵河=目的poi名称, 大巴车=交通方式, 芬兰堡=出发poi名称}	行程属性
从维港火车大概需要多久能到托普卡帕宫	{维港=出发poi名称, 火车=交通方式, 托普卡帕宫=目的poi名称}	行程属性
从凯旋门大巴车大概需要多久能到光明寺	{大巴车=交通方式, 光明寺=目的poi名称, 凯旋门=出发poi名称}	行程属性
从红树大巴车大概需要多久能到迪斯尼	{红树=出发poi名称, 大巴车=交通方式, 迪斯尼=目的poi名称}	行程属性
从新加坡河地铁大概需要多久能到托普卡帕宫	{新加坡河=出发poi名称, 地铁=交通方式, 托普卡帕宫=目的poi名称}	行程属性
从凯旋门飞机大概需要多久能到密歇根湖	{密歇根湖=目的poi名称, 凯旋门=出发poi名称, 飞机=交通方式}	行程属性
从孚日宫火车大概需要多久能到日月潭	{日月潭=目的poi名称, 孚日宫=出发poi名称, 火车=交通方式}	行程属性
从青莲院大巴车大概需要多久能到密歇根湖	{大巴车=交通方式, 密歇根湖=目的poi名称, 青莲院=出发poi名称}	行程属性
从新加坡河飞机大概需要多久能到光明寺	{新加坡河=出发poi名称, 光明寺=目的poi名称, 飞机=交通方式}	行程属性
从景福宫飞机大概需要多久能到猴庙	{景福宫=出发poi名称, 猴庙=目的poi名称, 飞机=交通方式}	行程属性
从孚日宫地铁大概需要多久能到金阁寺	{孚日宫=出发poi名称, 地铁=交通方式, 金阁寺=目的poi名称}	行程属性
从全聚德火车大概需要多久能到马穆提岛	{全聚德=出发poi名称, 火车=交通方式, 马穆提岛=目的poi名称}	行程属性
从新加坡河大巴车大概需要多久能到凯旋门	{大巴车=交通方式, 新加坡河=出发poi名称, 凯旋门=目的poi名称}	行程属性
从维多利亚港飞机大概需要多久能到迪斯尼	{维多利亚港=出发poi名称, 飞机=交通方式, 迪斯尼=目的poi名称}	行程属性
从多瑙河地铁大概需要多久能到青莲院	{多瑙河=出发poi名称, 青莲院=目的poi名称, 地铁=交通方式}	行程属性
从日月潭飞机大概需要多久能到凯旋门	{日月潭=出发poi名称, 凯旋门=目的poi名称, 飞机=交通方式}	行程属性
从托普卡帕宫飞机大概需要多久能到荣军院	{托普卡帕宫=出发poi名称, 荣军院=目的poi名称, 飞机=交通方式}	行程属性
从迪士尼地铁大概需要多久能到大夏宫	{大夏宫=目的poi名称, 地铁=交通方式, 迪士尼=出发poi名称}	行程属性
从红树大巴车大概需要多久能到多瑙河	{红树=出发poi名称, 大巴车=交通方式, 多瑙河=目的poi名称}	行程属性
从维港火车大概需要多久能到玛黑区	{玛黑区=目的poi名称, 维港=出发poi名称, 火车=交通方式}	行程属性
从猴庙地铁大概需要多久能到阿尔法玛	{阿尔法玛=目的poi名称, 地铁=交通方式, 猴庙=出发poi名称}	行程属性
从鼓浪屿地铁大概需要多久能到玛黑区	{玛黑区=目的poi名称, 鼓浪屿=出发poi名称, 地铁=交通方式}	行程属性
从白沙滩火车大概需要多久能到路易港	{火车=交通方式, 白沙滩=出发poi名称, 路易港=目的poi名称}	行程属性
从日月潭火车大概需要多久能到芬兰堡	{日月潭=出发poi名称, 火车=交通方式, 芬兰堡=目的poi名称}	行程属性
从青莲院地铁大概需要多久能到红树	{红树=目的poi名称, 青莲院=出发poi名称, 地铁=交通方式}	行程属性
从多瑙河火车大概需要多久能到猴庙	{火车=交通方式, 多瑙河=出发poi名称, 猴庙=目的poi名称}	行程属性
从孚日宫大巴车大概需要多久能到新加坡河	{孚日宫=出发poi名称, 大巴车=交通方式, 新加坡河=目的poi名称}	行程属性
从全聚德飞机大概需要多久能到景福宫	{全聚德=出发poi名称, 景福宫=目的poi名称, 飞机=交通方式}	行程属性
从芬兰堡飞机大概需要多久能到密歇根湖	{芬兰堡=出发poi名称, 密歇根湖=目的poi名称, 飞机=交通方式}	行程属性
从全聚德火车大概需要多久能到猴庙	{全聚德=出发poi名称, 火车=交通方式, 猴庙=目的poi名称}	行程属性
从路易港火车大概需要多久能到维多利亚港	{火车=交通方式, 维多利亚港=目的poi名称, 路易港=出发poi名称}	行程属性
从青莲院火车大概需要多久能到日月潭	{日月潭=目的poi名称, 火车=交通方式, 青莲院=出发poi名称}	行程属性
从金阁寺火车大概需要多久能到荣军院	{火车=交通方式, 荣军院=目的poi名称, 金阁寺=出发poi名称}	行程属性
从新加坡河地铁大概需要多久能到唐人街	{唐人街=目的poi名称, 新加坡河=出发poi名称, 地铁=交通方式}	行程属性
从青莲院火车大概需要多久能到卢浮宫	{火车=交通方式, 卢浮宫=目的poi名称, 青莲院=出发poi名称}	行程属性
从维港火车大概需要多久能到白沙滩	{维港=出发poi名称, 火车=交通方式, 白沙滩=目的poi名称}	行程属性
从马穆提岛大巴车大概需要多久能到白沙滩	{大巴车=交通方式, 白沙滩=目的poi名称, 马穆提岛=出发poi名称}	行程属性
从红树地铁大概需要多久能到光明寺	{红树=出发poi名称, 光明寺=目的poi名称, 地铁=交通方式}	行程属性
从玛黑区大巴车大概需要多久能到马穆提岛	{玛黑区=出发poi名称, 大巴车=交通方式, 马穆提岛=目的poi名称}	行程属性
从大夏宫大巴车大概需要多久能到莱茵河	{莱茵河=目的poi名称, 大巴车=交通方式, 大夏宫=出发poi名称}	行程属性
从阿尔法玛大巴车大概需要多久能到新加坡河	{大巴车=交通方式, 阿尔法玛=出发poi名称, 新加坡河=目的poi名称}	行程属性
从迪斯尼飞机大概需要多久能到玛黑区	{玛黑区=目的poi名称, 飞机=交通方式, 迪斯尼=出发poi名称}	行程属性
从新加坡河地铁大概需要多久能到芬兰堡	{新加坡河=出发poi名称, 芬兰堡=目的poi名称, 地铁=交通方式}	行程属性
从玛黑区飞机大概需要多久能到光明寺	{玛黑区=出发poi名称, 光明寺=目的poi名称, 飞机=交通方式}	行程属性
从大夏宫大巴车大概需要多久能到鼓浪屿	{大巴车=交通方式, 大夏宫=出发poi名称, 鼓浪屿=目的poi名称}	行程属性
从迪士尼火车大概需要多久能到孚日宫	{孚日宫=目的poi名称, 火车=交通方式, 迪士尼=出发poi名称}	行程属性
从唐人街地铁大概需要多久能到新加坡河	{唐人街=出发poi名称, 新加坡河=目的poi名称, 地铁=交通方式}	行程属性
从红树火车大概需要多久能到光明寺	{红树=出发poi名称, 火车=交通方式, 光明寺=目的poi名称}	行程属性
从全聚德地铁大概需要多久能到密歇根湖	{全聚德=出发poi名称, 密歇根湖=目的poi名称, 地铁=交通方式}	行程属性
从红树大巴车大概需要多久能到维多利亚港	{红树=出发poi名称, 大巴车=交通方式, 维多利亚港=目的poi名称}	行程属性
从路易港地铁大概需要多久能到马穆提岛	{路易港=出发poi名称, 地铁=交通方式, 马穆提岛=目的poi名称}	行程属性
从日月潭地铁大概需要多久能到光明寺	{日月潭=出发poi名称, 光明寺=目的poi名称, 地铁=交通方式}	行程属性
从光明寺地铁大概需要多久能到荣军院	{光明寺=出发poi名称, 地铁=交通方式, 荣军院=目的poi名称}	行程属性
从光明寺地铁大概需要多久能到多瑙河	{光明寺=出发poi名称, 多瑙河=目的poi名称, 地铁=交通方式}	行程属性
从青莲院飞机大概需要多久能到红树	{红树=目的poi名称, 青莲院=出发poi名称, 飞机=交通方式}	行程属性
从维多利亚港飞机大概需要多久能到荣军院	{维多利亚港=出发poi名称, 荣军院=目的poi名称, 飞机=交通方式}	行程属性
从青莲院大巴车大概需要多久能到白沙滩	{大巴车=交通方式, 白沙滩=目的poi名称, 青莲院=出发poi名称}	行程属性
从猴庙飞机大概需要多久能到光明寺	{光明寺=目的poi名称, 猴庙=出发poi名称, 飞机=交通方式}	行程属性
从日月潭大巴车大概需要多久能到九寨沟	{日月潭=出发poi名称, 大巴车=交通方式, 九寨沟=目的poi名称}	行程属性
从光明寺飞机大概需要多久能到大夏宫	{光明寺=出发poi名称, 大夏宫=目的poi名称, 飞机=交通方式}	行程属性
从马穆提岛大巴车大概需要多久能到金阁寺	{大巴车=交通方式, 马穆提岛=出发poi名称, 金阁寺=目的poi名称}	行程属性
从红树大巴车大概需要多久能到景福宫	{红树=出发poi名称, 大巴车=交通方式, 景福宫=目的poi名称}	行程属性
从托普卡帕宫火车大概需要多久能到多瑙河	{火车=交通方式, 多瑙河=目的poi名称, 托普卡帕宫=出发poi名称}	行程属性
从孚日宫飞机大概需要多久能到迪斯尼	{孚日宫=出发poi名称, 飞机=交通方式, 迪斯尼=目的poi名称}	行程属性
从密歇根湖飞机大概需要多久能到景福宫	{景福宫=目的poi名称, 密歇根湖=出发poi名称, 飞机=交通方式}	行程属性
从白沙滩地铁大概需要多久能到芬兰堡	{白沙滩=出发poi名称, 芬兰堡=目的poi名称, 地铁=交通方式}	行程属性
从日月潭大巴车大概需要多久能到迪斯尼	{日月潭=出发poi名称, 大巴车=交通方式, 迪斯尼=目的poi名称}	行程属性
从玛黑区飞机大概需要多久能到维多利亚港	{玛黑区=出发poi名称, 维多利亚港=目的poi名称, 飞机=交通方式}	行程属性
从九寨沟火车大概需要多久能到青莲院	{九寨沟=出发poi名称, 火车=交通方式, 青莲院=目的poi名称}	行程属性
从凯旋门大巴车大概需要多久能到金阁寺	{大巴车=交通方式, 凯旋门=出发poi名称, 金阁寺=目的poi名称}	行程属性
从青莲院地铁大概需要多久能到日月潭	{日月潭=目的poi名称, 青莲院=出发poi名称, 地铁=交通方式}	行程属性
从全聚德大巴车大概需要多久能到芬兰堡	{大巴车=交通方式, 全聚德=出发poi名称, 芬兰堡=目的poi名称}	行程属性
从金阁寺飞机大概需要多久能到路易港	{路易港=目的poi名称, 飞机=交通方式, 金阁寺=出发poi名称}	行程属性
从路易港飞机大概需要多久能到凯旋门	{路易港=出发poi名称, 凯旋门=目的poi名称, 飞机=交通方式}	行程属性
从日月潭火车大概需要多久能到马穆提岛	{日月潭=出发poi名称, 火车=交通方式, 马穆提岛=目的poi名称}	行程属性
从托普卡帕宫飞机大概需要多久能到凯旋门	{凯旋门=目的poi名称, 托普卡帕宫=出发poi名称, 飞机=交通方式}	行程属性
从新加坡河火车大概需要多久能到密歇根湖	{火车=交通方式, 新加坡河=出发poi名称, 密歇根湖=目的poi名称}	行程属性
从密歇根湖火车大概需要多久能到凯旋门	{火车=交通方式, 密歇根湖=出发poi名称, 凯旋门=目的poi名称}	行程属性
从青莲院火车大概需要多久能到光明寺	{火车=交通方式, 光明寺=目的poi名称, 青莲院=出发poi名称}	行程属性
从凯旋门到迪斯尼飞机大概要花多少时间	{凯旋门=出发poi名称, 飞机=交通方式, 迪斯尼=目的poi名称}	行程属性
从大夏宫到迪斯尼地铁大概要花多少时间	{大夏宫=出发poi名称, 地铁=交通方式, 迪斯尼=目的poi名称}	行程属性
从维多利亚港到孚日宫火车大概要花多少时间	{孚日宫=目的poi名称, 火车=交通方式, 维多利亚港=出发poi名称}	行程属性
从荣军院到凯旋门火车大概要花多少时间	{火车=交通方式, 凯旋门=目的poi名称, 荣军院=出发poi名称}	行程属性
从猴庙到光明寺火车大概要花多少时间	{火车=交通方式, 光明寺=目的poi名称, 猴庙=出发poi名称}	行程属性
从玛黑区到维多利亚港飞机大概要花多少时间	{玛黑区=出发poi名称, 维多利亚港=目的poi名称, 飞机=交通方式}	行程属性
从马穆提岛到迪士尼大巴车大概要花多少时间	{大巴车=交通方式, 马穆提岛=出发poi名称, 迪士尼=目的poi名称}	行程属性
从大夏宫到路易港大巴车大概要花多少时间	{大巴车=交通方式, 大夏宫=出发poi名称, 路易港=目的poi名称}	行程属性
从猴庙到红树大巴车大概要花多少时间	{红树=目的poi名称, 大巴车=交通方式, 猴庙=出发poi名称}	行程属性
从日月潭到多瑙河大巴车大概要花多少时间	{日月潭=出发poi名称, 大巴车=交通方式, 多瑙河=目的poi名称}	行程属性
从阿尔法玛到托普卡帕宫飞机大概要花多少时间	{阿尔法玛=出发poi名称, 托普卡帕宫=目的poi名称, 飞机=交通方式}	行程属性
从卢浮宫到马穆提岛地铁大概要花多少时间	{卢浮宫=出发poi名称, 地铁=交通方式, 马穆提岛=目的poi名称}	行程属性
从光明寺到莱茵河大巴车大概要花多少时间	{莱茵河=目的poi名称, 大巴车=交通方式, 光明寺=出发poi名称}	行程属性
从托普卡帕宫到孚日宫飞机大概要花多少时间	{孚日宫=目的poi名称, 托普卡帕宫=出发poi名称, 飞机=交通方式}	行程属性
从白沙滩到金阁寺飞机大概要花多少时间	{白沙滩=出发poi名称, 飞机=交通方式, 金阁寺=目的poi名称}	行程属性
从密歇根湖到多瑙河大巴车大概要花多少时间	{大巴车=交通方式, 多瑙河=目的poi名称, 密歇根湖=出发poi名称}	行程属性
从金阁寺到玛黑区火车大概要花多少时间	{玛黑区=目的poi名称, 火车=交通方式, 金阁寺=出发poi名称}	行程属性
从玛黑区到金阁寺地铁大概要花多少时间	{玛黑区=出发poi名称, 地铁=交通方式, 金阁寺=目的poi名称}	行程属性
从光明寺到日月潭大巴车大概要花多少时间	{日月潭=目的poi名称, 大巴车=交通方式, 光明寺=出发poi名称}	行程属性
从大夏宫到芬兰堡大巴车大概要花多少时间	{大巴车=交通方式, 芬兰堡=目的poi名称, 大夏宫=出发poi名称}	行程属性
从迪士尼到玛黑区飞机大概要花多少时间	{玛黑区=目的poi名称, 迪士尼=出发poi名称, 飞机=交通方式}	行程属性
从鼓浪屿到维多利亚港火车大概要花多少时间	{火车=交通方式, 维多利亚港=目的poi名称, 鼓浪屿=出发poi名称}	行程属性
从密歇根湖到玛黑区地铁大概要花多少时间	{玛黑区=目的poi名称, 密歇根湖=出发poi名称, 地铁=交通方式}	行程属性
从全聚德到芬兰堡大巴车大概要花多少时间	{大巴车=交通方式, 全聚德=出发poi名称, 芬兰堡=目的poi名称}	行程属性
从马穆提岛到路易港飞机大概要花多少时间	{路易港=目的poi名称, 马穆提岛=出发poi名称, 飞机=交通方式}	行程属性
从维多利亚港到维港火车大概要花多少时间	{维港=目的poi名称, 火车=交通方式, 维多利亚港=出发poi名称}	行程属性
从猴庙到孚日宫飞机大概要花多少时间	{孚日宫=目的poi名称, 猴庙=出发poi名称, 飞机=交通方式}	行程属性
从红树到多瑙河火车大概要花多少时间	{红树=出发poi名称, 火车=交通方式, 多瑙河=目的poi名称}	行程属性
从迪士尼到维多利亚港火车大概要花多少时间	{火车=交通方式, 维多利亚港=目的poi名称, 迪士尼=出发poi名称}	行程属性
从红树到维多利亚港大巴车大概要花多少时间	{红树=出发poi名称, 大巴车=交通方式, 维多利亚港=目的poi名称}	行程属性
从马穆提岛到托普卡帕宫飞机大概要花多少时间	{马穆提岛=出发poi名称, 托普卡帕宫=目的poi名称, 飞机=交通方式}	行程属性
从全聚德到青莲院飞机大概要花多少时间	{全聚德=出发poi名称, 青莲院=目的poi名称, 飞机=交通方式}	行程属性
从景福宫到多瑙河地铁大概要花多少时间	{景福宫=出发poi名称, 多瑙河=目的poi名称, 地铁=交通方式}	行程属性
从新加坡河到唐人街大巴车大概要花多少时间	{大巴车=交通方式, 唐人街=目的poi名称, 新加坡河=出发poi名称}	行程属性
从大夏宫到路易港飞机大概要花多少时间	{大夏宫=出发poi名称, 路易港=目的poi名称, 飞机=交通方式}	行程属性
从卢浮宫到新加坡河飞机大概要花多少时间	{新加坡河=目的poi名称, 卢浮宫=出发poi名称, 飞机=交通方式}	行程属性
从日月潭到迪士尼大巴车大概要花多少时间	{日月潭=出发poi名称, 大巴车=交通方式, 迪士尼=目的poi名称}	行程属性
从芬兰堡到托普卡帕宫大巴车大概要花多少时间	{大巴车=交通方式, 芬兰堡=出发poi名称, 托普卡帕宫=目的poi名称}	行程属性
从密歇根湖到大夏宫地铁大概要花多少时间	{密歇根湖=出发poi名称, 大夏宫=目的poi名称, 地铁=交通方式}	行程属性
从唐人街到玛黑区飞机大概要花多少时间	{玛黑区=目的poi名称, 唐人街=出发poi名称, 飞机=交通方式}	行程属性
从芬兰堡到红树飞机大概要花多少时间	{红树=目的poi名称, 芬兰堡=出发poi名称, 飞机=交通方式}	行程属性
从荣军院到鼓浪屿地铁大概要花多少时间	{鼓浪屿=目的poi名称, 地铁=交通方式, 荣军院=出发poi名称}	行程属性
从凯旋门到玛黑区地铁大概要花多少时间	{玛黑区=目的poi名称, 地铁=交通方式, 凯旋门=出发poi名称}	行程属性
从新加坡河到迪斯尼大巴车大概要花多少时间	{大巴车=交通方式, 新加坡河=出发poi名称, 迪斯尼=目的poi名称}	行程属性
从日月潭到鼓浪屿大巴车大概要花多少时间	{日月潭=出发poi名称, 大巴车=交通方式, 鼓浪屿=目的poi名称}	行程属性
从芬兰堡到荣军院地铁大概要花多少时间	{芬兰堡=出发poi名称, 地铁=交通方式, 荣军院=目的poi名称}	行程属性
从芬兰堡到荣军院火车大概要花多少时间	{火车=交通方式, 芬兰堡=出发poi名称, 荣军院=目的poi名称}	行程属性
从鼓浪屿到迪士尼地铁大概要花多少时间	{鼓浪屿=出发poi名称, 地铁=交通方式, 迪士尼=目的poi名称}	行程属性
从托普卡帕宫到九寨沟飞机大概要花多少时间	{九寨沟=目的poi名称, 托普卡帕宫=出发poi名称, 飞机=交通方式}	行程属性
从凯旋门到光明寺火车大概要花多少时间	{火车=交通方式, 光明寺=目的poi名称, 凯旋门=出发poi名称}	行程属性
从大夏宫到孚日宫火车大概要花多少时间	{孚日宫=目的poi名称, 火车=交通方式, 大夏宫=出发poi名称}	行程属性
从日月潭到景福宫地铁大概要花多少时间	{日月潭=出发poi名称, 景福宫=目的poi名称, 地铁=交通方式}	行程属性
从卢浮宫到迪斯尼飞机大概要花多少时间	{卢浮宫=出发poi名称, 飞机=交通方式, 迪斯尼=目的poi名称}	行程属性
从九寨沟到托普卡帕宫地铁大概要花多少时间	{九寨沟=出发poi名称, 地铁=交通方式, 托普卡帕宫=目的poi名称}	行程属性
从景福宫到玛黑区火车大概要花多少时间	{玛黑区=目的poi名称, 景福宫=出发poi名称, 火车=交通方式}	行程属性
从红树到猴庙地铁大概要花多少时间	{红树=出发poi名称, 地铁=交通方式, 猴庙=目的poi名称}	行程属性
从光明寺到路易港地铁大概要花多少时间	{光明寺=出发poi名称, 路易港=目的poi名称, 地铁=交通方式}	行程属性
从鼓浪屿到唐人街地铁大概要花多少时间	{唐人街=目的poi名称, 鼓浪屿=出发poi名称, 地铁=交通方式}	行程属性
从日月潭到红树飞机大概要花多少时间	{红树=目的poi名称, 日月潭=出发poi名称, 飞机=交通方式}	行程属性
从猴庙到九寨沟火车大概要花多少时间	{九寨沟=目的poi名称, 火车=交通方式, 猴庙=出发poi名称}	行程属性
从孚日宫到芬兰堡飞机大概要花多少时间	{孚日宫=出发poi名称, 芬兰堡=目的poi名称, 飞机=交通方式}	行程属性
从托普卡帕宫到新加坡河地铁大概要花多少时间	{新加坡河=目的poi名称, 地铁=交通方式, 托普卡帕宫=出发poi名称}	行程属性
从路易港到阿尔法玛火车大概要花多少时间	{火车=交通方式, 阿尔法玛=目的poi名称, 路易港=出发poi名称}	行程属性
从阿尔法玛到光明寺飞机大概要花多少时间	{阿尔法玛=出发poi名称, 光明寺=目的poi名称, 飞机=交通方式}	行程属性
从日月潭到芬兰堡火车大概要花多少时间	{日月潭=出发poi名称, 火车=交通方式, 芬兰堡=目的poi名称}	行程属性
从路易港到密歇根湖地铁大概要花多少时间	{密歇根湖=目的poi名称, 路易港=出发poi名称, 地铁=交通方式}	行程属性
从白沙滩到光明寺大巴车大概要花多少时间	{大巴车=交通方式, 白沙滩=出发poi名称, 光明寺=目的poi名称}	行程属性
从密歇根湖到大夏宫飞机大概要花多少时间	{密歇根湖=出发poi名称, 大夏宫=目的poi名称, 飞机=交通方式}	行程属性
从大夏宫到唐人街大巴车大概要花多少时间	{大巴车=交通方式, 唐人街=目的poi名称, 大夏宫=出发poi名称}	行程属性
从新加坡河到密歇根湖火车大概要花多少时间	{火车=交通方式, 新加坡河=出发poi名称, 密歇根湖=目的poi名称}	行程属性
从唐人街到迪士尼大巴车大概要花多少时间	{大巴车=交通方式, 唐人街=出发poi名称, 迪士尼=目的poi名称}	行程属性
从景福宫到多瑙河飞机大概要花多少时间	{景福宫=出发poi名称, 多瑙河=目的poi名称, 飞机=交通方式}	行程属性
从景福宫到九寨沟飞机大概要花多少时间	{景福宫=出发poi名称, 九寨沟=目的poi名称, 飞机=交通方式}	行程属性
从迪斯尼到青莲院地铁大概要花多少时间	{青莲院=目的poi名称, 地铁=交通方式, 迪斯尼=出发poi名称}	行程属性
从猴庙到荣军院火车大概要花多少时间	{火车=交通方式, 猴庙=出发poi名称, 荣军院=目的poi名称}	行程属性
从多瑙河到维港地铁大概要花多少时间	{维港=目的poi名称, 多瑙河=出发poi名称, 地铁=交通方式}	行程属性
从白沙滩到荣军院大巴车大概要花多少时间	{大巴车=交通方式, 白沙滩=出发poi名称, 荣军院=目的poi名称}	行程属性
从大夏宫到猴庙飞机大概要花多少时间	{大夏宫=出发poi名称, 猴庙=目的poi名称, 飞机=交通方式}	行程属性
从阿尔法玛到大夏宫大巴车大概要花多少时间	{大巴车=交通方式, 阿尔法玛=出发poi名称, 大夏宫=目的poi名称}	行程属性
从密歇根湖到莱茵河火车大概要花多少时间	{莱茵河=目的poi名称, 火车=交通方式, 密歇根湖=出发poi名称}	行程属性
从鼓浪屿到金阁寺大巴车大概要花多少时间	{大巴车=交通方式, 鼓浪屿=出发poi名称, 金阁寺=目的poi名称}	行程属性
从托普卡帕宫到全聚德大巴车大概要花多少时间	{大巴车=交通方式, 全聚德=目的poi名称, 托普卡帕宫=出发poi名称}	行程属性
从路易港到青莲院火车大概要花多少时间	{火车=交通方式, 路易港=出发poi名称, 青莲院=目的poi名称}	行程属性
从托普卡帕宫到阿尔法玛飞机大概要花多少时间	{阿尔法玛=目的poi名称, 托普卡帕宫=出发poi名称, 飞机=交通方式}	行程属性
从迪斯尼到九寨沟大巴车大概要花多少时间	{大巴车=交通方式, 九寨沟=目的poi名称, 迪斯尼=出发poi名称}	行程属性
从密歇根湖到迪士尼大巴车大概要花多少时间	{大巴车=交通方式, 密歇根湖=出发poi名称, 迪士尼=目的poi名称}	行程属性
从唐人街到维多利亚港大巴车大概要花多少时间	{大巴车=交通方式, 唐人街=出发poi名称, 维多利亚港=目的poi名称}	行程属性
从景福宫到路易港飞机大概要花多少时间	{景福宫=出发poi名称, 路易港=目的poi名称, 飞机=交通方式}	行程属性
从光明寺到马穆提岛飞机大概要花多少时间	{光明寺=出发poi名称, 马穆提岛=目的poi名称, 飞机=交通方式}	行程属性
从金阁寺到鼓浪屿飞机大概要花多少时间	{鼓浪屿=目的poi名称, 飞机=交通方式, 金阁寺=出发poi名称}	行程属性
从凯旋门到光明寺飞机大概要花多少时间	{光明寺=目的poi名称, 凯旋门=出发poi名称, 飞机=交通方式}	行程属性
从密歇根湖到托普卡帕宫地铁大概要花多少时间	{密歇根湖=出发poi名称, 地铁=交通方式, 托普卡帕宫=目的poi名称}	行程属性
从大夏宫到日月潭火车大概要花多少时间	{日月潭=目的poi名称, 火车=交通方式, 大夏宫=出发poi名称}	行程属性
从孚日宫到白沙滩大巴车大概要花多少时间	{孚日宫=出发poi名称, 大巴车=交通方式, 白沙滩=目的poi名称}	行程属性
从鼓浪屿到路易港火车大概要花多少时间	{火车=交通方式, 鼓浪屿=出发poi名称, 路易港=目的poi名称}	行程属性
从唐人街到金阁寺大巴车大概要花多少时间	{大巴车=交通方式, 唐人街=出发poi名称, 金阁寺=目的poi名称}	行程属性
从唐人街到景福宫火车大概要花多少时间	{唐人街=出发poi名称, 景福宫=目的poi名称, 火车=交通方式}	行程属性
从凯旋门到光明寺大巴车大概要花多少时间	{大巴车=交通方式, 光明寺=目的poi名称, 凯旋门=出发poi名称}	行程属性
从多瑙河到路易港大巴车大概要花多少时间	{大巴车=交通方式, 多瑙河=出发poi名称, 路易港=目的poi名称}	行程属性
从迪斯尼到路易港飞机大概要花多少时间	{路易港=目的poi名称, 飞机=交通方式, 迪斯尼=出发poi名称}	行程属性
从这里到迪斯尼地铁需要很长时间吗	{地铁=交通方式, 迪斯尼=目的poi名称}	行程属性
从这里到芬兰堡火车需要很长时间吗	{火车=交通方式, 芬兰堡=目的poi名称}	行程属性
从这里到金阁寺地铁需要很长时间吗	{地铁=交通方式, 金阁寺=目的poi名称}	行程属性
从这里到密歇根湖火车需要很长时间吗	{火车=交通方式, 密歇根湖=目的poi名称}	行程属性
从这里到孚日宫地铁需要很长时间吗	{孚日宫=目的poi名称, 地铁=交通方式}	行程属性
从这里到新加坡河火车需要很长时间吗	{火车=交通方式, 新加坡河=目的poi名称}	行程属性
从这里到鼓浪屿大巴车需要很长时间吗	{大巴车=交通方式, 鼓浪屿=目的poi名称}	行程属性
从这里到大夏宫火车需要很长时间吗	{火车=交通方式, 大夏宫=目的poi名称}	行程属性
从这里到维多利亚港火车需要很长时间吗	{火车=交通方式, 维多利亚港=目的poi名称}	行程属性
从这里到迪士尼地铁需要很长时间吗	{地铁=交通方式, 迪士尼=目的poi名称}	行程属性
从这里到全聚德地铁需要很长时间吗	{全聚德=目的poi名称, 地铁=交通方式}	行程属性
从这里到路易港飞机需要很长时间吗	{路易港=目的poi名称, 飞机=交通方式}	行程属性
从这里到九寨沟大巴车需要很长时间吗	{大巴车=交通方式, 九寨沟=目的poi名称}	行程属性
从这里到迪士尼大巴车需要很长时间吗	{大巴车=交通方式, 迪士尼=目的poi名称}	行程属性
从这里到日月潭火车需要很长时间吗	{日月潭=目的poi名称, 火车=交通方式}	行程属性
从这里到光明寺地铁需要很长时间吗	{光明寺=目的poi名称, 地铁=交通方式}	行程属性
从这里到九寨沟火车需要很长时间吗	{九寨沟=目的poi名称, 火车=交通方式}	行程属性
从这里到玛黑区火车需要很长时间吗	{玛黑区=目的poi名称, 火车=交通方式}	行程属性
从这里到景福宫火车需要很长时间吗	{景福宫=目的poi名称, 火车=交通方式}	行程属性
从这里到全聚德大巴车需要很长时间吗	{大巴车=交通方式, 全聚德=目的poi名称}	行程属性
从这里到九寨沟地铁需要很长时间吗	{九寨沟=目的poi名称, 地铁=交通方式}	行程属性
从这里到莱茵河大巴车需要很长时间吗	{莱茵河=目的poi名称, 大巴车=交通方式}	行程属性
从这里到玛黑区飞机需要很长时间吗	{玛黑区=目的poi名称, 飞机=交通方式}	行程属性
从这里到密歇根湖大巴车需要很长时间吗	{大巴车=交通方式, 密歇根湖=目的poi名称}	行程属性
从这里到阿尔法玛地铁需要很长时间吗	{阿尔法玛=目的poi名称, 地铁=交通方式}	行程属性
从这里到唐人街地铁需要很长时间吗	{唐人街=目的poi名称, 地铁=交通方式}	行程属性
从这里到猴庙地铁需要很长时间吗	{地铁=交通方式, 猴庙=目的poi名称}	行程属性
从这里到维港火车需要很长时间吗	{维港=目的poi名称, 火车=交通方式}	行程属性
从这里到凯旋门飞机需要很长时间吗	{凯旋门=目的poi名称, 飞机=交通方式}	行程属性
从这里到新加坡河大巴车需要很长时间吗	{大巴车=交通方式, 新加坡河=目的poi名称}	行程属性
从这里到青莲院火车需要很长时间吗	{火车=交通方式, 青莲院=目的poi名称}	行程属性
从这里到维多利亚港飞机需要很长时间吗	{维多利亚港=目的poi名称, 飞机=交通方式}	行程属性
从这里到维港飞机需要很长时间吗	{维港=目的poi名称, 飞机=交通方式}	行程属性
从这里到阿尔法玛飞机需要很长时间吗	{阿尔法玛=目的poi名称, 飞机=交通方式}	行程属性
从这里到马穆提岛地铁需要很长时间吗	{地铁=交通方式, 马穆提岛=目的poi名称}	行程属性
从这里到大夏宫飞机需要很长时间吗	{大夏宫=目的poi名称, 飞机=交通方式}	行程属性
从这里到猴庙火车需要很长时间吗	{火车=交通方式, 猴庙=目的poi名称}	行程属性
从这里到猴庙飞机需要很长时间吗	{猴庙=目的poi名称, 飞机=交通方式}	行程属性
从这里到维港地铁需要很长时间吗	{维港=目的poi名称, 地铁=交通方式}	行程属性
从这里到维多利亚港大巴车需要很长时间吗	{大巴车=交通方式, 维多利亚港=目的poi名称}	行程属性
从这里到芬兰堡地铁需要很长时间吗	{芬兰堡=目的poi名称, 地铁=交通方式}	行程属性
从这里到密歇根湖飞机需要很长时间吗	{密歇根湖=目的poi名称, 飞机=交通方式}	行程属性
从这里到迪士尼飞机需要很长时间吗	{迪士尼=目的poi名称, 飞机=交通方式}	行程属性
从这里到孚日宫火车需要很长时间吗	{孚日宫=目的poi名称, 火车=交通方式}	行程属性
从这里到马穆提岛飞机需要很长时间吗	{马穆提岛=目的poi名称, 飞机=交通方式}	行程属性
从这里到芬兰堡大巴车需要很长时间吗	{大巴车=交通方式, 芬兰堡=目的poi名称}	行程属性
从这里到红树火车需要很长时间吗	{红树=目的poi名称, 火车=交通方式}	行程属性
从这里到光明寺飞机需要很长时间吗	{光明寺=目的poi名称, 飞机=交通方式}	行程属性
从这里到多瑙河地铁需要很长时间吗	{多瑙河=目的poi名称, 地铁=交通方式}	行程属性
从这里到红树飞机需要很长时间吗	{红树=目的poi名称, 飞机=交通方式}	行程属性
从这里到荣军院大巴车需要很长时间吗	{大巴车=交通方式, 荣军院=目的poi名称}	行程属性
从这里到白沙滩大巴车需要很长时间吗	{大巴车=交通方式, 白沙滩=目的poi名称}	行程属性
从这里到多瑙河大巴车需要很长时间吗	{大巴车=交通方式, 多瑙河=目的poi名称}	行程属性
从这里到九寨沟飞机需要很长时间吗	{九寨沟=目的poi名称, 飞机=交通方式}	行程属性
从这里到维港大巴车需要很长时间吗	{大巴车=交通方式, 维港=目的poi名称}	行程属性
从这里到金阁寺火车需要很长时间吗	{火车=交通方式, 金阁寺=目的poi名称}	行程属性
从这里到多瑙河飞机需要很长时间吗	{多瑙河=目的poi名称, 飞机=交通方式}	行程属性
从这里到凯旋门地铁需要很长时间吗	{地铁=交通方式, 凯旋门=目的poi名称}	行程属性
从这里到金阁寺飞机需要很长时间吗	{飞机=交通方式, 金阁寺=目的poi名称}	行程属性
从这里到猴庙大巴车需要很长时间吗	{大巴车=交通方式, 猴庙=目的poi名称}	行程属性
从这里到卢浮宫地铁需要很长时间吗	{卢浮宫=目的poi名称, 地铁=交通方式}	行程属性
从这里到多瑙河火车需要很长时间吗	{火车=交通方式, 多瑙河=目的poi名称}	行程属性
从这里到路易港火车需要很长时间吗	{火车=交通方式, 路易港=目的poi名称}	行程属性
从这里到日月潭飞机需要很长时间吗	{日月潭=目的poi名称, 飞机=交通方式}	行程属性
从这里到荣军院飞机需要很长时间吗	{荣军院=目的poi名称, 飞机=交通方式}	行程属性
从这里到托普卡帕宫飞机需要很长时间吗	{托普卡帕宫=目的poi名称, 飞机=交通方式}	行程属性
从这里到托普卡帕宫火车需要很长时间吗	{火车=交通方式, 托普卡帕宫=目的poi名称}	行程属性
从这里到鼓浪屿火车需要很长时间吗	{火车=交通方式, 鼓浪屿=目的poi名称}	行程属性
从这里到鼓浪屿地铁需要很长时间吗	{鼓浪屿=目的poi名称, 地铁=交通方式}	行程属性
从这里到青莲院地铁需要很长时间吗	{青莲院=目的poi名称, 地铁=交通方式}	行程属性
从这里到大夏宫地铁需要很长时间吗	{大夏宫=目的poi名称, 地铁=交通方式}	行程属性
从这里到马穆提岛火车需要很长时间吗	{火车=交通方式, 马穆提岛=目的poi名称}	行程属性
从这里到全聚德飞机需要很长时间吗	{全聚德=目的poi名称, 飞机=交通方式}	行程属性
从这里到唐人街飞机需要很长时间吗	{唐人街=目的poi名称, 飞机=交通方式}	行程属性
从这里到荣军院火车需要很长时间吗	{火车=交通方式, 荣军院=目的poi名称}	行程属性
从这里到全聚德火车需要很长时间吗	{全聚德=目的poi名称, 火车=交通方式}	行程属性
从这里到密歇根湖地铁需要很长时间吗	{密歇根湖=目的poi名称, 地铁=交通方式}	行程属性
从这里到景福宫飞机需要很长时间吗	{景福宫=目的poi名称, 飞机=交通方式}	行程属性
从这里到路易港大巴车需要很长时间吗	{大巴车=交通方式, 路易港=目的poi名称}	行程属性
从这里地铁到白沙滩花的时间多吗	{白沙滩=目的poi名称, 地铁=交通方式}	行程属性
从这里大巴车到维多利亚港花的时间多吗	{大巴车=交通方式, 维多利亚港=目的poi名称}	行程属性
从这里地铁到阿尔法玛花的时间多吗	{阿尔法玛=目的poi名称, 地铁=交通方式}	行程属性
从这里火车到迪斯尼花的时间多吗	{火车=交通方式, 迪斯尼=目的poi名称}	行程属性
从这里火车到红树花的时间多吗	{红树=目的poi名称, 火车=交通方式}	行程属性
从这里飞机到托普卡帕宫花的时间多吗	{托普卡帕宫=目的poi名称, 飞机=交通方式}	行程属性
从这里大巴车到金阁寺花的时间多吗	{大巴车=交通方式, 金阁寺=目的poi名称}	行程属性
从这里大巴车到新加坡河花的时间多吗	{大巴车=交通方式, 新加坡河=目的poi名称}	行程属性
从这里大巴车到卢浮宫花的时间多吗	{大巴车=交通方式, 卢浮宫=目的poi名称}	行程属性
从这里火车到孚日宫花的时间多吗	{孚日宫=目的poi名称, 火车=交通方式}	行程属性
从这里地铁到荣军院花的时间多吗	{地铁=交通方式, 荣军院=目的poi名称}	行程属性
从这里地铁到密歇根湖花的时间多吗	{密歇根湖=目的poi名称, 地铁=交通方式}	行程属性
从这里地铁到迪士尼花的时间多吗	{地铁=交通方式, 迪士尼=目的poi名称}	行程属性
从这里火车到鼓浪屿花的时间多吗	{火车=交通方式, 鼓浪屿=目的poi名称}	行程属性
从这里飞机到莱茵河花的时间多吗	{莱茵河=目的poi名称, 飞机=交通方式}	行程属性
从这里大巴车到荣军院花的时间多吗	{大巴车=交通方式, 荣军院=目的poi名称}	行程属性
从这里飞机到多瑙河花的时间多吗	{多瑙河=目的poi名称, 飞机=交通方式}	行程属性
从这里飞机到马穆提岛花的时间多吗	{马穆提岛=目的poi名称, 飞机=交通方式}	行程属性
从这里地铁到金阁寺花的时间多吗	{地铁=交通方式, 金阁寺=目的poi名称}	行程属性
从这里火车到日月潭花的时间多吗	{日月潭=目的poi名称, 火车=交通方式}	行程属性
从这里飞机到日月潭花的时间多吗	{日月潭=目的poi名称, 飞机=交通方式}	行程属性
从这里火车到阿尔法玛花的时间多吗	{火车=交通方式, 阿尔法玛=目的poi名称}	行程属性
从这里火车到莱茵河花的时间多吗	{莱茵河=目的poi名称, 火车=交通方式}	行程属性
从这里地铁到唐人街花的时间多吗	{唐人街=目的poi名称, 地铁=交通方式}	行程属性
从这里大巴车到白沙滩花的时间多吗	{大巴车=交通方式, 白沙滩=目的poi名称}	行程属性
从这里地铁到九寨沟花的时间多吗	{九寨沟=目的poi名称, 地铁=交通方式}	行程属性
从这里飞机到凯旋门花的时间多吗	{凯旋门=目的poi名称, 飞机=交通方式}	行程属性
从这里地铁到光明寺花的时间多吗	{光明寺=目的poi名称, 地铁=交通方式}	行程属性
从这里火车到白沙滩花的时间多吗	{火车=交通方式, 白沙滩=目的poi名称}	行程属性
从这里大巴车到景福宫花的时间多吗	{大巴车=交通方式, 景福宫=目的poi名称}	行程属性
从这里火车到新加坡河花的时间多吗	{火车=交通方式, 新加坡河=目的poi名称}	行程属性
从这里大巴车到迪士尼花的时间多吗	{大巴车=交通方式, 迪士尼=目的poi名称}	行程属性
从这里飞机到荣军院花的时间多吗	{荣军院=目的poi名称, 飞机=交通方式}	行程属性
从这里地铁到维多利亚港花的时间多吗	{维多利亚港=目的poi名称, 地铁=交通方式}	行程属性
从这里大巴车到马穆提岛花的时间多吗	{大巴车=交通方式, 马穆提岛=目的poi名称}	行程属性
从这里地铁到迪斯尼花的时间多吗	{地铁=交通方式, 迪斯尼=目的poi名称}	行程属性
从这里飞机到迪士尼花的时间多吗	{迪士尼=目的poi名称, 飞机=交通方式}	行程属性
从这里大巴车到光明寺花的时间多吗	{大巴车=交通方式, 光明寺=目的poi名称}	行程属性
从这里地铁到莱茵河花的时间多吗	{莱茵河=目的poi名称, 地铁=交通方式}	行程属性
从这里飞机到路易港花的时间多吗	{路易港=目的poi名称, 飞机=交通方式}	行程属性
从这里地铁到多瑙河花的时间多吗	{多瑙河=目的poi名称, 地铁=交通方式}	行程属性
从这里飞机到猴庙花的时间多吗	{猴庙=目的poi名称, 飞机=交通方式}	行程属性
从这里飞机到全聚德花的时间多吗	{全聚德=目的poi名称, 飞机=交通方式}	行程属性
从这里大巴车到青莲院花的时间多吗	{大巴车=交通方式, 青莲院=目的poi名称}	行程属性
从这里地铁到玛黑区花的时间多吗	{玛黑区=目的poi名称, 地铁=交通方式}	行程属性
从这里火车到全聚德花的时间多吗	{全聚德=目的poi名称, 火车=交通方式}	行程属性
从这里飞机到青莲院花的时间多吗	{青莲院=目的poi名称, 飞机=交通方式}	行程属性
从这里地铁到托普卡帕宫花的时间多吗	{地铁=交通方式, 托普卡帕宫=目的poi名称}	行程属性
从这里地铁到红树花的时间多吗	{红树=目的poi名称, 地铁=交通方式}	行程属性
从这里地铁到猴庙花的时间多吗	{地铁=交通方式, 猴庙=目的poi名称}	行程属性
从这里大巴车到多瑙河花的时间多吗	{大巴车=交通方式, 多瑙河=目的poi名称}	行程属性
从这里飞机到芬兰堡花的时间多吗	{芬兰堡=目的poi名称, 飞机=交通方式}	行程属性
从这里大巴车到唐人街花的时间多吗	{大巴车=交通方式, 唐人街=目的poi名称}	行程属性
从这里飞机到鼓浪屿花的时间多吗	{鼓浪屿=目的poi名称, 飞机=交通方式}	行程属性
从这里火车到多瑙河花的时间多吗	{火车=交通方式, 多瑙河=目的poi名称}	行程属性
从这里火车到密歇根湖花的时间多吗	{火车=交通方式, 密歇根湖=目的poi名称}	行程属性
从这里飞机到维港花的时间多吗	{维港=目的poi名称, 飞机=交通方式}	行程属性
从这里飞机到新加坡河花的时间多吗	{新加坡河=目的poi名称, 飞机=交通方式}	行程属性
从这里火车到迪士尼花的时间多吗	{火车=交通方式, 迪士尼=目的poi名称}	行程属性
从这里飞机到迪斯尼花的时间多吗	{飞机=交通方式, 迪斯尼=目的poi名称}	行程属性
从这里地铁到维港花的时间多吗	{维港=目的poi名称, 地铁=交通方式}	行程属性
从这里火车到景福宫花的时间多吗	{景福宫=目的poi名称, 火车=交通方式}	行程属性
从这里火车到金阁寺花的时间多吗	{火车=交通方式, 金阁寺=目的poi名称}	行程属性
从这里火车到光明寺花的时间多吗	{火车=交通方式, 光明寺=目的poi名称}	行程属性
从这里火车到托普卡帕宫花的时间多吗	{火车=交通方式, 托普卡帕宫=目的poi名称}	行程属性
从这里大巴车到路易港花的时间多吗	{大巴车=交通方式, 路易港=目的poi名称}	行程属性
从这里地铁到大夏宫花的时间多吗	{地铁=交通方式, 大夏宫=目的poi名称}	行程属性
从这里地铁到路易港花的时间多吗	{地铁=交通方式, 路易港=目的poi名称}	行程属性
从这里大巴车到红树花的时间多吗	{红树=目的poi名称, 大巴车=交通方式}	行程属性
从这里地铁到芬兰堡花的时间多吗	{芬兰堡=目的poi名称, 地铁=交通方式}	行程属性
从这里飞机到金阁寺花的时间多吗	{飞机=交通方式, 金阁寺=目的poi名称}	行程属性
从这里火车到玛黑区花的时间多吗	{玛黑区=目的poi名称, 火车=交通方式}	行程属性
从这里大巴车到凯旋门花的时间多吗	{大巴车=交通方式, 凯旋门=目的poi名称}	行程属性
从这里飞机到光明寺花的时间多吗	{光明寺=目的poi名称, 飞机=交通方式}	行程属性
从这里火车到维港花的时间多吗	{维港=目的poi名称, 火车=交通方式}	行程属性
从这里地铁到新加坡河花的时间多吗	{新加坡河=目的poi名称, 地铁=交通方式}	行程属性
从这里飞机到九寨沟花的时间多吗	{九寨沟=目的poi名称, 飞机=交通方式}	行程属性
从这里火车到维多利亚港花的时间多吗	{火车=交通方式, 维多利亚港=目的poi名称}	行程属性
从这里火车到大夏宫花的时间多吗	{火车=交通方式, 大夏宫=目的poi名称}	行程属性
从这里飞机到玛黑区花的时间多吗	{玛黑区=目的poi名称, 飞机=交通方式}	行程属性
从这里地铁到马穆提岛花的时间多吗	{地铁=交通方式, 马穆提岛=目的poi名称}	行程属性
从这里地铁到青莲院花的时间多吗	{地铁=交通方式, 青莲院=目的poi名称}	行程属性
从这里大巴车到阿尔法玛花的时间多吗	{大巴车=交通方式, 阿尔法玛=目的poi名称}	行程属性
从这大巴车到猴庙用的时间长吗	{大巴车=交通方式, 猴庙=目的poi名称}	行程属性
从这飞机到多瑙河用的时间长吗	{多瑙河=目的poi名称, 飞机=交通方式}	行程属性
从这飞机到鼓浪屿用的时间长吗	{鼓浪屿=目的poi名称, 飞机=交通方式}	行程属性
从这飞机到莱茵河用的时间长吗	{莱茵河=目的poi名称, 飞机=交通方式}	行程属性
从这飞机到维港用的时间长吗	{维港=目的poi名称, 飞机=交通方式}	行程属性
从这地铁到凯旋门用的时间长吗	{地铁=交通方式, 凯旋门=目的poi名称}	行程属性
从这地铁到白沙滩用的时间长吗	{白沙滩=目的poi名称, 地铁=交通方式}	行程属性
从这飞机到马穆提岛用的时间长吗	{马穆提岛=目的poi名称, 飞机=交通方式}	行程属性
从这火车到莱茵河用的时间长吗	{莱茵河=目的poi名称, 火车=交通方式}	行程属性
从这飞机到卢浮宫用的时间长吗	{卢浮宫=目的poi名称, 飞机=交通方式}	行程属性
从这大巴车到唐人街用的时间长吗	{大巴车=交通方式, 唐人街=目的poi名称}	行程属性
从这飞机到唐人街用的时间长吗	{唐人街=目的poi名称, 飞机=交通方式}	行程属性
从这火车到路易港用的时间长吗	{火车=交通方式, 路易港=目的poi名称}	行程属性
从这大巴车到光明寺用的时间长吗	{大巴车=交通方式, 光明寺=目的poi名称}	行程属性
从这地铁到卢浮宫用的时间长吗	{卢浮宫=目的poi名称, 地铁=交通方式}	行程属性
从这火车到荣军院用的时间长吗	{火车=交通方式, 荣军院=目的poi名称}	行程属性
从这飞机到九寨沟用的时间长吗	{九寨沟=目的poi名称, 飞机=交通方式}	行程属性
从这大巴车到日月潭用的时间长吗	{日月潭=目的poi名称, 大巴车=交通方式}	行程属性
从这地铁到迪斯尼用的时间长吗	{地铁=交通方式, 迪斯尼=目的poi名称}	行程属性
从这飞机到孚日宫用的时间长吗	{孚日宫=目的poi名称, 飞机=交通方式}	行程属性
从这地铁到马穆提岛用的时间长吗	{地铁=交通方式, 马穆提岛=目的poi名称}	行程属性
从这火车到白沙滩用的时间长吗	{火车=交通方式, 白沙滩=目的poi名称}	行程属性
从这大巴车到多瑙河用的时间长吗	{大巴车=交通方式, 多瑙河=目的poi名称}	行程属性
从这大巴车到景福宫用的时间长吗	{大巴车=交通方式, 景福宫=目的poi名称}	行程属性
从这地铁到玛黑区用的时间长吗	{玛黑区=目的poi名称, 地铁=交通方式}	行程属性
从这地铁到荣军院用的时间长吗	{地铁=交通方式, 荣军院=目的poi名称}	行程属性
从这地铁到阿尔法玛用的时间长吗	{阿尔法玛=目的poi名称, 地铁=交通方式}	行程属性
从这火车到密歇根湖用的时间长吗	{火车=交通方式, 密歇根湖=目的poi名称}	行程属性
从这地铁到鼓浪屿用的时间长吗	{地铁=交通方式, 鼓浪屿=目的poi名称}	行程属性
从这火车到猴庙用的时间长吗	{火车=交通方式, 猴庙=目的poi名称}	行程属性
从这地铁到大夏宫用的时间长吗	{地铁=交通方式, 大夏宫=目的poi名称}	行程属性
从这大巴车到迪士尼用的时间长吗	{大巴车=交通方式, 迪士尼=目的poi名称}	行程属性
从这飞机到迪士尼用的时间长吗	{迪士尼=目的poi名称, 飞机=交通方式}	行程属性
从这大巴车到路易港用的时间长吗	{大巴车=交通方式, 路易港=目的poi名称}	行程属性
从这大巴车到维港用的时间长吗	{大巴车=交通方式, 维港=目的poi名称}	行程属性
从这地铁到密歇根湖用的时间长吗	{密歇根湖=目的poi名称, 地铁=交通方式}	行程属性
从这地铁到维多利亚港用的时间长吗	{维多利亚港=目的poi名称, 地铁=交通方式}	行程属性
从这火车到阿尔法玛用的时间长吗	{火车=交通方式, 阿尔法玛=目的poi名称}	行程属性
从这火车到新加坡河用的时间长吗	{火车=交通方式, 新加坡河=目的poi名称}	行程属性
从这地铁到孚日宫用的时间长吗	{孚日宫=目的poi名称, 地铁=交通方式}	行程属性
从这飞机到新加坡河用的时间长吗	{新加坡河=目的poi名称, 飞机=交通方式}	行程属性
从这大巴车到凯旋门用的时间长吗	{大巴车=交通方式, 凯旋门=目的poi名称}	行程属性
从这飞机到白沙滩用的时间长吗	{白沙滩=目的poi名称, 飞机=交通方式}	行程属性
从这火车到马穆提岛用的时间长吗	{火车=交通方式, 马穆提岛=目的poi名称}	行程属性
从这大巴车到莱茵河用的时间长吗	{莱茵河=目的poi名称, 大巴车=交通方式}	行程属性
从这地铁到迪士尼用的时间长吗	{地铁=交通方式, 迪士尼=目的poi名称}	行程属性
从这大巴车到迪斯尼用的时间长吗	{大巴车=交通方式, 迪斯尼=目的poi名称}	行程属性
从这大巴车到红树用的时间长吗	{红树=目的poi名称, 大巴车=交通方式}	行程属性
从这大巴车到马穆提岛用的时间长吗	{大巴车=交通方式, 马穆提岛=目的poi名称}	行程属性
从这飞机到日月潭用的时间长吗	{日月潭=目的poi名称, 飞机=交通方式}	行程属性
从这地铁到金阁寺用的时间长吗	{地铁=交通方式, 金阁寺=目的poi名称}	行程属性
从这火车到金阁寺用的时间长吗	{火车=交通方式, 金阁寺=目的poi名称}	行程属性
从这地铁到日月潭用的时间长吗	{日月潭=目的poi名称, 地铁=交通方式}	行程属性
从这大巴车到荣军院用的时间长吗	{大巴车=交通方式, 荣军院=目的poi名称}	行程属性
从这火车到孚日宫用的时间长吗	{孚日宫=目的poi名称, 火车=交通方式}	行程属性
从这地铁到唐人街用的时间长吗	{唐人街=目的poi名称, 地铁=交通方式}	行程属性
从这飞机到光明寺用的时间长吗	{光明寺=目的poi名称, 飞机=交通方式}	行程属性
从这火车到玛黑区用的时间长吗	{玛黑区=目的poi名称, 火车=交通方式}	行程属性
从这地铁到全聚德用的时间长吗	{全聚德=目的poi名称, 地铁=交通方式}	行程属性
从这大巴车到白沙滩用的时间长吗	{大巴车=交通方式, 白沙滩=目的poi名称}	行程属性
从这火车到景福宫用的时间长吗	{景福宫=目的poi名称, 火车=交通方式}	行程属性
从这地铁到青莲院用的时间长吗	{地铁=交通方式, 青莲院=目的poi名称}	行程属性
从这火车到迪斯尼用的时间长吗	{火车=交通方式, 迪斯尼=目的poi名称}	行程属性
从这火车到唐人街用的时间长吗	{唐人街=目的poi名称, 火车=交通方式}	行程属性
这里离九寨沟多远	{九寨沟=目的poi名称}	行程属性
这里离凯旋门多远	{凯旋门=目的poi名称}	行程属性
这里离大夏宫多远	{大夏宫=目的poi名称}	行程属性
这里离猴庙多远	{猴庙=目的poi名称}	行程属性
这里离路易港多远	{路易港=目的poi名称}	行程属性
这里离玛黑区多远	{玛黑区=目的poi名称}	行程属性
这里离卢浮宫多远	{卢浮宫=目的poi名称}	行程属性
这里离阿尔法玛多远	{阿尔法玛=目的poi名称}	行程属性
这里离孚日宫多远	{孚日宫=目的poi名称}	行程属性
这里离多瑙河多远	{多瑙河=目的poi名称}	行程属性
这里离托普卡帕宫多远	{托普卡帕宫=目的poi名称}	行程属性
这里离光明寺多远	{光明寺=目的poi名称}	行程属性
这里离维港多远	{维港=目的poi名称}	行程属性
这里离马穆提岛多远	{马穆提岛=目的poi名称}	行程属性
这里离金阁寺多远	{金阁寺=目的poi名称}	行程属性
这里离维多利亚港多远	{维多利亚港=目的poi名称}	行程属性
这里离全聚德多远	{全聚德=目的poi名称}	行程属性
这里离荣军院多远	{荣军院=目的poi名称}	行程属性
这里离青莲院多远	{青莲院=目的poi名称}	行程属性
这里离景福宫多远	{景福宫=目的poi名称}	行程属性
这里离迪士尼多远	{迪士尼=目的poi名称}	行程属性
这里离密歇根湖多远	{密歇根湖=目的poi名称}	行程属性
这里离红树多远	{红树=目的poi名称}	行程属性
这里离迪斯尼多远	{迪斯尼=目的poi名称}	行程属性
这里离芬兰堡多远	{芬兰堡=目的poi名称}	行程属性
这里离莱茵河多远	{莱茵河=目的poi名称}	行程属性
这里离唐人街多远	{唐人街=目的poi名称}	行程属性
告诉我多瑙河到阿尔法玛的距离	{多瑙河=出发poi名称, 阿尔法玛=目的poi名称}	行程属性
告诉我荣军院到鼓浪屿的距离	{鼓浪屿=目的poi名称, 荣军院=出发poi名称}	行程属性
告诉我孚日宫到景福宫的距离	{孚日宫=出发poi名称, 景福宫=目的poi名称}	行程属性
告诉我日月潭到全聚德的距离	{日月潭=出发poi名称, 全聚德=目的poi名称}	行程属性
告诉我阿尔法玛到日月潭的距离	{日月潭=目的poi名称, 阿尔法玛=出发poi名称}	行程属性
告诉我卢浮宫到密歇根湖的距离	{卢浮宫=出发poi名称, 密歇根湖=目的poi名称}	行程属性
告诉我维港到景福宫的距离	{维港=出发poi名称, 景福宫=目的poi名称}	行程属性
告诉我荣军院到维港的距离	{维港=目的poi名称, 荣军院=出发poi名称}	行程属性
告诉我白沙滩到维多利亚港的距离	{白沙滩=出发poi名称, 维多利亚港=目的poi名称}	行程属性
告诉我维港到猴庙的距离	{维港=出发poi名称, 猴庙=目的poi名称}	行程属性
告诉我金阁寺到阿尔法玛的距离	{阿尔法玛=目的poi名称, 金阁寺=出发poi名称}	行程属性
告诉我阿尔法玛到光明寺的距离	{阿尔法玛=出发poi名称, 光明寺=目的poi名称}	行程属性
告诉我芬兰堡到维多利亚港的距离	{维多利亚港=目的poi名称, 芬兰堡=出发poi名称}	行程属性
告诉我鼓浪屿到芬兰堡的距离	{芬兰堡=目的poi名称, 鼓浪屿=出发poi名称}	行程属性
告诉我卢浮宫到托普卡帕宫的距离	{卢浮宫=出发poi名称, 托普卡帕宫=目的poi名称}	行程属性
告诉我卢浮宫到莱茵河的距离	{莱茵河=目的poi名称, 卢浮宫=出发poi名称}	行程属性
告诉我玛黑区到大夏宫的距离	{玛黑区=出发poi名称, 大夏宫=目的poi名称}	行程属性
告诉我红树到凯旋门的距离	{红树=出发poi名称, 凯旋门=目的poi名称}	行程属性
告诉我迪斯尼到莱茵河的距离	{莱茵河=目的poi名称, 迪斯尼=出发poi名称}	行程属性
告诉我大夏宫到卢浮宫的距离	{卢浮宫=目的poi名称, 大夏宫=出发poi名称}	行程属性
告诉我路易港到大夏宫的距离	{路易港=出发poi名称, 大夏宫=目的poi名称}	行程属性
告诉我凯旋门到荣军院的距离	{凯旋门=出发poi名称, 荣军院=目的poi名称}	行程属性
告诉我景福宫到凯旋门的距离	{景福宫=出发poi名称, 凯旋门=目的poi名称}	行程属性
告诉我青莲院到迪斯尼的距离	{青莲院=出发poi名称, 迪斯尼=目的poi名称}	行程属性
告诉我玛黑区到鼓浪屿的距离	{玛黑区=出发poi名称, 鼓浪屿=目的poi名称}	行程属性
告诉我鼓浪屿到全聚德的距离	{全聚德=目的poi名称, 鼓浪屿=出发poi名称}	行程属性
告诉我维港到白沙滩的距离	{维港=出发poi名称, 白沙滩=目的poi名称}	行程属性
告诉我孚日宫到托普卡帕宫的距离	{孚日宫=出发poi名称, 托普卡帕宫=目的poi名称}	行程属性
告诉我玛黑区到唐人街的距离	{玛黑区=出发poi名称, 唐人街=目的poi名称}	行程属性
告诉我光明寺到青莲院的距离	{光明寺=出发poi名称, 青莲院=目的poi名称}	行程属性
告诉我新加坡河到凯旋门的距离	{新加坡河=出发poi名称, 凯旋门=目的poi名称}	行程属性
告诉我莱茵河到孚日宫的距离	{莱茵河=出发poi名称, 孚日宫=目的poi名称}	行程属性
告诉我维港到荣军院的距离	{维港=出发poi名称, 荣军院=目的poi名称}	行程属性
告诉我青莲院到荣军院的距离	{青莲院=出发poi名称, 荣军院=目的poi名称}	行程属性
告诉我马穆提岛到荣军院的距离	{马穆提岛=出发poi名称, 荣军院=目的poi名称}	行程属性
告诉我孚日宫到唐人街的距离	{孚日宫=出发poi名称, 唐人街=目的poi名称}	行程属性
告诉我金阁寺到青莲院的距离	{青莲院=目的poi名称, 金阁寺=出发poi名称}	行程属性
告诉我路易港到猴庙的距离	{路易港=出发poi名称, 猴庙=目的poi名称}	行程属性
告诉我金阁寺到凯旋门的距离	{凯旋门=目的poi名称, 金阁寺=出发poi名称}	行程属性
告诉我路易港到凯旋门的距离	{路易港=出发poi名称, 凯旋门=目的poi名称}	行程属性
告诉我九寨沟到金阁寺的距离	{九寨沟=出发poi名称, 金阁寺=目的poi名称}	行程属性
告诉我大夏宫到金阁寺的距离	{大夏宫=出发poi名称, 金阁寺=目的poi名称}	行程属性
告诉我莱茵河到九寨沟的距离	{莱茵河=出发poi名称, 九寨沟=目的poi名称}	行程属性
告诉我卢浮宫到维多利亚港的距离	{维多利亚港=目的poi名称, 卢浮宫=出发poi名称}	行程属性
告诉我猴庙到金阁寺的距离	{猴庙=出发poi名称, 金阁寺=目的poi名称}	行程属性
告诉我孚日宫到莱茵河的距离	{莱茵河=目的poi名称, 孚日宫=出发poi名称}	行程属性
告诉我多瑙河到卢浮宫的距离	{多瑙河=出发poi名称, 卢浮宫=目的poi名称}	行程属性
告诉我路易港到多瑙河的距离	{多瑙河=目的poi名称, 路易港=出发poi名称}	行程属性
告诉我马穆提岛到迪斯尼的距离	{马穆提岛=出发poi名称, 迪斯尼=目的poi名称}	行程属性
告诉我九寨沟到维多利亚港的距离	{九寨沟=出发poi名称, 维多利亚港=目的poi名称}	行程属性
告诉我大夏宫到日月潭的距离	{日月潭=目的poi名称, 大夏宫=出发poi名称}	行程属性
告诉我青莲院到芬兰堡的距离	{芬兰堡=目的poi名称, 青莲院=出发poi名称}	行程属性
告诉我迪斯尼到密歇根湖的距离	{密歇根湖=目的poi名称, 迪斯尼=出发poi名称}	行程属性
告诉我新加坡河到鼓浪屿的距离	{新加坡河=出发poi名称, 鼓浪屿=目的poi名称}	行程属性
告诉我白沙滩到青莲院的距离	{白沙滩=出发poi名称, 青莲院=目的poi名称}	行程属性
告诉我多瑙河到鼓浪屿的距离	{多瑙河=出发poi名称, 鼓浪屿=目的poi名称}	行程属性
告诉我多瑙河到白沙滩的距离	{白沙滩=目的poi名称, 多瑙河=出发poi名称}	行程属性
告诉我迪斯尼到卢浮宫的距离	{卢浮宫=目的poi名称, 迪斯尼=出发poi名称}	行程属性
告诉我红树到荣军院的距离	{红树=出发poi名称, 荣军院=目的poi名称}	行程属性
告诉我迪士尼到多瑙河的距离	{多瑙河=目的poi名称, 迪士尼=出发poi名称}	行程属性
告诉我新加坡河到日月潭的距离	{日月潭=目的poi名称, 新加坡河=出发poi名称}	行程属性
告诉我九寨沟到鼓浪屿的距离	{九寨沟=出发poi名称, 鼓浪屿=目的poi名称}	行程属性
告诉我白沙滩到玛黑区的距离	{玛黑区=目的poi名称, 白沙滩=出发poi名称}	行程属性
告诉我密歇根湖到九寨沟的距离	{九寨沟=目的poi名称, 密歇根湖=出发poi名称}	行程属性
告诉我金阁寺到密歇根湖的距离	{密歇根湖=目的poi名称, 金阁寺=出发poi名称}	行程属性
告诉我猴庙到鼓浪屿的距离	{鼓浪屿=目的poi名称, 猴庙=出发poi名称}	行程属性
告诉我景福宫到阿尔法玛的距离	{景福宫=出发poi名称, 阿尔法玛=目的poi名称}	行程属性
告诉我维多利亚港到九寨沟的距离	{九寨沟=目的poi名称, 维多利亚港=出发poi名称}	行程属性
告诉我莱茵河到红树的距离	{红树=目的poi名称, 莱茵河=出发poi名称}	行程属性
告诉我芬兰堡到鼓浪屿的距离	{芬兰堡=出发poi名称, 鼓浪屿=目的poi名称}	行程属性
告诉我大夏宫到唐人街的距离	{唐人街=目的poi名称, 大夏宫=出发poi名称}	行程属性
告诉我白沙滩到孚日宫的距离	{孚日宫=目的poi名称, 白沙滩=出发poi名称}	行程属性
告诉我猴庙到凯旋门的距离	{猴庙=出发poi名称, 凯旋门=目的poi名称}	行程属性
告诉我维多利亚港到景福宫的距离	{景福宫=目的poi名称, 维多利亚港=出发poi名称}	行程属性
告诉我莱茵河到荣军院的距离	{莱茵河=出发poi名称, 荣军院=目的poi名称}	行程属性
告诉我大夏宫到维多利亚港的距离	{维多利亚港=目的poi名称, 大夏宫=出发poi名称}	行程属性
告诉我凯旋门到红树的距离	{红树=目的poi名称, 凯旋门=出发poi名称}	行程属性
告诉我鼓浪屿到荣军院的距离	{鼓浪屿=出发poi名称, 荣军院=目的poi名称}	行程属性
告诉我芬兰堡到日月潭的距离	{日月潭=目的poi名称, 芬兰堡=出发poi名称}	行程属性
告诉我玛黑区到卢浮宫的距离	{玛黑区=出发poi名称, 卢浮宫=目的poi名称}	行程属性
告诉我光明寺到莱茵河的距离	{莱茵河=目的poi名称, 光明寺=出发poi名称}	行程属性
告诉我马穆提岛到全聚德的距离	{全聚德=目的poi名称, 马穆提岛=出发poi名称}	行程属性
告诉我密歇根湖到阿尔法玛的距离	{阿尔法玛=目的poi名称, 密歇根湖=出发poi名称}	行程属性
告诉我迪斯尼到日月潭的距离	{日月潭=目的poi名称, 迪斯尼=出发poi名称}	行程属性
告诉我景福宫到迪斯尼的距离	{景福宫=出发poi名称, 迪斯尼=目的poi名称}	行程属性
告诉我青莲院到红树的距离	{红树=目的poi名称, 青莲院=出发poi名称}	行程属性
告诉我九寨沟到托普卡帕宫的距离	{九寨沟=出发poi名称, 托普卡帕宫=目的poi名称}	行程属性
告诉我全聚德到阿尔法玛的距离	{全聚德=出发poi名称, 阿尔法玛=目的poi名称}	行程属性
告诉我猴庙到新加坡河的距离	{新加坡河=目的poi名称, 猴庙=出发poi名称}	行程属性
告诉我凯旋门到新加坡河的距离	{新加坡河=目的poi名称, 凯旋门=出发poi名称}	行程属性
告诉我玛黑区到芬兰堡的距离	{玛黑区=出发poi名称, 芬兰堡=目的poi名称}	行程属性
告诉我唐人街到光明寺的距离	{唐人街=出发poi名称, 光明寺=目的poi名称}	行程属性
告诉我孚日宫到荣军院的距离	{孚日宫=出发poi名称, 荣军院=目的poi名称}	行程属性
告诉我芬兰堡到马穆提岛的距离	{芬兰堡=出发poi名称, 马穆提岛=目的poi名称}	行程属性
告诉我马穆提岛到鼓浪屿的距离	{鼓浪屿=目的poi名称, 马穆提岛=出发poi名称}	行程属性
告诉我维多利亚港到莱茵河的距离	{莱茵河=目的poi名称, 维多利亚港=出发poi名称}	行程属性
告诉我芬兰堡到唐人街的距离	{唐人街=目的poi名称, 芬兰堡=出发poi名称}	行程属性
告诉我鼓浪屿到新加坡河的距离	{新加坡河=目的poi名称, 鼓浪屿=出发poi名称}	行程属性
告诉我景福宫到玛黑区的距离	{玛黑区=目的poi名称, 景福宫=出发poi名称}	行程属性
告诉我密歇根湖到维多利亚港的距离	{维多利亚港=目的poi名称, 密歇根湖=出发poi名称}	行程属性
这里距离唐人街远吗	{唐人街=目的poi名称}	行程属性
这里距离光明寺远吗	{光明寺=目的poi名称}	行程属性
这里距离路易港远吗	{路易港=目的poi名称}	行程属性
这里距离多瑙河远吗	{多瑙河=目的poi名称}	行程属性
这里距离阿尔法玛远吗	{阿尔法玛=目的poi名称}	行程属性
这里距离新加坡河远吗	{新加坡河=目的poi名称}	行程属性
这里距离荣军院远吗	{荣军院=目的poi名称}	行程属性
这里距离凯旋门远吗	{凯旋门=目的poi名称}	行程属性
这里距离全聚德远吗	{全聚德=目的poi名称}	行程属性
这里距离金阁寺远吗	{金阁寺=目的poi名称}	行程属性
这里距离卢浮宫远吗	{卢浮宫=目的poi名称}	行程属性
这里距离九寨沟远吗	{九寨沟=目的poi名称}	行程属性
这里距离玛黑区远吗	{玛黑区=目的poi名称}	行程属性
这里距离密歇根湖远吗	{密歇根湖=目的poi名称}	行程属性
这里距离迪斯尼远吗	{迪斯尼=目的poi名称}	行程属性
这里距离日月潭远吗	{日月潭=目的poi名称}	行程属性
这里距离青莲院远吗	{青莲院=目的poi名称}	行程属性
这里距离大夏宫远吗	{大夏宫=目的poi名称}	行程属性
这里距离鼓浪屿远吗	{鼓浪屿=目的poi名称}	行程属性
这里距离红树远吗	{红树=目的poi名称}	行程属性
这里距离景福宫远吗	{景福宫=目的poi名称}	行程属性
这里距离迪士尼远吗	{迪士尼=目的poi名称}	行程属性
这里距离维多利亚港远吗	{维多利亚港=目的poi名称}	行程属性
这里距离托普卡帕宫远吗	{托普卡帕宫=目的poi名称}	行程属性
这里距离新加坡河近吗	{新加坡河=目的poi名称}	行程属性
这里距离维多利亚港近吗	{维多利亚港=目的poi名称}	行程属性
这里距离芬兰堡近吗	{芬兰堡=目的poi名称}	行程属性
这里距离日月潭近吗	{日月潭=目的poi名称}	行程属性
这里距离青莲院近吗	{青莲院=目的poi名称}	行程属性
这里距离凯旋门近吗	{凯旋门=目的poi名称}	行程属性
这里距离荣军院近吗	{荣军院=目的poi名称}	行程属性
这里距离路易港近吗	{路易港=目的poi名称}	行程属性
这里距离白沙滩近吗	{白沙滩=目的poi名称}	行程属性
这里距离孚日宫近吗	{孚日宫=目的poi名称}	行程属性
这里距离莱茵河近吗	{莱茵河=目的poi名称}	行程属性
这里距离马穆提岛近吗	{马穆提岛=目的poi名称}	行程属性
这里距离大夏宫近吗	{大夏宫=目的poi名称}	行程属性
这里距离九寨沟近吗	{九寨沟=目的poi名称}	行程属性
这里距离光明寺近吗	{光明寺=目的poi名称}	行程属性
这里距离景福宫近吗	{景福宫=目的poi名称}	行程属性
这里距离密歇根湖近吗	{密歇根湖=目的poi名称}	行程属性
这里距离金阁寺近吗	{金阁寺=目的poi名称}	行程属性
这里距离阿尔法玛近吗	{阿尔法玛=目的poi名称}	行程属性
这里距离多瑙河近吗	{多瑙河=目的poi名称}	行程属性
这里距离玛黑区近吗	{玛黑区=目的poi名称}	行程属性
这里距离卢浮宫近吗	{卢浮宫=目的poi名称}	行程属性
这里到莱茵河的距离是多少	{莱茵河=目的poi名称}	行程属性
这里到维港的距离是多少	{维港=目的poi名称}	行程属性
这里到多瑙河的距离是多少	{多瑙河=目的poi名称}	行程属性
这里到阿尔法玛的距离是多少	{阿尔法玛=目的poi名称}	行程属性
这里到新加坡河的距离是多少	{新加坡河=目的poi名称}	行程属性
这里到金阁寺的距离是多少	{金阁寺=目的poi名称}	行程属性
这里到路易港的距离是多少	{路易港=目的poi名称}	行程属性
这里到红树的距离是多少	{红树=目的poi名称}	行程属性
这里到唐人街的距离是多少	{唐人街=目的poi名称}	行程属性
这里到卢浮宫的距离是多少	{卢浮宫=目的poi名称}	行程属性
这里到马穆提岛的距离是多少	{马穆提岛=目的poi名称}	行程属性
这里到九寨沟的距离是多少	{九寨沟=目的poi名称}	行程属性
这里到迪斯尼的距离是多少	{迪斯尼=目的poi名称}	行程属性
这里到日月潭的距离是多少	{日月潭=目的poi名称}	行程属性
这里到光明寺的距离是多少	{光明寺=目的poi名称}	行程属性
这里到白沙滩的距离是多少	{白沙滩=目的poi名称}	行程属性
这里到荣军院的距离是多少	{荣军院=目的poi名称}	行程属性
这里到鼓浪屿的距离是多少	{鼓浪屿=目的poi名称}	行程属性
这里到大夏宫的距离是多少	{大夏宫=目的poi名称}	行程属性
这里到景福宫的距离是多少	{景福宫=目的poi名称}	行程属性
这里到凯旋门的距离是多少	{凯旋门=目的poi名称}	行程属性
这里到维多利亚港的距离是多少	{维多利亚港=目的poi名称}	行程属性
这里到全聚德的距离是多少	{全聚德=目的poi名称}	行程属性
这里到玛黑区的距离是多少	{玛黑区=目的poi名称}	行程属性
这里到托普卡帕宫的距离是多少	{托普卡帕宫=目的poi名称}	行程属性
莱茵河离荣军院多远	{莱茵河=出发poi名称, 荣军院=目的poi名称}	行程属性
红树离猴庙多远	{红树=出发poi名称, 猴庙=目的poi名称}	行程属性
密歇根湖离迪斯尼多远	{密歇根湖=出发poi名称, 迪斯尼=目的poi名称}	行程属性
迪士尼离卢浮宫多远	{卢浮宫=目的poi名称, 迪士尼=出发poi名称}	行程属性
猴庙离迪斯尼多远	{猴庙=出发poi名称, 迪斯尼=目的poi名称}	行程属性
迪斯尼离光明寺多远	{光明寺=目的poi名称, 迪斯尼=出发poi名称}	行程属性
莱茵河离密歇根湖多远	{莱茵河=出发poi名称, 密歇根湖=目的poi名称}	行程属性
猴庙离金阁寺多远	{猴庙=出发poi名称, 金阁寺=目的poi名称}	行程属性
托普卡帕宫离路易港多远	{路易港=目的poi名称, 托普卡帕宫=出发poi名称}	行程属性
金阁寺离迪斯尼多远	{金阁寺=出发poi名称, 迪斯尼=目的poi名称}	行程属性
迪士尼离红树多远	{红树=目的poi名称, 迪士尼=出发poi名称}	行程属性
日月潭离凯旋门多远	{日月潭=出发poi名称, 凯旋门=目的poi名称}	行程属性
红树离迪士尼多远	{红树=出发poi名称, 迪士尼=目的poi名称}	行程属性
马穆提岛离玛黑区多远	{玛黑区=目的poi名称, 马穆提岛=出发poi名称}	行程属性
凯旋门离鼓浪屿多远	{鼓浪屿=目的poi名称, 凯旋门=出发poi名称}	行程属性
阿尔法玛离路易港多远	{阿尔法玛=出发poi名称, 路易港=目的poi名称}	行程属性
青莲院离路易港多远	{青莲院=出发poi名称, 路易港=目的poi名称}	行程属性
唐人街离卢浮宫多远	{唐人街=出发poi名称, 卢浮宫=目的poi名称}	行程属性
迪士尼离荣军院多远	{迪士尼=出发poi名称, 荣军院=目的poi名称}	行程属性
唐人街离阿尔法玛多远	{唐人街=出发poi名称, 阿尔法玛=目的poi名称}	行程属性
景福宫离维多利亚港多远	{景福宫=出发poi名称, 维多利亚港=目的poi名称}	行程属性
凯旋门离唐人街多远	{唐人街=目的poi名称, 凯旋门=出发poi名称}	行程属性
迪士尼离维多利亚港多远	{维多利亚港=目的poi名称, 迪士尼=出发poi名称}	行程属性
卢浮宫离孚日宫多远	{孚日宫=目的poi名称, 卢浮宫=出发poi名称}	行程属性
荣军院离猴庙多远	{猴庙=目的poi名称, 荣军院=出发poi名称}	行程属性
卢浮宫离密歇根湖多远	{卢浮宫=出发poi名称, 密歇根湖=目的poi名称}	行程属性
光明寺离金阁寺多远	{光明寺=出发poi名称, 金阁寺=目的poi名称}	行程属性
马穆提岛离密歇根湖多远	{密歇根湖=目的poi名称, 马穆提岛=出发poi名称}	行程属性
猴庙离孚日宫多远	{孚日宫=目的poi名称, 猴庙=出发poi名称}	行程属性
金阁寺离景福宫多远	{景福宫=目的poi名称, 金阁寺=出发poi名称}	行程属性
白沙滩离多瑙河多远	{白沙滩=出发poi名称, 多瑙河=目的poi名称}	行程属性
荣军院离光明寺多远	{光明寺=目的poi名称, 荣军院=出发poi名称}	行程属性
唐人街离密歇根湖多远	{唐人街=出发poi名称, 密歇根湖=目的poi名称}	行程属性
金阁寺离玛黑区多远	{玛黑区=目的poi名称, 金阁寺=出发poi名称}	行程属性
孚日宫离猴庙多远	{孚日宫=出发poi名称, 猴庙=目的poi名称}	行程属性
孚日宫离玛黑区多远	{玛黑区=目的poi名称, 孚日宫=出发poi名称}	行程属性
红树离全聚德多远	{红树=出发poi名称, 全聚德=目的poi名称}	行程属性
新加坡河离九寨沟多远	{九寨沟=目的poi名称, 新加坡河=出发poi名称}	行程属性
孚日宫离金阁寺多远	{孚日宫=出发poi名称, 金阁寺=目的poi名称}	行程属性
阿尔法玛离金阁寺多远	{阿尔法玛=出发poi名称, 金阁寺=目的poi名称}	行程属性
光明寺离猴庙多远	{光明寺=出发poi名称, 猴庙=目的poi名称}	行程属性
玛黑区离金阁寺多远	{玛黑区=出发poi名称, 金阁寺=目的poi名称}	行程属性
马穆提岛离新加坡河多远	{新加坡河=目的poi名称, 马穆提岛=出发poi名称}	行程属性
玛黑区离猴庙多远	{玛黑区=出发poi名称, 猴庙=目的poi名称}	行程属性
阿尔法玛离维多利亚港多远	{维多利亚港=目的poi名称, 阿尔法玛=出发poi名称}	行程属性
迪士尼离莱茵河多远	{莱茵河=目的poi名称, 迪士尼=出发poi名称}	行程属性
大夏宫离唐人街多远	{唐人街=目的poi名称, 大夏宫=出发poi名称}	行程属性
维港离青莲院多远	{维港=出发poi名称, 青莲院=目的poi名称}	行程属性
玛黑区离卢浮宫多远	{玛黑区=出发poi名称, 卢浮宫=目的poi名称}	行程属性
荣军院离孚日宫多远	{孚日宫=目的poi名称, 荣军院=出发poi名称}	行程属性
九寨沟离玛黑区多远	{玛黑区=目的poi名称, 九寨沟=出发poi名称}	行程属性
青莲院离景福宫多远	{景福宫=目的poi名称, 青莲院=出发poi名称}	行程属性
孚日宫离迪斯尼多远	{孚日宫=出发poi名称, 迪斯尼=目的poi名称}	行程属性
迪斯尼离路易港多远	{路易港=目的poi名称, 迪斯尼=出发poi名称}	行程属性
新加坡河离维多利亚港多远	{维多利亚港=目的poi名称, 新加坡河=出发poi名称}	行程属性
日月潭离猴庙多远	{日月潭=出发poi名称, 猴庙=目的poi名称}	行程属性
路易港离迪士尼多远	{路易港=出发poi名称, 迪士尼=目的poi名称}	行程属性
路易港离新加坡河多远	{新加坡河=目的poi名称, 路易港=出发poi名称}	行程属性
荣军院离唐人街多远	{唐人街=目的poi名称, 荣军院=出发poi名称}	行程属性
荣军院离迪斯尼多远	{荣军院=出发poi名称, 迪斯尼=目的poi名称}	行程属性
玛黑区离阿尔法玛多远	{玛黑区=出发poi名称, 阿尔法玛=目的poi名称}	行程属性
红树离阿尔法玛多远	{红树=出发poi名称, 阿尔法玛=目的poi名称}	行程属性
阿尔法玛离红树多远	{红树=目的poi名称, 阿尔法玛=出发poi名称}	行程属性
莱茵河离猴庙多远	{莱茵河=出发poi名称, 猴庙=目的poi名称}	行程属性
卢浮宫离维港多远	{维港=目的poi名称, 卢浮宫=出发poi名称}	行程属性
孚日宫离芬兰堡多远	{孚日宫=出发poi名称, 芬兰堡=目的poi名称}	行程属性
迪士尼离迪斯尼多远	{迪士尼=出发poi名称, 迪斯尼=目的poi名称}	行程属性
红树离日月潭多远	{红树=出发poi名称, 日月潭=目的poi名称}	行程属性
托普卡帕宫离全聚德多远	{全聚德=目的poi名称, 托普卡帕宫=出发poi名称}	行程属性
密歇根湖离金阁寺多远	{密歇根湖=出发poi名称, 金阁寺=目的poi名称}	行程属性
大夏宫离芬兰堡多远	{芬兰堡=目的poi名称, 大夏宫=出发poi名称}	行程属性
大夏宫离卢浮宫多远	{卢浮宫=目的poi名称, 大夏宫=出发poi名称}	行程属性
迪斯尼离全聚德多远	{全聚德=目的poi名称, 迪斯尼=出发poi名称}	行程属性
景福宫离新加坡河多远	{景福宫=出发poi名称, 新加坡河=目的poi名称}	行程属性
路易港离密歇根湖多远	{密歇根湖=目的poi名称, 路易港=出发poi名称}	行程属性
玛黑区离托普卡帕宫多远	{玛黑区=出发poi名称, 托普卡帕宫=目的poi名称}	行程属性
密歇根湖离维港多远	{维港=目的poi名称, 密歇根湖=出发poi名称}	行程属性
新加坡河离青莲院多远	{新加坡河=出发poi名称, 青莲院=目的poi名称}	行程属性
猴庙离荣军院多远	{猴庙=出发poi名称, 荣军院=目的poi名称}	行程属性
荣军院离景福宫多远	{景福宫=目的poi名称, 荣军院=出发poi名称}	行程属性
卢浮宫离莱茵河多远	{莱茵河=目的poi名称, 卢浮宫=出发poi名称}	行程属性
鼓浪屿离猴庙多远	{鼓浪屿=出发poi名称, 猴庙=目的poi名称}	行程属性
唐人街离猴庙多远	{唐人街=出发poi名称, 猴庙=目的poi名称}	行程属性
红树离孚日宫多远	{红树=出发poi名称, 孚日宫=目的poi名称}	行程属性
青莲院离维港多远	{维港=目的poi名称, 青莲院=出发poi名称}	行程属性
全聚德离青莲院多远	{全聚德=出发poi名称, 青莲院=目的poi名称}	行程属性
多瑙河离全聚德多远	{全聚德=目的poi名称, 多瑙河=出发poi名称}	行程属性
大夏宫离荣军院多远	{大夏宫=出发poi名称, 荣军院=目的poi名称}	行程属性
维多利亚港离荣军院多远	{维多利亚港=出发poi名称, 荣军院=目的poi名称}	行程属性
多瑙河离唐人街多远	{唐人街=目的poi名称, 多瑙河=出发poi名称}	行程属性
红树离托普卡帕宫多远	{红树=出发poi名称, 托普卡帕宫=目的poi名称}	行程属性
金阁寺离莱茵河多远	{莱茵河=目的poi名称, 金阁寺=出发poi名称}	行程属性
金阁寺离日月潭多远	{日月潭=目的poi名称, 金阁寺=出发poi名称}	行程属性
莱茵河离日月潭多远	{莱茵河=出发poi名称, 日月潭=目的poi名称}	行程属性
青莲院离大夏宫多远	{青莲院=出发poi名称, 大夏宫=目的poi名称}	行程属性
猴庙离光明寺多远	{光明寺=目的poi名称, 猴庙=出发poi名称}	行程属性
凯旋门离阿尔法玛多远	{阿尔法玛=目的poi名称, 凯旋门=出发poi名称}	行程属性
白沙滩离芬兰堡多远	{白沙滩=出发poi名称, 芬兰堡=目的poi名称}	行程属性
多瑙河离九寨沟多远	{九寨沟=目的poi名称, 多瑙河=出发poi名称}	行程属性
卢浮宫离青莲院多远	{卢浮宫=出发poi名称, 青莲院=目的poi名称}	行程属性
从这里地铁到全聚德需要多少钱	{全聚德=目的poi名称, 地铁=交通方式}	行程属性
从这里大巴车到芬兰堡需要多少钱	{大巴车=交通方式, 芬兰堡=目的poi名称}	行程属性
从这里火车到多瑙河需要多少钱	{火车=交通方式, 多瑙河=目的poi名称}	行程属性
从这里火车到阿尔法玛需要多少钱	{火车=交通方式, 阿尔法玛=目的poi名称}	行程属性
从这里飞机到全聚德需要多少钱	{全聚德=目的poi名称, 飞机=交通方式}	行程属性
从这里火车到凯旋门需要多少钱	{火车=交通方式, 凯旋门=目的poi名称}	行程属性
从这里飞机到青莲院需要多少钱	{青莲院=目的poi名称, 飞机=交通方式}	行程属性
从这里大巴车到密歇根湖需要多少钱	{大巴车=交通方式, 密歇根湖=目的poi名称}	行程属性
从这里火车到芬兰堡需要多少钱	{火车=交通方式, 芬兰堡=目的poi名称}	行程属性
从这里大巴车到莱茵河需要多少钱	{莱茵河=目的poi名称, 大巴车=交通方式}	行程属性
从这里飞机到路易港需要多少钱	{路易港=目的poi名称, 飞机=交通方式}	行程属性
从这里飞机到景福宫需要多少钱	{景福宫=目的poi名称, 飞机=交通方式}	行程属性
从这里飞机到新加坡河需要多少钱	{新加坡河=目的poi名称, 飞机=交通方式}	行程属性
从这里飞机到密歇根湖需要多少钱	{密歇根湖=目的poi名称, 飞机=交通方式}	行程属性
从这里飞机到孚日宫需要多少钱	{孚日宫=目的poi名称, 飞机=交通方式}	行程属性
从这里地铁到大夏宫需要多少钱	{地铁=交通方式, 大夏宫=目的poi名称}	行程属性
从这里火车到景福宫需要多少钱	{景福宫=目的poi名称, 火车=交通方式}	行程属性
从这里飞机到红树需要多少钱	{红树=目的poi名称, 飞机=交通方式}	行程属性
从这里地铁到荣军院需要多少钱	{地铁=交通方式, 荣军院=目的poi名称}	行程属性
从这里地铁到托普卡帕宫需要多少钱	{地铁=交通方式, 托普卡帕宫=目的poi名称}	行程属性
从这里地铁到日月潭需要多少钱	{日月潭=目的poi名称, 地铁=交通方式}	行程属性
从这里地铁到维多利亚港需要多少钱	{维多利亚港=目的poi名称, 地铁=交通方式}	行程属性
从这里大巴车到唐人街需要多少钱	{大巴车=交通方式, 唐人街=目的poi名称}	行程属性
从这里飞机到凯旋门需要多少钱	{凯旋门=目的poi名称, 飞机=交通方式}	行程属性
从这里地铁到青莲院需要多少钱	{地铁=交通方式, 青莲院=目的poi名称}	行程属性
从这里大巴车到阿尔法玛需要多少钱	{大巴车=交通方式, 阿尔法玛=目的poi名称}	行程属性
从这里大巴车到白沙滩需要多少钱	{大巴车=交通方式, 白沙滩=目的poi名称}	行程属性
从这里火车到孚日宫需要多少钱	{孚日宫=目的poi名称, 火车=交通方式}	行程属性
从这里火车到迪斯尼需要多少钱	{火车=交通方式, 迪斯尼=目的poi名称}	行程属性
从这里飞机到唐人街需要多少钱	{唐人街=目的poi名称, 飞机=交通方式}	行程属性
从这里大巴车到维港需要多少钱	{大巴车=交通方式, 维港=目的poi名称}	行程属性
从这里火车到唐人街需要多少钱	{唐人街=目的poi名称, 火车=交通方式}	行程属性
从这里火车到全聚德需要多少钱	{全聚德=目的poi名称, 火车=交通方式}	行程属性
从这里大巴车到猴庙需要多少钱	{大巴车=交通方式, 猴庙=目的poi名称}	行程属性
从这里飞机到维港需要多少钱	{维港=目的poi名称, 飞机=交通方式}	行程属性
从这里火车到路易港需要多少钱	{火车=交通方式, 路易港=目的poi名称}	行程属性
从这里飞机到九寨沟需要多少钱	{九寨沟=目的poi名称, 飞机=交通方式}	行程属性
从这里大巴车到马穆提岛需要多少钱	{大巴车=交通方式, 马穆提岛=目的poi名称}	行程属性
从这里地铁到凯旋门需要多少钱	{地铁=交通方式, 凯旋门=目的poi名称}	行程属性
从这里火车到鼓浪屿需要多少钱	{火车=交通方式, 鼓浪屿=目的poi名称}	行程属性
从这里大巴车到鼓浪屿需要多少钱	{大巴车=交通方式, 鼓浪屿=目的poi名称}	行程属性
从这里火车到新加坡河需要多少钱	{火车=交通方式, 新加坡河=目的poi名称}	行程属性
从这里大巴车到荣军院需要多少钱	{大巴车=交通方式, 荣军院=目的poi名称}	行程属性
从这里大巴车到孚日宫需要多少钱	{大巴车=交通方式, 孚日宫=目的poi名称}	行程属性
从这里火车到马穆提岛需要多少钱	{火车=交通方式, 马穆提岛=目的poi名称}	行程属性
从这里大巴车到玛黑区需要多少钱	{玛黑区=目的poi名称, 大巴车=交通方式}	行程属性
从这里飞机到芬兰堡需要多少钱	{芬兰堡=目的poi名称, 飞机=交通方式}	行程属性
从这里飞机到金阁寺需要多少钱	{飞机=交通方式, 金阁寺=目的poi名称}	行程属性
从这里飞机到多瑙河需要多少钱	{多瑙河=目的poi名称, 飞机=交通方式}	行程属性
从这里飞机到托普卡帕宫需要多少钱	{托普卡帕宫=目的poi名称, 飞机=交通方式}	行程属性
从这里地铁到新加坡河需要多少钱	{新加坡河=目的poi名称, 地铁=交通方式}	行程属性
从这里大巴车到景福宫需要多少钱	{大巴车=交通方式, 景福宫=目的poi名称}	行程属性
从这里地铁到玛黑区需要多少钱	{玛黑区=目的poi名称, 地铁=交通方式}	行程属性
从这里大巴车到日月潭需要多少钱	{日月潭=目的poi名称, 大巴车=交通方式}	行程属性
从这里火车到青莲院需要多少钱	{火车=交通方式, 青莲院=目的poi名称}	行程属性
从这里地铁到红树需要多少钱	{红树=目的poi名称, 地铁=交通方式}	行程属性
从这里飞机到莱茵河需要多少钱	{莱茵河=目的poi名称, 飞机=交通方式}	行程属性
从这里飞机到光明寺需要多少钱	{光明寺=目的poi名称, 飞机=交通方式}	行程属性
从这里火车到白沙滩需要多少钱	{火车=交通方式, 白沙滩=目的poi名称}	行程属性
从这里地铁到维港需要多少钱	{维港=目的poi名称, 地铁=交通方式}	行程属性
从这里地铁到芬兰堡需要多少钱	{芬兰堡=目的poi名称, 地铁=交通方式}	行程属性
从这里火车到红树需要多少钱	{红树=目的poi名称, 火车=交通方式}	行程属性
从这里飞机到卢浮宫需要多少钱	{卢浮宫=目的poi名称, 飞机=交通方式}	行程属性
从这里火车到日月潭需要多少钱	{日月潭=目的poi名称, 火车=交通方式}	行程属性
从这里大巴车到多瑙河需要多少钱	{大巴车=交通方式, 多瑙河=目的poi名称}	行程属性
从这里火车到卢浮宫需要多少钱	{火车=交通方式, 卢浮宫=目的poi名称}	行程属性
从这里飞机到维多利亚港需要多少钱	{维多利亚港=目的poi名称, 飞机=交通方式}	行程属性
从这里地铁到景福宫需要多少钱	{景福宫=目的poi名称, 地铁=交通方式}	行程属性
从这里火车到玛黑区需要多少钱	{玛黑区=目的poi名称, 火车=交通方式}	行程属性
从这里地铁到马穆提岛需要多少钱	{地铁=交通方式, 马穆提岛=目的poi名称}	行程属性
从这里大巴车到红树需要多少钱	{红树=目的poi名称, 大巴车=交通方式}	行程属性
从这里大巴车到托普卡帕宫需要多少钱	{大巴车=交通方式, 托普卡帕宫=目的poi名称}	行程属性
从这里火车到大夏宫需要多少钱	{火车=交通方式, 大夏宫=目的poi名称}	行程属性
从这里大巴车到青莲院需要多少钱	{大巴车=交通方式, 青莲院=目的poi名称}	行程属性
从这里火车到光明寺需要多少钱	{火车=交通方式, 光明寺=目的poi名称}	行程属性
从这里火车到金阁寺需要多少钱	{火车=交通方式, 金阁寺=目的poi名称}	行程属性
从这里大巴车到迪士尼需要多少钱	{大巴车=交通方式, 迪士尼=目的poi名称}	行程属性
从这里火车到密歇根湖需要多少钱	{火车=交通方式, 密歇根湖=目的poi名称}	行程属性
从这里飞机到白沙滩需要多少钱	{白沙滩=目的poi名称, 飞机=交通方式}	行程属性
从这里地铁到唐人街需要多少钱	{唐人街=目的poi名称, 地铁=交通方式}	行程属性
从这里地铁到卢浮宫需要多少钱	{卢浮宫=目的poi名称, 地铁=交通方式}	行程属性
从这里地铁到迪士尼需要多少钱	{地铁=交通方式, 迪士尼=目的poi名称}	行程属性
从这里地铁到猴庙需要多少钱	{地铁=交通方式, 猴庙=目的poi名称}	行程属性
从这儿大巴车到鼓浪屿大概要花多少钱	{大巴车=交通方式, 鼓浪屿=目的poi名称}	行程属性
从这儿大巴车到全聚德大概要花多少钱	{大巴车=交通方式, 全聚德=目的poi名称}	行程属性
从这儿大巴车到红树大概要花多少钱	{红树=目的poi名称, 大巴车=交通方式}	行程属性
从这儿飞机到鼓浪屿大概要花多少钱	{鼓浪屿=目的poi名称, 飞机=交通方式}	行程属性
从这儿地铁到新加坡河大概要花多少钱	{新加坡河=目的poi名称, 地铁=交通方式}	行程属性
从这儿地铁到景福宫大概要花多少钱	{景福宫=目的poi名称, 地铁=交通方式}	行程属性
从这儿大巴车到阿尔法玛大概要花多少钱	{大巴车=交通方式, 阿尔法玛=目的poi名称}	行程属性
从这儿地铁到全聚德大概要花多少钱	{全聚德=目的poi名称, 地铁=交通方式}	行程属性
从这儿飞机到玛黑区大概要花多少钱	{玛黑区=目的poi名称, 飞机=交通方式}	行程属性
从这儿飞机到大夏宫大概要花多少钱	{大夏宫=目的poi名称, 飞机=交通方式}	行程属性
从这儿大巴车到托普卡帕宫大概要花多少钱	{大巴车=交通方式, 托普卡帕宫=目的poi名称}	行程属性
从这儿火车到光明寺大概要花多少钱	{火车=交通方式, 光明寺=目的poi名称}	行程属性
从这儿地铁到凯旋门大概要花多少钱	{地铁=交通方式, 凯旋门=目的poi名称}	行程属性
从这儿火车到九寨沟大概要花多少钱	{火车=交通方式, 九寨沟=目的poi名称}	行程属性
从这儿飞机到金阁寺大概要花多少钱	{飞机=交通方式, 金阁寺=目的poi名称}	行程属性
从这儿火车到玛黑区大概要花多少钱	{玛黑区=目的poi名称, 火车=交通方式}	行程属性
从这儿大巴车到光明寺大概要花多少钱	{大巴车=交通方式, 光明寺=目的poi名称}	行程属性
从这儿大巴车到芬兰堡大概要花多少钱	{大巴车=交通方式, 芬兰堡=目的poi名称}	行程属性
从这儿地铁到玛黑区大概要花多少钱	{玛黑区=目的poi名称, 地铁=交通方式}	行程属性
从这儿飞机到唐人街大概要花多少钱	{唐人街=目的poi名称, 飞机=交通方式}	行程属性
从这儿火车到莱茵河大概要花多少钱	{莱茵河=目的poi名称, 火车=交通方式}	行程属性
从这儿火车到维多利亚港大概要花多少钱	{火车=交通方式, 维多利亚港=目的poi名称}	行程属性
从这儿地铁到青莲院大概要花多少钱	{地铁=交通方式, 青莲院=目的poi名称}	行程属性
从这儿地铁到迪士尼大概要花多少钱	{地铁=交通方式, 迪士尼=目的poi名称}	行程属性
从这儿地铁到维多利亚港大概要花多少钱	{维多利亚港=目的poi名称, 地铁=交通方式}	行程属性
从这儿飞机到马穆提岛大概要花多少钱	{马穆提岛=目的poi名称, 飞机=交通方式}	行程属性
从这儿飞机到猴庙大概要花多少钱	{猴庙=目的poi名称, 飞机=交通方式}	行程属性
从这儿火车到金阁寺大概要花多少钱	{火车=交通方式, 金阁寺=目的poi名称}	行程属性
从这儿大巴车到密歇根湖大概要花多少钱	{大巴车=交通方式, 密歇根湖=目的poi名称}	行程属性
从这儿飞机到芬兰堡大概要花多少钱	{芬兰堡=目的poi名称, 飞机=交通方式}	行程属性
从这儿地铁到芬兰堡大概要花多少钱	{芬兰堡=目的poi名称, 地铁=交通方式}	行程属性
从这儿地铁到多瑙河大概要花多少钱	{多瑙河=目的poi名称, 地铁=交通方式}	行程属性
从这儿大巴车到金阁寺大概要花多少钱	{大巴车=交通方式, 金阁寺=目的poi名称}	行程属性
从这儿地铁到密歇根湖大概要花多少钱	{密歇根湖=目的poi名称, 地铁=交通方式}	行程属性
从这儿大巴车到维多利亚港大概要花多少钱	{大巴车=交通方式, 维多利亚港=目的poi名称}	行程属性
从这儿飞机到白沙滩大概要花多少钱	{白沙滩=目的poi名称, 飞机=交通方式}	行程属性
从这儿飞机到多瑙河大概要花多少钱	{多瑙河=目的poi名称, 飞机=交通方式}	行程属性
从这儿火车到日月潭大概要花多少钱	{日月潭=目的poi名称, 火车=交通方式}	行程属性
从这儿飞机到光明寺大概要花多少钱	{光明寺=目的poi名称, 飞机=交通方式}	行程属性
从这儿火车到阿尔法玛大概要花多少钱	{火车=交通方式, 阿尔法玛=目的poi名称}	行程属性
从这儿火车到景福宫大概要花多少钱	{景福宫=目的poi名称, 火车=交通方式}	行程属性
从这儿地铁到卢浮宫大概要花多少钱	{卢浮宫=目的poi名称, 地铁=交通方式}	行程属性
从这儿大巴车到路易港大概要花多少钱	{大巴车=交通方式, 路易港=目的poi名称}	行程属性
从这儿地铁到路易港大概要花多少钱	{地铁=交通方式, 路易港=目的poi名称}	行程属性
从这儿飞机到凯旋门大概要花多少钱	{凯旋门=目的poi名称, 飞机=交通方式}	行程属性
从这儿火车到路易港大概要花多少钱	{火车=交通方式, 路易港=目的poi名称}	行程属性
从这儿火车到白沙滩大概要花多少钱	{火车=交通方式, 白沙滩=目的poi名称}	行程属性
从这儿飞机到密歇根湖大概要花多少钱	{密歇根湖=目的poi名称, 飞机=交通方式}	行程属性
从这儿飞机到青莲院大概要花多少钱	{青莲院=目的poi名称, 飞机=交通方式}	行程属性
从这儿飞机到托普卡帕宫大概要花多少钱	{托普卡帕宫=目的poi名称, 飞机=交通方式}	行程属性
从这儿火车到密歇根湖大概要花多少钱	{火车=交通方式, 密歇根湖=目的poi名称}	行程属性
从这儿大巴车到维港大概要花多少钱	{大巴车=交通方式, 维港=目的poi名称}	行程属性
从这儿地铁到马穆提岛大概要花多少钱	{地铁=交通方式, 马穆提岛=目的poi名称}	行程属性
从这儿飞机到孚日宫大概要花多少钱	{孚日宫=目的poi名称, 飞机=交通方式}	行程属性
从这儿地铁到光明寺大概要花多少钱	{光明寺=目的poi名称, 地铁=交通方式}	行程属性
从这儿飞机到维多利亚港大概要花多少钱	{维多利亚港=目的poi名称, 飞机=交通方式}	行程属性
从这儿大巴车到迪士尼大概要花多少钱	{大巴车=交通方式, 迪士尼=目的poi名称}	行程属性
从这儿大巴车到莱茵河大概要花多少钱	{莱茵河=目的poi名称, 大巴车=交通方式}	行程属性
从这儿地铁到红树大概要花多少钱	{红树=目的poi名称, 地铁=交通方式}	行程属性
从这儿火车到托普卡帕宫大概要花多少钱	{火车=交通方式, 托普卡帕宫=目的poi名称}	行程属性
从这儿大巴车到玛黑区大概要花多少钱	{玛黑区=目的poi名称, 大巴车=交通方式}	行程属性
从这儿地铁到莱茵河大概要花多少钱	{莱茵河=目的poi名称, 地铁=交通方式}	行程属性
从这儿火车到凯旋门大概要花多少钱	{火车=交通方式, 凯旋门=目的poi名称}	行程属性
从这儿火车到鼓浪屿大概要花多少钱	{火车=交通方式, 鼓浪屿=目的poi名称}	行程属性
从这儿火车到迪士尼大概要花多少钱	{火车=交通方式, 迪士尼=目的poi名称}	行程属性
从这儿地铁到白沙滩大概要花多少钱	{白沙滩=目的poi名称, 地铁=交通方式}	行程属性
从这儿大巴车到唐人街大概要花多少钱	{大巴车=交通方式, 唐人街=目的poi名称}	行程属性
从这儿地铁到猴庙大概要花多少钱	{地铁=交通方式, 猴庙=目的poi名称}	行程属性
从这儿地铁到九寨沟大概要花多少钱	{九寨沟=目的poi名称, 地铁=交通方式}	行程属性
从这儿地铁到大夏宫大概要花多少钱	{地铁=交通方式, 大夏宫=目的poi名称}	行程属性
从这儿飞机到卢浮宫大概要花多少钱	{卢浮宫=目的poi名称, 飞机=交通方式}	行程属性
从这儿地铁到日月潭大概要花多少钱	{日月潭=目的poi名称, 地铁=交通方式}	行程属性
从这儿火车到维港大概要花多少钱	{维港=目的poi名称, 火车=交通方式}	行程属性
从这里大巴车到维多利亚港贵吗	{大巴车=交通方式, 维多利亚港=目的poi名称}	行程属性
从这里大巴车到鼓浪屿贵吗	{大巴车=交通方式, 鼓浪屿=目的poi名称}	行程属性
从这里飞机到卢浮宫贵吗	{卢浮宫=目的poi名称, 飞机=交通方式}	行程属性
从这里飞机到青莲院贵吗	{青莲院=目的poi名称, 飞机=交通方式}	行程属性
从这里地铁到日月潭贵吗	{日月潭=目的poi名称, 地铁=交通方式}	行程属性
从这里地铁到托普卡帕宫贵吗	{地铁=交通方式, 托普卡帕宫=目的poi名称}	行程属性
从这里火车到玛黑区贵吗	{玛黑区=目的poi名称, 火车=交通方式}	行程属性
从这里大巴车到全聚德贵吗	{大巴车=交通方式, 全聚德=目的poi名称}	行程属性
从这里火车到多瑙河贵吗	{火车=交通方式, 多瑙河=目的poi名称}	行程属性
从这里飞机到孚日宫贵吗	{孚日宫=目的poi名称, 飞机=交通方式}	行程属性
从这里飞机到阿尔法玛贵吗	{阿尔法玛=目的poi名称, 飞机=交通方式}	行程属性
从这里大巴车到密歇根湖贵吗	{大巴车=交通方式, 密歇根湖=目的poi名称}	行程属性
从这里火车到白沙滩贵吗	{火车=交通方式, 白沙滩=目的poi名称}	行程属性
从这里地铁到密歇根湖贵吗	{密歇根湖=目的poi名称, 地铁=交通方式}	行程属性
从这里火车到荣军院贵吗	{火车=交通方式, 荣军院=目的poi名称}	行程属性
从这里大巴车到迪士尼贵吗	{大巴车=交通方式, 迪士尼=目的poi名称}	行程属性
从这里火车到景福宫贵吗	{景福宫=目的poi名称, 火车=交通方式}	行程属性
从这里飞机到玛黑区贵吗	{玛黑区=目的poi名称, 飞机=交通方式}	行程属性
从这里大巴车到托普卡帕宫贵吗	{大巴车=交通方式, 托普卡帕宫=目的poi名称}	行程属性
从这里飞机到九寨沟贵吗	{九寨沟=目的poi名称, 飞机=交通方式}	行程属性
从这里火车到新加坡河贵吗	{火车=交通方式, 新加坡河=目的poi名称}	行程属性
从这里地铁到光明寺贵吗	{光明寺=目的poi名称, 地铁=交通方式}	行程属性
从这里飞机到大夏宫贵吗	{大夏宫=目的poi名称, 飞机=交通方式}	行程属性
从这里地铁到荣军院贵吗	{地铁=交通方式, 荣军院=目的poi名称}	行程属性
从这里飞机到维多利亚港贵吗	{维多利亚港=目的poi名称, 飞机=交通方式}	行程属性
从这里飞机到全聚德贵吗	{全聚德=目的poi名称, 飞机=交通方式}	行程属性
从这里飞机到红树贵吗	{红树=目的poi名称, 飞机=交通方式}	行程属性
从这里大巴车到路易港贵吗	{大巴车=交通方式, 路易港=目的poi名称}	行程属性
从这里地铁到马穆提岛贵吗	{地铁=交通方式, 马穆提岛=目的poi名称}	行程属性
从这里火车到迪士尼贵吗	{火车=交通方式, 迪士尼=目的poi名称}	行程属性
从这里火车到卢浮宫贵吗	{火车=交通方式, 卢浮宫=目的poi名称}	行程属性
从这里火车到维多利亚港贵吗	{火车=交通方式, 维多利亚港=目的poi名称}	行程属性
从这里地铁到多瑙河贵吗	{多瑙河=目的poi名称, 地铁=交通方式}	行程属性
从这里大巴车到孚日宫贵吗	{大巴车=交通方式, 孚日宫=目的poi名称}	行程属性
从这里大巴车到凯旋门贵吗	{大巴车=交通方式, 凯旋门=目的poi名称}	行程属性
从这里地铁到大夏宫贵吗	{地铁=交通方式, 大夏宫=目的poi名称}	行程属性
从这里火车到孚日宫贵吗	{孚日宫=目的poi名称, 火车=交通方式}	行程属性
从这里飞机到猴庙贵吗	{猴庙=目的poi名称, 飞机=交通方式}	行程属性
从这里大巴车到新加坡河贵吗	{大巴车=交通方式, 新加坡河=目的poi名称}	行程属性
从这里飞机到光明寺贵吗	{光明寺=目的poi名称, 飞机=交通方式}	行程属性
从这里火车到全聚德贵吗	{全聚德=目的poi名称, 火车=交通方式}	行程属性
从这里飞机到唐人街贵吗	{唐人街=目的poi名称, 飞机=交通方式}	行程属性
从这里飞机到鼓浪屿贵吗	{鼓浪屿=目的poi名称, 飞机=交通方式}	行程属性
从这里大巴车到荣军院贵吗	{大巴车=交通方式, 荣军院=目的poi名称}	行程属性
从这里飞机到托普卡帕宫贵吗	{托普卡帕宫=目的poi名称, 飞机=交通方式}	行程属性
从这里地铁到凯旋门贵吗	{地铁=交通方式, 凯旋门=目的poi名称}	行程属性
从这里地铁到迪士尼贵吗	{地铁=交通方式, 迪士尼=目的poi名称}	行程属性
从这里火车到光明寺贵吗	{火车=交通方式, 光明寺=目的poi名称}	行程属性
从这里飞机到多瑙河贵吗	{多瑙河=目的poi名称, 飞机=交通方式}	行程属性
从这里火车到密歇根湖贵吗	{火车=交通方式, 密歇根湖=目的poi名称}	行程属性
从这里火车到托普卡帕宫贵吗	{火车=交通方式, 托普卡帕宫=目的poi名称}	行程属性
从这里飞机到日月潭贵吗	{日月潭=目的poi名称, 飞机=交通方式}	行程属性
从这里大巴车到阿尔法玛贵吗	{大巴车=交通方式, 阿尔法玛=目的poi名称}	行程属性
从这里地铁到阿尔法玛花的钱多吗	{阿尔法玛=目的poi名称, 地铁=交通方式}	行程属性
从这里大巴车到唐人街花的钱多吗	{大巴车=交通方式, 唐人街=目的poi名称}	行程属性
从这里大巴车到景福宫花的钱多吗	{大巴车=交通方式, 景福宫=目的poi名称}	行程属性
从这里飞机到凯旋门花的钱多吗	{凯旋门=目的poi名称, 飞机=交通方式}	行程属性
从这里大巴车到荣军院花的钱多吗	{大巴车=交通方式, 荣军院=目的poi名称}	行程属性
从这里飞机到多瑙河花的钱多吗	{多瑙河=目的poi名称, 飞机=交通方式}	行程属性
从这里飞机到景福宫花的钱多吗	{景福宫=目的poi名称, 飞机=交通方式}	行程属性
从这里飞机到托普卡帕宫花的钱多吗	{托普卡帕宫=目的poi名称, 飞机=交通方式}	行程属性
从这里大巴车到新加坡河花的钱多吗	{大巴车=交通方式, 新加坡河=目的poi名称}	行程属性
从这里大巴车到鼓浪屿花的钱多吗	{大巴车=交通方式, 鼓浪屿=目的poi名称}	行程属性
从这里大巴车到密歇根湖花的钱多吗	{大巴车=交通方式, 密歇根湖=目的poi名称}	行程属性
从这里火车到唐人街花的钱多吗	{唐人街=目的poi名称, 火车=交通方式}	行程属性
从这里地铁到新加坡河花的钱多吗	{新加坡河=目的poi名称, 地铁=交通方式}	行程属性
从这里大巴车到全聚德花的钱多吗	{大巴车=交通方式, 全聚德=目的poi名称}	行程属性
从这里大巴车到阿尔法玛花的钱多吗	{大巴车=交通方式, 阿尔法玛=目的poi名称}	行程属性
从这里火车到荣军院花的钱多吗	{火车=交通方式, 荣军院=目的poi名称}	行程属性
从这里飞机到密歇根湖花的钱多吗	{密歇根湖=目的poi名称, 飞机=交通方式}	行程属性
从这里大巴车到孚日宫花的钱多吗	{大巴车=交通方式, 孚日宫=目的poi名称}	行程属性
从这里地铁到迪士尼花的钱多吗	{地铁=交通方式, 迪士尼=目的poi名称}	行程属性
从这里飞机到荣军院花的钱多吗	{荣军院=目的poi名称, 飞机=交通方式}	行程属性
从这里地铁到维多利亚港花的钱多吗	{维多利亚港=目的poi名称, 地铁=交通方式}	行程属性
从这里火车到金阁寺花的钱多吗	{火车=交通方式, 金阁寺=目的poi名称}	行程属性
从这里飞机到玛黑区花的钱多吗	{玛黑区=目的poi名称, 飞机=交通方式}	行程属性
从这里大巴车到维多利亚港花的钱多吗	{大巴车=交通方式, 维多利亚港=目的poi名称}	行程属性
从这里火车到维港花的钱多吗	{维港=目的poi名称, 火车=交通方式}	行程属性
从这里地铁到密歇根湖花的钱多吗	{密歇根湖=目的poi名称, 地铁=交通方式}	行程属性
从这里大巴车到凯旋门花的钱多吗	{大巴车=交通方式, 凯旋门=目的poi名称}	行程属性
从这里火车到新加坡河花的钱多吗	{火车=交通方式, 新加坡河=目的poi名称}	行程属性
从这里地铁到莱茵河花的钱多吗	{莱茵河=目的poi名称, 地铁=交通方式}	行程属性
从这里飞机到日月潭花的钱多吗	{日月潭=目的poi名称, 飞机=交通方式}	行程属性
从这里地铁到全聚德花的钱多吗	{全聚德=目的poi名称, 地铁=交通方式}	行程属性
从这里地铁到九寨沟花的钱多吗	{九寨沟=目的poi名称, 地铁=交通方式}	行程属性
从这里火车到阿尔法玛花的钱多吗	{火车=交通方式, 阿尔法玛=目的poi名称}	行程属性
从这里飞机到维港花的钱多吗	{维港=目的poi名称, 飞机=交通方式}	行程属性
从这里大巴车到光明寺花的钱多吗	{大巴车=交通方式, 光明寺=目的poi名称}	行程属性
从这里火车到孚日宫花的钱多吗	{孚日宫=目的poi名称, 火车=交通方式}	行程属性
从这里火车到白沙滩花的钱多吗	{火车=交通方式, 白沙滩=目的poi名称}	行程属性
从这里火车到青莲院花的钱多吗	{火车=交通方式, 青莲院=目的poi名称}	行程属性
从这里地铁到马穆提岛花的钱多吗	{地铁=交通方式, 马穆提岛=目的poi名称}	行程属性
从这里地铁到青莲院花的钱多吗	{地铁=交通方式, 青莲院=目的poi名称}	行程属性
从这里大巴车到九寨沟花的钱多吗	{大巴车=交通方式, 九寨沟=目的poi名称}	行程属性
从这里火车到芬兰堡花的钱多吗	{火车=交通方式, 芬兰堡=目的poi名称}	行程属性
从这里大巴车到多瑙河花的钱多吗	{大巴车=交通方式, 多瑙河=目的poi名称}	行程属性
从这里地铁到卢浮宫花的钱多吗	{卢浮宫=目的poi名称, 地铁=交通方式}	行程属性
从这里飞机到新加坡河花的钱多吗	{新加坡河=目的poi名称, 飞机=交通方式}	行程属性
从这里飞机到白沙滩花的钱多吗	{白沙滩=目的poi名称, 飞机=交通方式}	行程属性
从这里大巴车到马穆提岛花的钱多吗	{大巴车=交通方式, 马穆提岛=目的poi名称}	行程属性
从这里地铁到孚日宫花的钱多吗	{孚日宫=目的poi名称, 地铁=交通方式}	行程属性
从这里飞机到迪士尼花的钱多吗	{迪士尼=目的poi名称, 飞机=交通方式}	行程属性
从这里大巴车到维港花的钱多吗	{大巴车=交通方式, 维港=目的poi名称}	行程属性
从这里飞机到九寨沟花的钱多吗	{九寨沟=目的poi名称, 飞机=交通方式}	行程属性
从这里大巴车到红树花的钱多吗	{红树=目的poi名称, 大巴车=交通方式}	行程属性
从这里大巴车到托普卡帕宫花的钱多吗	{大巴车=交通方式, 托普卡帕宫=目的poi名称}	行程属性
从这里火车到玛黑区花的钱多吗	{玛黑区=目的poi名称, 火车=交通方式}	行程属性
从这里火车到景福宫花的钱多吗	{景福宫=目的poi名称, 火车=交通方式}	行程属性
从这里大巴车到玛黑区花的钱多吗	{玛黑区=目的poi名称, 大巴车=交通方式}	行程属性
从这里火车到全聚德花的钱多吗	{全聚德=目的poi名称, 火车=交通方式}	行程属性
从这里飞机到金阁寺花的钱多吗	{飞机=交通方式, 金阁寺=目的poi名称}	行程属性
从这里地铁到光明寺花的钱多吗	{光明寺=目的poi名称, 地铁=交通方式}	行程属性
从这里地铁到白沙滩花的钱多吗	{白沙滩=目的poi名称, 地铁=交通方式}	行程属性
从这里飞机到全聚德花的钱多吗	{全聚德=目的poi名称, 飞机=交通方式}	行程属性
从这里飞机到鼓浪屿花的钱多吗	{鼓浪屿=目的poi名称, 飞机=交通方式}	行程属性
从这里火车到迪斯尼花的钱多吗	{火车=交通方式, 迪斯尼=目的poi名称}	行程属性
从这里火车到迪士尼花的钱多吗	{火车=交通方式, 迪士尼=目的poi名称}	行程属性
从这里大巴车到莱茵河花的钱多吗	{莱茵河=目的poi名称, 大巴车=交通方式}	行程属性
从这里火车到马穆提岛花的钱多吗	{火车=交通方式, 马穆提岛=目的poi名称}	行程属性
从这里地铁到凯旋门花的钱多吗	{地铁=交通方式, 凯旋门=目的poi名称}	行程属性
从这里火车到红树花的钱多吗	{红树=目的poi名称, 火车=交通方式}	行程属性
从这里地铁到日月潭花的钱多吗	{日月潭=目的poi名称, 地铁=交通方式}	行程属性
从这里飞机到猴庙花的钱多吗	{猴庙=目的poi名称, 飞机=交通方式}	行程属性
从这里地铁到唐人街花的钱多吗	{唐人街=目的poi名称, 地铁=交通方式}	行程属性
从这里大巴车到迪士尼花的钱多吗	{大巴车=交通方式, 迪士尼=目的poi名称}	行程属性
从这里地铁到红树花的钱多吗	{红树=目的poi名称, 地铁=交通方式}	行程属性
从这里地铁到玛黑区花的钱多吗	{玛黑区=目的poi名称, 地铁=交通方式}	行程属性
从这里地铁到路易港花的钱多吗	{地铁=交通方式, 路易港=目的poi名称}	行程属性
从这里地铁到猴庙花的钱多吗	{地铁=交通方式, 猴庙=目的poi名称}	行程属性
从这里火车到密歇根湖花的钱多吗	{火车=交通方式, 密歇根湖=目的poi名称}	行程属性
从这里飞机到马穆提岛花的钱多吗	{马穆提岛=目的poi名称, 飞机=交通方式}	行程属性
从这里大巴车到路易港花的钱多吗	{大巴车=交通方式, 路易港=目的poi名称}	行程属性
从这里飞机到光明寺花的钱多吗	{光明寺=目的poi名称, 飞机=交通方式}	行程属性
从这里火车到鼓浪屿花的钱多吗	{火车=交通方式, 鼓浪屿=目的poi名称}	行程属性
从这里大巴车到迪斯尼花的钱多吗	{大巴车=交通方式, 迪斯尼=目的poi名称}	行程属性
从这里大巴车到青莲院花的钱多吗	{大巴车=交通方式, 青莲院=目的poi名称}	行程属性
从这里大巴车到日月潭花的钱多吗	{日月潭=目的poi名称, 大巴车=交通方式}	行程属性
从这里地铁到多瑙河花的钱多吗	{多瑙河=目的poi名称, 地铁=交通方式}	行程属性
从这里火车到卢浮宫花的钱多吗	{火车=交通方式, 卢浮宫=目的poi名称}	行程属性
从这里大巴车到芬兰堡花的钱多吗	{大巴车=交通方式, 芬兰堡=目的poi名称}	行程属性
从这里火车到九寨沟花的钱多吗	{火车=交通方式, 九寨沟=目的poi名称}	行程属性
从这里火车到光明寺花的钱多吗	{火车=交通方式, 光明寺=目的poi名称}	行程属性
从这里飞机到孚日宫花的钱多吗	{孚日宫=目的poi名称, 飞机=交通方式}	行程属性
从这里飞机到卢浮宫花的钱多吗	{卢浮宫=目的poi名称, 飞机=交通方式}	行程属性
从这里飞机到芬兰堡花的钱多吗	{芬兰堡=目的poi名称, 飞机=交通方式}	行程属性
从这里火车到托普卡帕宫花的钱多吗	{火车=交通方式, 托普卡帕宫=目的poi名称}	行程属性
从这里飞机到路易港花的钱多吗	{路易港=目的poi名称, 飞机=交通方式}	行程属性
从这里火车到多瑙河花的钱多吗	{火车=交通方式, 多瑙河=目的poi名称}	行程属性
从这里飞机到维多利亚港花的钱多吗	{维多利亚港=目的poi名称, 飞机=交通方式}	行程属性
从这里火车到凯旋门花的钱多吗	{火车=交通方式, 凯旋门=目的poi名称}	行程属性
从这里火车到猴庙花的钱多吗	{火车=交通方式, 猴庙=目的poi名称}	行程属性
从这里大巴车到维港便宜吗	{大巴车=交通方式, 维港=目的poi名称}	行程属性
从这里火车到阿尔法玛便宜吗	{火车=交通方式, 阿尔法玛=目的poi名称}	行程属性
从这里飞机到猴庙便宜吗	{猴庙=目的poi名称, 飞机=交通方式}	行程属性
从这里火车到光明寺便宜吗	{火车=交通方式, 光明寺=目的poi名称}	行程属性
从这里地铁到迪士尼便宜吗	{地铁=交通方式, 迪士尼=目的poi名称}	行程属性
从这里地铁到鼓浪屿便宜吗	{地铁=交通方式, 鼓浪屿=目的poi名称}	行程属性
从这里火车到唐人街便宜吗	{唐人街=目的poi名称, 火车=交通方式}	行程属性
从这里飞机到新加坡河便宜吗	{新加坡河=目的poi名称, 飞机=交通方式}	行程属性
从这里大巴车到唐人街便宜吗	{大巴车=交通方式, 唐人街=目的poi名称}	行程属性
从这里飞机到光明寺便宜吗	{光明寺=目的poi名称, 飞机=交通方式}	行程属性
从这里飞机到青莲院便宜吗	{青莲院=目的poi名称, 飞机=交通方式}	行程属性
从这里地铁到白沙滩便宜吗	{白沙滩=目的poi名称, 地铁=交通方式}	行程属性
从这里飞机到孚日宫便宜吗	{孚日宫=目的poi名称, 飞机=交通方式}	行程属性
从这里飞机到景福宫便宜吗	{景福宫=目的poi名称, 飞机=交通方式}	行程属性
从这里地铁到玛黑区便宜吗	{玛黑区=目的poi名称, 地铁=交通方式}	行程属性
从这里大巴车到九寨沟便宜吗	{大巴车=交通方式, 九寨沟=目的poi名称}	行程属性
从这里大巴车到景福宫便宜吗	{大巴车=交通方式, 景福宫=目的poi名称}	行程属性
从这里飞机到唐人街便宜吗	{唐人街=目的poi名称, 飞机=交通方式}	行程属性
从这里大巴车到玛黑区便宜吗	{玛黑区=目的poi名称, 大巴车=交通方式}	行程属性
从这里火车到青莲院便宜吗	{火车=交通方式, 青莲院=目的poi名称}	行程属性
从这里大巴车到芬兰堡便宜吗	{大巴车=交通方式, 芬兰堡=目的poi名称}	行程属性
从这里火车到玛黑区便宜吗	{玛黑区=目的poi名称, 火车=交通方式}	行程属性
从这里火车到金阁寺便宜吗	{火车=交通方式, 金阁寺=目的poi名称}	行程属性
从这里地铁到景福宫便宜吗	{景福宫=目的poi名称, 地铁=交通方式}	行程属性
从这里大巴车到卢浮宫便宜吗	{大巴车=交通方式, 卢浮宫=目的poi名称}	行程属性
从这里火车到荣军院便宜吗	{火车=交通方式, 荣军院=目的poi名称}	行程属性
从这里地铁到莱茵河便宜吗	{莱茵河=目的poi名称, 地铁=交通方式}	行程属性
从这里地铁到阿尔法玛便宜吗	{阿尔法玛=目的poi名称, 地铁=交通方式}	行程属性
从这里火车到多瑙河便宜吗	{火车=交通方式, 多瑙河=目的poi名称}	行程属性
从这里地铁到托普卡帕宫便宜吗	{地铁=交通方式, 托普卡帕宫=目的poi名称}	行程属性
从这里地铁到红树便宜吗	{红树=目的poi名称, 地铁=交通方式}	行程属性
从这里火车到卢浮宫便宜吗	{火车=交通方式, 卢浮宫=目的poi名称}	行程属性
从这里火车到全聚德便宜吗	{全聚德=目的poi名称, 火车=交通方式}	行程属性
从这里地铁到卢浮宫便宜吗	{卢浮宫=目的poi名称, 地铁=交通方式}	行程属性
从这里火车到九寨沟便宜吗	{火车=交通方式, 九寨沟=目的poi名称}	行程属性
从这里火车到鼓浪屿便宜吗	{火车=交通方式, 鼓浪屿=目的poi名称}	行程属性
从这里飞机到迪斯尼便宜吗	{飞机=交通方式, 迪斯尼=目的poi名称}	行程属性
从这里火车到莱茵河便宜吗	{莱茵河=目的poi名称, 火车=交通方式}	行程属性
从这里大巴车到迪士尼便宜吗	{大巴车=交通方式, 迪士尼=目的poi名称}	行程属性
从这里飞机到卢浮宫便宜吗	{卢浮宫=目的poi名称, 飞机=交通方式}	行程属性
从这里火车到凯旋门便宜吗	{火车=交通方式, 凯旋门=目的poi名称}	行程属性
从这里大巴车到路易港便宜吗	{大巴车=交通方式, 路易港=目的poi名称}	行程属性
从这里火车到红树便宜吗	{红树=目的poi名称, 火车=交通方式}	行程属性
从这里火车到路易港便宜吗	{火车=交通方式, 路易港=目的poi名称}	行程属性
从这里大巴车到新加坡河便宜吗	{大巴车=交通方式, 新加坡河=目的poi名称}	行程属性
从这里大巴车到猴庙便宜吗	{大巴车=交通方式, 猴庙=目的poi名称}	行程属性
从这里飞机到白沙滩便宜吗	{白沙滩=目的poi名称, 飞机=交通方式}	行程属性
从这里飞机到托普卡帕宫便宜吗	{托普卡帕宫=目的poi名称, 飞机=交通方式}	行程属性
从这里飞机到九寨沟便宜吗	{九寨沟=目的poi名称, 飞机=交通方式}	行程属性
从这里大巴车到马穆提岛便宜吗	{大巴车=交通方式, 马穆提岛=目的poi名称}	行程属性
从这里火车到密歇根湖便宜吗	{火车=交通方式, 密歇根湖=目的poi名称}	行程属性
从这里大巴车到鼓浪屿便宜吗	{大巴车=交通方式, 鼓浪屿=目的poi名称}	行程属性
从这里大巴车到全聚德便宜吗	{大巴车=交通方式, 全聚德=目的poi名称}	行程属性
从这里火车到孚日宫便宜吗	{孚日宫=目的poi名称, 火车=交通方式}	行程属性
从这里火车到日月潭便宜吗	{日月潭=目的poi名称, 火车=交通方式}	行程属性
从这里火车到托普卡帕宫便宜吗	{火车=交通方式, 托普卡帕宫=目的poi名称}	行程属性
从这里地铁到大夏宫便宜吗	{地铁=交通方式, 大夏宫=目的poi名称}	行程属性
从这里大巴车到迪斯尼便宜吗	{大巴车=交通方式, 迪斯尼=目的poi名称}	行程属性
从这里飞机到维港便宜吗	{维港=目的poi名称, 飞机=交通方式}	行程属性
从这里飞机到红树便宜吗	{红树=目的poi名称, 飞机=交通方式}	行程属性
从这里大巴车到大夏宫便宜吗	{大巴车=交通方式, 大夏宫=目的poi名称}	行程属性
从这里飞机到马穆提岛便宜吗	{马穆提岛=目的poi名称, 飞机=交通方式}	行程属性
从这里火车到迪斯尼便宜吗	{火车=交通方式, 迪斯尼=目的poi名称}	行程属性
从这里地铁到路易港便宜吗	{地铁=交通方式, 路易港=目的poi名称}	行程属性
从这里地铁到芬兰堡便宜吗	{芬兰堡=目的poi名称, 地铁=交通方式}	行程属性
从这里地铁到孚日宫便宜吗	{孚日宫=目的poi名称, 地铁=交通方式}	行程属性
从这里飞机到莱茵河便宜吗	{莱茵河=目的poi名称, 飞机=交通方式}	行程属性
从这里飞机到阿尔法玛便宜吗	{阿尔法玛=目的poi名称, 飞机=交通方式}	行程属性
从这里地铁到迪斯尼便宜吗	{地铁=交通方式, 迪斯尼=目的poi名称}	行程属性
从这里地铁到荣军院便宜吗	{地铁=交通方式, 荣军院=目的poi名称}	行程属性
从这里飞机到路易港便宜吗	{路易港=目的poi名称, 飞机=交通方式}	行程属性
从这里大巴车到维多利亚港便宜吗	{大巴车=交通方式, 维多利亚港=目的poi名称}	行程属性
从这里火车到维多利亚港便宜吗	{火车=交通方式, 维多利亚港=目的poi名称}	行程属性
从这里飞机到大夏宫便宜吗	{大夏宫=目的poi名称, 飞机=交通方式}	行程属性
从这里飞机到凯旋门便宜吗	{凯旋门=目的poi名称, 飞机=交通方式}	行程属性
从这儿去九寨沟，大巴车要花多少钱	{大巴车=交通方式, 九寨沟=目的poi名称}	行程属性
从这儿去孚日宫，大巴车要花多少钱	{孚日宫=目的poi名称, 大巴车=交通方式}	行程属性
从这儿去路易港，火车要花多少钱	{火车=交通方式, 路易港=目的poi名称}	行程属性
从这儿去白沙滩，地铁要花多少钱	{白沙滩=目的poi名称, 地铁=交通方式}	行程属性
从这儿去密歇根湖，火车要花多少钱	{火车=交通方式, 密歇根湖=目的poi名称}	行程属性
从这儿去九寨沟，飞机要花多少钱	{九寨沟=目的poi名称, 飞机=交通方式}	行程属性
从这儿去莱茵河，地铁要花多少钱	{莱茵河=目的poi名称, 地铁=交通方式}	行程属性
从这儿去孚日宫，飞机要花多少钱	{孚日宫=目的poi名称, 飞机=交通方式}	行程属性
从这儿去马穆提岛，火车要花多少钱	{火车=交通方式, 马穆提岛=目的poi名称}	行程属性
从这儿去光明寺，地铁要花多少钱	{光明寺=目的poi名称, 地铁=交通方式}	行程属性
从这儿去迪士尼，大巴车要花多少钱	{大巴车=交通方式, 迪士尼=目的poi名称}	行程属性
从这儿去阿尔法玛，大巴车要花多少钱	{大巴车=交通方式, 阿尔法玛=目的poi名称}	行程属性
从这儿去猴庙，地铁要花多少钱	{地铁=交通方式, 猴庙=目的poi名称}	行程属性
从这儿去全聚德，飞机要花多少钱	{全聚德=目的poi名称, 飞机=交通方式}	行程属性
从这儿去猴庙，火车要花多少钱	{火车=交通方式, 猴庙=目的poi名称}	行程属性
从这儿去维港，飞机要花多少钱	{维港=目的poi名称, 飞机=交通方式}	行程属性
从这儿去猴庙，飞机要花多少钱	{猴庙=目的poi名称, 飞机=交通方式}	行程属性
从这儿去金阁寺，地铁要花多少钱	{地铁=交通方式, 金阁寺=目的poi名称}	行程属性
从这儿去全聚德，地铁要花多少钱	{全聚德=目的poi名称, 地铁=交通方式}	行程属性
从这儿去密歇根湖，地铁要花多少钱	{密歇根湖=目的poi名称, 地铁=交通方式}	行程属性
从这儿去卢浮宫，火车要花多少钱	{火车=交通方式, 卢浮宫=目的poi名称}	行程属性
从这儿去唐人街，火车要花多少钱	{唐人街=目的poi名称, 火车=交通方式}	行程属性
从这儿去日月潭，飞机要花多少钱	{日月潭=目的poi名称, 飞机=交通方式}	行程属性
从这儿去马穆提岛，地铁要花多少钱	{地铁=交通方式, 马穆提岛=目的poi名称}	行程属性
从这儿去维多利亚港，大巴车要花多少钱	{大巴车=交通方式, 维多利亚港=目的poi名称}	行程属性
从这儿去莱茵河，飞机要花多少钱	{莱茵河=目的poi名称, 飞机=交通方式}	行程属性
从这儿去光明寺，飞机要花多少钱	{光明寺=目的poi名称, 飞机=交通方式}	行程属性
从这儿去莱茵河，火车要花多少钱	{莱茵河=目的poi名称, 火车=交通方式}	行程属性
从这儿去卢浮宫，地铁要花多少钱	{卢浮宫=目的poi名称, 地铁=交通方式}	行程属性
从这儿去景福宫，火车要花多少钱	{景福宫=目的poi名称, 火车=交通方式}	行程属性
从这儿去鼓浪屿，火车要花多少钱	{火车=交通方式, 鼓浪屿=目的poi名称}	行程属性
从这儿去迪士尼，地铁要花多少钱	{地铁=交通方式, 迪士尼=目的poi名称}	行程属性
从这儿去维多利亚港，地铁要花多少钱	{维多利亚港=目的poi名称, 地铁=交通方式}	行程属性
从这儿去芬兰堡，飞机要花多少钱	{芬兰堡=目的poi名称, 飞机=交通方式}	行程属性
从这儿去托普卡帕宫，飞机要花多少钱	{托普卡帕宫=目的poi名称, 飞机=交通方式}	行程属性
从这儿去红树，大巴车要花多少钱	{红树=目的poi名称, 大巴车=交通方式}	行程属性
从这儿去全聚德，大巴车要花多少钱	{大巴车=交通方式, 全聚德=目的poi名称}	行程属性
从这儿去迪士尼，火车要花多少钱	{火车=交通方式, 迪士尼=目的poi名称}	行程属性
从这儿去鼓浪屿，飞机要花多少钱	{鼓浪屿=目的poi名称, 飞机=交通方式}	行程属性
从这儿去路易港，大巴车要花多少钱	{大巴车=交通方式, 路易港=目的poi名称}	行程属性
从这儿去红树，飞机要花多少钱	{红树=目的poi名称, 飞机=交通方式}	行程属性
从这儿去迪斯尼，火车要花多少钱	{火车=交通方式, 迪斯尼=目的poi名称}	行程属性
从这儿去红树，地铁要花多少钱	{红树=目的poi名称, 地铁=交通方式}	行程属性
从这儿去卢浮宫，飞机要花多少钱	{卢浮宫=目的poi名称, 飞机=交通方式}	行程属性
从这儿去莱茵河，大巴车要花多少钱	{莱茵河=目的poi名称, 大巴车=交通方式}	行程属性
从这儿去鼓浪屿，大巴车要花多少钱	{大巴车=交通方式, 鼓浪屿=目的poi名称}	行程属性
从这儿去托普卡帕宫，大巴车要花多少钱	{大巴车=交通方式, 托普卡帕宫=目的poi名称}	行程属性
从这儿去阿尔法玛，飞机要花多少钱	{阿尔法玛=目的poi名称, 飞机=交通方式}	行程属性
从这儿去猴庙，大巴车要花多少钱	{大巴车=交通方式, 猴庙=目的poi名称}	行程属性
从这儿去多瑙河，地铁要花多少钱	{多瑙河=目的poi名称, 地铁=交通方式}	行程属性
从这儿去白沙滩，大巴车要花多少钱	{大巴车=交通方式, 白沙滩=目的poi名称}	行程属性
从这儿去光明寺，火车要花多少钱	{火车=交通方式, 光明寺=目的poi名称}	行程属性
从这儿去多瑙河，火车要花多少钱	{火车=交通方式, 多瑙河=目的poi名称}	行程属性
从这儿去青莲院，大巴车要花多少钱	{大巴车=交通方式, 青莲院=目的poi名称}	行程属性
从这儿去白沙滩，火车要花多少钱	{火车=交通方式, 白沙滩=目的poi名称}	行程属性
从这儿去路易港，飞机要花多少钱	{路易港=目的poi名称, 飞机=交通方式}	行程属性
从这儿去维港，大巴车要花多少钱	{大巴车=交通方式, 维港=目的poi名称}	行程属性
从这儿去玛黑区，火车要花多少钱	{玛黑区=目的poi名称, 火车=交通方式}	行程属性
从这儿去迪斯尼，大巴车要花多少钱	{大巴车=交通方式, 迪斯尼=目的poi名称}	行程属性
从这儿去唐人街，地铁要花多少钱	{唐人街=目的poi名称, 地铁=交通方式}	行程属性
从这儿去维多利亚港，火车要花多少钱	{火车=交通方式, 维多利亚港=目的poi名称}	行程属性
从这儿去九寨沟，地铁要花多少钱	{九寨沟=目的poi名称, 地铁=交通方式}	行程属性
从这儿去多瑙河，大巴车要花多少钱	{大巴车=交通方式, 多瑙河=目的poi名称}	行程属性
从这儿去维多利亚港，飞机要花多少钱	{维多利亚港=目的poi名称, 飞机=交通方式}	行程属性
从这儿去托普卡帕宫，地铁要花多少钱	{地铁=交通方式, 托普卡帕宫=目的poi名称}	行程属性
从这儿去阿尔法玛，地铁要花多少钱	{阿尔法玛=目的poi名称, 地铁=交通方式}	行程属性
从这儿去金阁寺，火车要花多少钱	{火车=交通方式, 金阁寺=目的poi名称}	行程属性
从这儿去青莲院，火车要花多少钱	{火车=交通方式, 青莲院=目的poi名称}	行程属性
从这儿去马穆提岛，飞机要花多少钱	{马穆提岛=目的poi名称, 飞机=交通方式}	行程属性
从这儿去阿尔法玛，火车要花多少钱	{火车=交通方式, 阿尔法玛=目的poi名称}	行程属性
从这儿去新加坡河，地铁要花多少钱	{新加坡河=目的poi名称, 地铁=交通方式}	行程属性
从这儿去日月潭，大巴车要花多少钱	{日月潭=目的poi名称, 大巴车=交通方式}	行程属性
从这儿去金阁寺，飞机要花多少钱	{飞机=交通方式, 金阁寺=目的poi名称}	行程属性
从这儿去全聚德，火车要花多少钱	{全聚德=目的poi名称, 火车=交通方式}	行程属性
从这儿去大夏宫，飞机要花多少钱	{大夏宫=目的poi名称, 飞机=交通方式}	行程属性
从这儿去新加坡河，大巴车要花多少钱	{大巴车=交通方式, 新加坡河=目的poi名称}	行程属性
