”雪碧“用朝鲜语怎么说	{朝鲜语=语言, ”雪碧“=内容}	1.翻译后的结果
”雪碧“用汉语怎么说	{汉语=语言, ”雪碧“=内容}	1.翻译后的结果
我喜欢欧洲旅行用斯瓦希里语怎么说	{斯瓦希里语=语言, 我喜欢欧洲旅行=内容}	1.翻译后的结果
”雪碧“用西班牙语怎么说	{西班牙语=语言, ”雪碧“=内容}	1.翻译后的结果
去美国旅行用意大利语怎么说	{去美国旅行=内容, 意大利语=语言}	1.翻译后的结果
“芒果糯米鸡“用泰米尔语怎么说	{“芒果糯米鸡“=内容, 泰米尔语=语言}	1.翻译后的结果
“芒果糯米鸡“用韩语怎么说	{“芒果糯米鸡“=内容, 韩语=语言}	1.翻译后的结果
”雪碧“用俄语怎么说	{俄语=语言, ”雪碧“=内容}	1.翻译后的结果
我喜欢欧洲旅行用日语怎么说	{日语=语言, 我喜欢欧洲旅行=内容}	1.翻译后的结果
去美国旅行用英语怎么说	{去美国旅行=内容, 英语=语言}	1.翻译后的结果
“芒果糯米鸡“用英语怎么说	{“芒果糯米鸡“=内容, 英语=语言}	1.翻译后的结果
我喜欢欧洲旅行用意大利语怎么说	{意大利语=语言, 我喜欢欧洲旅行=内容}	1.翻译后的结果
去美国旅行用越南语怎么说	{去美国旅行=内容, 越南语=语言}	1.翻译后的结果
”雪碧“用泰米尔语怎么说	{泰米尔语=语言, ”雪碧“=内容}	1.翻译后的结果
去美国旅行用韩语怎么说	{韩语=语言, 去美国旅行=内容}	1.翻译后的结果
我喜欢欧洲旅行用泰米尔语怎么说	{泰米尔语=语言, 我喜欢欧洲旅行=内容}	1.翻译后的结果
去美国旅行用朝鲜语怎么说	{去美国旅行=内容, 朝鲜语=语言}	1.翻译后的结果
去美国旅行用法语怎么说	{法语=语言, 去美国旅行=内容}	1.翻译后的结果
我喜欢欧洲旅行用英语怎么说	{英语=语言, 我喜欢欧洲旅行=内容}	1.翻译后的结果
“芒果糯米鸡“用德语怎么说	{“芒果糯米鸡“=内容, 德语=语言}	1.翻译后的结果
“芒果糯米鸡“用朝鲜语怎么说	{“芒果糯米鸡“=内容, 朝鲜语=语言}	1.翻译后的结果
我喜欢欧洲旅行用越南语怎么说	{越南语=语言, 我喜欢欧洲旅行=内容}	1.翻译后的结果
我喜欢欧洲旅行用汉语怎么说	{汉语=语言, 我喜欢欧洲旅行=内容}	1.翻译后的结果
”雪碧“用日语怎么说	{日语=语言, ”雪碧“=内容}	1.翻译后的结果
去美国旅行用斯瓦希里语怎么说	{去美国旅行=内容, 斯瓦希里语=语言}	1.翻译后的结果
“芒果糯米鸡“用意大利语怎么说	{“芒果糯米鸡“=内容, 意大利语=语言}	1.翻译后的结果
”雪碧“用阿拉伯语怎么说	{阿拉伯语=语言, ”雪碧“=内容}	1.翻译后的结果
”雪碧“用斯瓦希里语怎么说	{斯瓦希里语=语言, ”雪碧“=内容}	1.翻译后的结果
我喜欢欧洲旅行用韩语怎么说	{韩语=语言, 我喜欢欧洲旅行=内容}	1.翻译后的结果
韩语怎么说“芒果糯米鸡“	{“芒果糯米鸡“=内容, 韩语=语言}	1.翻译后的结果
朝鲜语怎么说去美国旅行	{朝鲜语=语言, 去美国旅行=内容}	1.翻译后的结果
西班牙语怎么说”雪碧“	{西班牙语=语言, ”雪碧“=内容}	1.翻译后的结果
韩语怎么说去美国旅行	{韩语=语言, 去美国旅行=内容}	1.翻译后的结果
英语怎么说“芒果糯米鸡“	{“芒果糯米鸡“=内容, 英语=语言}	1.翻译后的结果
法语怎么说我喜欢欧洲旅行	{法语=语言, 我喜欢欧洲旅行=内容}	1.翻译后的结果
德语怎么说去美国旅行	{去美国旅行=内容, 德语=语言}	1.翻译后的结果
泰米尔语怎么说去美国旅行	{泰米尔语=语言, 去美国旅行=内容}	1.翻译后的结果
汉语怎么说我喜欢欧洲旅行	{汉语=语言, 我喜欢欧洲旅行=内容}	1.翻译后的结果
泰米尔语怎么说”雪碧“	{泰米尔语=语言, ”雪碧“=内容}	1.翻译后的结果
法语怎么说去美国旅行	{法语=语言, 去美国旅行=内容}	1.翻译后的结果
阿拉伯语怎么说我喜欢欧洲旅行	{阿拉伯语=语言, 我喜欢欧洲旅行=内容}	1.翻译后的结果
西班牙语怎么说我喜欢欧洲旅行	{西班牙语=语言, 我喜欢欧洲旅行=内容}	1.翻译后的结果
阿拉伯语怎么说去美国旅行	{阿拉伯语=语言, 去美国旅行=内容}	1.翻译后的结果
俄语怎么说我喜欢欧洲旅行	{俄语=语言, 我喜欢欧洲旅行=内容}	1.翻译后的结果
日语怎么说去美国旅行	{日语=语言, 去美国旅行=内容}	1.翻译后的结果
越南语怎么说我喜欢欧洲旅行	{越南语=语言, 我喜欢欧洲旅行=内容}	1.翻译后的结果
汉语怎么说去美国旅行	{去美国旅行=内容, 汉语=语言}	1.翻译后的结果
俄语怎么说”雪碧“	{俄语=语言, ”雪碧“=内容}	1.翻译后的结果
英语怎么说我喜欢欧洲旅行	{英语=语言, 我喜欢欧洲旅行=内容}	1.翻译后的结果
意大利语怎么说”雪碧“	{意大利语=语言, ”雪碧“=内容}	1.翻译后的结果
英语怎么说”雪碧“	{英语=语言, ”雪碧“=内容}	1.翻译后的结果
泰米尔语怎么说我喜欢欧洲旅行	{泰米尔语=语言, 我喜欢欧洲旅行=内容}	1.翻译后的结果
意大利语怎么说我喜欢欧洲旅行	{意大利语=语言, 我喜欢欧洲旅行=内容}	1.翻译后的结果
斯瓦希里语怎么说我喜欢欧洲旅行	{斯瓦希里语=语言, 我喜欢欧洲旅行=内容}	1.翻译后的结果
韩语怎么说我喜欢欧洲旅行	{韩语=语言, 我喜欢欧洲旅行=内容}	1.翻译后的结果
斯瓦希里语怎么说“芒果糯米鸡“	{“芒果糯米鸡“=内容, 斯瓦希里语=语言}	1.翻译后的结果
俄语怎么说去美国旅行	{俄语=语言, 去美国旅行=内容}	1.翻译后的结果
越南语怎么说去美国旅行	{去美国旅行=内容, 越南语=语言}	1.翻译后的结果
阿拉伯语怎么说“芒果糯米鸡“	{阿拉伯语=语言, “芒果糯米鸡“=内容}	1.翻译后的结果
泰米尔语怎么说“芒果糯米鸡“	{“芒果糯米鸡“=内容, 泰米尔语=语言}	1.翻译后的结果
法语怎么说“芒果糯米鸡“	{“芒果糯米鸡“=内容, 法语=语言}	1.翻译后的结果
英语怎么说去美国旅行	{去美国旅行=内容, 英语=语言}	1.翻译后的结果
西班牙语怎么说“芒果糯米鸡“	{西班牙语=语言, “芒果糯米鸡“=内容}	1.翻译后的结果
越南语怎么说”雪碧“	{”雪碧“=内容, 越南语=语言}	1.翻译后的结果
意大利语怎么说“芒果糯米鸡“	{“芒果糯米鸡“=内容, 意大利语=语言}	1.翻译后的结果
斯瓦希里语怎么说”雪碧“	{斯瓦希里语=语言, ”雪碧“=内容}	1.翻译后的结果
西班牙语怎么说去美国旅行	{西班牙语=语言, 去美国旅行=内容}	1.翻译后的结果
越南语怎么说“芒果糯米鸡“	{“芒果糯米鸡“=内容, 越南语=语言}	1.翻译后的结果
朝鲜语怎么说我喜欢欧洲旅行	{朝鲜语=语言, 我喜欢欧洲旅行=内容}	1.翻译后的结果
德语怎么说我喜欢欧洲旅行	{德语=语言, 我喜欢欧洲旅行=内容}	1.翻译后的结果
日语怎么说”雪碧“	{日语=语言, ”雪碧“=内容}	1.翻译后的结果
德语怎么说”雪碧“	{德语=语言, ”雪碧“=内容}	1.翻译后的结果
意大利语怎么说去美国旅行	{去美国旅行=内容, 意大利语=语言}	1.翻译后的结果
阿拉伯语怎么说”雪碧“	{阿拉伯语=语言, ”雪碧“=内容}	1.翻译后的结果
”雪碧“怎么用阿拉伯语说	{阿拉伯语=语言, ”雪碧“=内容}	1.翻译后的结果
”雪碧“怎么用意大利语说	{意大利语=语言, ”雪碧“=内容}	1.翻译后的结果
去美国旅行怎么用法语说	{法语=语言, 去美国旅行=内容}	1.翻译后的结果
我喜欢欧洲旅行怎么用日语说	{日语=语言, 我喜欢欧洲旅行=内容}	1.翻译后的结果
我喜欢欧洲旅行怎么用英语说	{英语=语言, 我喜欢欧洲旅行=内容}	1.翻译后的结果
我喜欢欧洲旅行怎么用越南语说	{越南语=语言, 我喜欢欧洲旅行=内容}	1.翻译后的结果
去美国旅行怎么用俄语说	{俄语=语言, 去美国旅行=内容}	1.翻译后的结果
去美国旅行怎么用西班牙语说	{西班牙语=语言, 去美国旅行=内容}	1.翻译后的结果
我喜欢欧洲旅行怎么用韩语说	{韩语=语言, 我喜欢欧洲旅行=内容}	1.翻译后的结果
”雪碧“怎么用俄语说	{俄语=语言, ”雪碧“=内容}	1.翻译后的结果
“芒果糯米鸡“怎么用西班牙语说	{西班牙语=语言, “芒果糯米鸡“=内容}	1.翻译后的结果
“芒果糯米鸡“怎么用越南语说	{“芒果糯米鸡“=内容, 越南语=语言}	1.翻译后的结果
“芒果糯米鸡“怎么用朝鲜语说	{“芒果糯米鸡“=内容, 朝鲜语=语言}	1.翻译后的结果
“芒果糯米鸡“怎么用德语说	{“芒果糯米鸡“=内容, 德语=语言}	1.翻译后的结果
“芒果糯米鸡“怎么用英语说	{“芒果糯米鸡“=内容, 英语=语言}	1.翻译后的结果
我喜欢欧洲旅行怎么用阿拉伯语说	{阿拉伯语=语言, 我喜欢欧洲旅行=内容}	1.翻译后的结果
我喜欢欧洲旅行怎么用意大利语说	{意大利语=语言, 我喜欢欧洲旅行=内容}	1.翻译后的结果
去美国旅行怎么用阿拉伯语说	{阿拉伯语=语言, 去美国旅行=内容}	1.翻译后的结果
去美国旅行怎么用越南语说	{去美国旅行=内容, 越南语=语言}	1.翻译后的结果
”雪碧“怎么用法语说	{法语=语言, ”雪碧“=内容}	1.翻译后的结果
“芒果糯米鸡“怎么用意大利语说	{“芒果糯米鸡“=内容, 意大利语=语言}	1.翻译后的结果
去美国旅行怎么用斯瓦希里语说	{去美国旅行=内容, 斯瓦希里语=语言}	1.翻译后的结果
我喜欢欧洲旅行怎么用斯瓦希里语说	{斯瓦希里语=语言, 我喜欢欧洲旅行=内容}	1.翻译后的结果
我喜欢欧洲旅行怎么用泰米尔语说	{泰米尔语=语言, 我喜欢欧洲旅行=内容}	1.翻译后的结果
去美国旅行怎么用泰米尔语说	{去美国旅行=内容, 泰米尔语=语言}	1.翻译后的结果
”雪碧“怎么用德语说	{德语=语言, ”雪碧“=内容}	1.翻译后的结果
去美国旅行怎么用汉语说	{去美国旅行=内容, 汉语=语言}	1.翻译后的结果
”雪碧“怎么用西班牙语说	{西班牙语=语言, ”雪碧“=内容}	1.翻译后的结果
“芒果糯米鸡“怎么用日语说	{“芒果糯米鸡“=内容, 日语=语言}	1.翻译后的结果
“芒果糯米鸡“怎么用阿拉伯语说	{阿拉伯语=语言, “芒果糯米鸡“=内容}	1.翻译后的结果
怎么用越南语说”雪碧“	{”雪碧“=内容, 越南语=语言}	1.翻译后的结果
怎么用斯瓦希里语说”雪碧“	{斯瓦希里语=语言, ”雪碧“=内容}	1.翻译后的结果
怎么用泰米尔语说“芒果糯米鸡“	{“芒果糯米鸡“=内容, 泰米尔语=语言}	1.翻译后的结果
怎么用日语说“芒果糯米鸡“	{“芒果糯米鸡“=内容, 日语=语言}	1.翻译后的结果
怎么用韩语说我喜欢欧洲旅行	{韩语=语言, 我喜欢欧洲旅行=内容}	1.翻译后的结果
怎么用阿拉伯语说“芒果糯米鸡“	{阿拉伯语=语言, “芒果糯米鸡“=内容}	1.翻译后的结果
怎么用朝鲜语说去美国旅行	{朝鲜语=语言, 去美国旅行=内容}	1.翻译后的结果
怎么用德语说“芒果糯米鸡“	{“芒果糯米鸡“=内容, 德语=语言}	1.翻译后的结果
怎么用德语说”雪碧“	{德语=语言, ”雪碧“=内容}	1.翻译后的结果
怎么用韩语说去美国旅行	{韩语=语言, 去美国旅行=内容}	1.翻译后的结果
怎么用法语说“芒果糯米鸡“	{“芒果糯米鸡“=内容, 法语=语言}	1.翻译后的结果
怎么用英语说我喜欢欧洲旅行	{英语=语言, 我喜欢欧洲旅行=内容}	1.翻译后的结果
怎么用阿拉伯语说去美国旅行	{阿拉伯语=语言, 去美国旅行=内容}	1.翻译后的结果
怎么用日语说我喜欢欧洲旅行	{日语=语言, 我喜欢欧洲旅行=内容}	1.翻译后的结果
怎么用斯瓦希里语说我喜欢欧洲旅行	{斯瓦希里语=语言, 我喜欢欧洲旅行=内容}	1.翻译后的结果
怎么用西班牙语说我喜欢欧洲旅行	{西班牙语=语言, 我喜欢欧洲旅行=内容}	1.翻译后的结果
怎么用朝鲜语说”雪碧“	{朝鲜语=语言, ”雪碧“=内容}	1.翻译后的结果
怎么用意大利语说去美国旅行	{去美国旅行=内容, 意大利语=语言}	1.翻译后的结果
怎么用英语说去美国旅行	{去美国旅行=内容, 英语=语言}	1.翻译后的结果
怎么用日语说去美国旅行	{日语=语言, 去美国旅行=内容}	1.翻译后的结果
怎么用西班牙语说”雪碧“	{西班牙语=语言, ”雪碧“=内容}	1.翻译后的结果
怎么用斯瓦希里语说去美国旅行	{斯瓦希里语=语言, 去美国旅行=内容}	1.翻译后的结果
怎么用泰米尔语说我喜欢欧洲旅行	{泰米尔语=语言, 我喜欢欧洲旅行=内容}	1.翻译后的结果
怎么用法语说我喜欢欧洲旅行	{法语=语言, 我喜欢欧洲旅行=内容}	1.翻译后的结果
怎么用越南语说“芒果糯米鸡“	{“芒果糯米鸡“=内容, 越南语=语言}	1.翻译后的结果
怎么用汉语说我喜欢欧洲旅行	{汉语=语言, 我喜欢欧洲旅行=内容}	1.翻译后的结果
怎么用西班牙语说去美国旅行	{西班牙语=语言, 去美国旅行=内容}	1.翻译后的结果
怎么用汉语说去美国旅行	{去美国旅行=内容, 汉语=语言}	1.翻译后的结果
怎么用韩语说”雪碧“	{韩语=语言, ”雪碧“=内容}	1.翻译后的结果
怎么用汉语说“芒果糯米鸡“	{“芒果糯米鸡“=内容, 汉语=语言}	1.翻译后的结果
怎么用越南语说我喜欢欧洲旅行	{越南语=语言, 我喜欢欧洲旅行=内容}	1.翻译后的结果
怎么用英语说“芒果糯米鸡“	{“芒果糯米鸡“=内容, 英语=语言}	1.翻译后的结果
朝鲜语怎么表示我喜欢欧洲旅行	{朝鲜语=语言, 我喜欢欧洲旅行=内容}	1.翻译后的结果
英语怎么表示去美国旅行	{去美国旅行=内容, 英语=语言}	1.翻译后的结果
斯瓦希里语怎么表示我喜欢欧洲旅行	{斯瓦希里语=语言, 我喜欢欧洲旅行=内容}	1.翻译后的结果
越南语怎么表示”雪碧“	{”雪碧“=内容, 越南语=语言}	1.翻译后的结果
朝鲜语怎么表示“芒果糯米鸡“	{“芒果糯米鸡“=内容, 朝鲜语=语言}	1.翻译后的结果
意大利语怎么表示”雪碧“	{意大利语=语言, ”雪碧“=内容}	1.翻译后的结果
德语怎么表示”雪碧“	{德语=语言, ”雪碧“=内容}	1.翻译后的结果
西班牙语怎么表示我喜欢欧洲旅行	{西班牙语=语言, 我喜欢欧洲旅行=内容}	1.翻译后的结果
西班牙语怎么表示去美国旅行	{西班牙语=语言, 去美国旅行=内容}	1.翻译后的结果
英语怎么表示“芒果糯米鸡“	{“芒果糯米鸡“=内容, 英语=语言}	1.翻译后的结果
韩语怎么表示去美国旅行	{韩语=语言, 去美国旅行=内容}	1.翻译后的结果
俄语怎么表示我喜欢欧洲旅行	{俄语=语言, 我喜欢欧洲旅行=内容}	1.翻译后的结果
阿拉伯语怎么表示我喜欢欧洲旅行	{阿拉伯语=语言, 我喜欢欧洲旅行=内容}	1.翻译后的结果
俄语怎么表示去美国旅行	{俄语=语言, 去美国旅行=内容}	1.翻译后的结果
法语怎么表示去美国旅行	{法语=语言, 去美国旅行=内容}	1.翻译后的结果
法语怎么表示我喜欢欧洲旅行	{法语=语言, 我喜欢欧洲旅行=内容}	1.翻译后的结果
泰米尔语怎么表示我喜欢欧洲旅行	{泰米尔语=语言, 我喜欢欧洲旅行=内容}	1.翻译后的结果
俄语怎么表示“芒果糯米鸡“	{“芒果糯米鸡“=内容, 俄语=语言}	1.翻译后的结果
韩语怎么表示“芒果糯米鸡“	{“芒果糯米鸡“=内容, 韩语=语言}	1.翻译后的结果
德语怎么表示我喜欢欧洲旅行	{德语=语言, 我喜欢欧洲旅行=内容}	1.翻译后的结果
韩语怎么表示”雪碧“	{韩语=语言, ”雪碧“=内容}	1.翻译后的结果
德语怎么表示“芒果糯米鸡“	{“芒果糯米鸡“=内容, 德语=语言}	1.翻译后的结果
汉语怎么表示去美国旅行	{去美国旅行=内容, 汉语=语言}	1.翻译后的结果
阿拉伯语怎么表示“芒果糯米鸡“	{阿拉伯语=语言, “芒果糯米鸡“=内容}	1.翻译后的结果
越南语怎么表示“芒果糯米鸡“	{“芒果糯米鸡“=内容, 越南语=语言}	1.翻译后的结果
阿拉伯语怎么表示”雪碧“	{阿拉伯语=语言, ”雪碧“=内容}	1.翻译后的结果
越南语怎么表示去美国旅行	{去美国旅行=内容, 越南语=语言}	1.翻译后的结果
西班牙语怎么表示”雪碧“	{西班牙语=语言, ”雪碧“=内容}	1.翻译后的结果
汉语怎么表示我喜欢欧洲旅行	{汉语=语言, 我喜欢欧洲旅行=内容}	1.翻译后的结果
德语怎么表示去美国旅行	{去美国旅行=内容, 德语=语言}	1.翻译后的结果
斯瓦希里语怎么表示”雪碧“	{斯瓦希里语=语言, ”雪碧“=内容}	1.翻译后的结果
泰米尔语怎么表示”雪碧“	{泰米尔语=语言, ”雪碧“=内容}	1.翻译后的结果
意大利语怎么表示“芒果糯米鸡“	{“芒果糯米鸡“=内容, 意大利语=语言}	1.翻译后的结果
日语怎么表示“芒果糯米鸡“	{“芒果糯米鸡“=内容, 日语=语言}	1.翻译后的结果
意大利语怎么表示去美国旅行	{去美国旅行=内容, 意大利语=语言}	1.翻译后的结果
日语怎么表示”雪碧“	{日语=语言, ”雪碧“=内容}	1.翻译后的结果
越南语怎么表示我喜欢欧洲旅行	{越南语=语言, 我喜欢欧洲旅行=内容}	1.翻译后的结果
意大利语怎么表示我喜欢欧洲旅行	{意大利语=语言, 我喜欢欧洲旅行=内容}	1.翻译后的结果
日语怎么表示去美国旅行	{日语=语言, 去美国旅行=内容}	1.翻译后的结果
韩语怎么表示我喜欢欧洲旅行	{韩语=语言, 我喜欢欧洲旅行=内容}	1.翻译后的结果
阿拉伯语怎么表示去美国旅行	{阿拉伯语=语言, 去美国旅行=内容}	1.翻译后的结果
泰米尔语怎么表示去美国旅行	{泰米尔语=语言, 去美国旅行=内容}	1.翻译后的结果
朝鲜语怎么表示”雪碧“	{朝鲜语=语言, ”雪碧“=内容}	1.翻译后的结果
英语怎么表示”雪碧“	{英语=语言, ”雪碧“=内容}	1.翻译后的结果
”雪碧“怎么用意大利语表示	{意大利语=语言, ”雪碧“=内容}	1.翻译后的结果
去美国旅行怎么用意大利语表示	{去美国旅行=内容, 意大利语=语言}	1.翻译后的结果
我喜欢欧洲旅行怎么用西班牙语表示	{西班牙语=语言, 我喜欢欧洲旅行=内容}	1.翻译后的结果
”雪碧“怎么用韩语表示	{韩语=语言, ”雪碧“=内容}	1.翻译后的结果
我喜欢欧洲旅行怎么用阿拉伯语表示	{阿拉伯语=语言, 我喜欢欧洲旅行=内容}	1.翻译后的结果
去美国旅行怎么用越南语表示	{去美国旅行=内容, 越南语=语言}	1.翻译后的结果
去美国旅行怎么用斯瓦希里语表示	{去美国旅行=内容, 斯瓦希里语=语言}	1.翻译后的结果
“芒果糯米鸡“怎么用俄语表示	{“芒果糯米鸡“=内容, 俄语=语言}	1.翻译后的结果
“芒果糯米鸡“怎么用德语表示	{“芒果糯米鸡“=内容, 德语=语言}	1.翻译后的结果
去美国旅行怎么用英语表示	{去美国旅行=内容, 英语=语言}	1.翻译后的结果
”雪碧“怎么用阿拉伯语表示	{阿拉伯语=语言, ”雪碧“=内容}	1.翻译后的结果
”雪碧“怎么用汉语表示	{汉语=语言, ”雪碧“=内容}	1.翻译后的结果
“芒果糯米鸡“怎么用意大利语表示	{“芒果糯米鸡“=内容, 意大利语=语言}	1.翻译后的结果
“芒果糯米鸡“怎么用法语表示	{“芒果糯米鸡“=内容, 法语=语言}	1.翻译后的结果
”雪碧“怎么用斯瓦希里语表示	{斯瓦希里语=语言, ”雪碧“=内容}	1.翻译后的结果
我喜欢欧洲旅行怎么用意大利语表示	{意大利语=语言, 我喜欢欧洲旅行=内容}	1.翻译后的结果
”雪碧“怎么用法语表示	{法语=语言, ”雪碧“=内容}	1.翻译后的结果
我喜欢欧洲旅行怎么用英语表示	{英语=语言, 我喜欢欧洲旅行=内容}	1.翻译后的结果
去美国旅行怎么用朝鲜语表示	{去美国旅行=内容, 朝鲜语=语言}	1.翻译后的结果
去美国旅行怎么用韩语表示	{韩语=语言, 去美国旅行=内容}	1.翻译后的结果
我喜欢欧洲旅行怎么用法语表示	{法语=语言, 我喜欢欧洲旅行=内容}	1.翻译后的结果
”雪碧“怎么用德语表示	{德语=语言, ”雪碧“=内容}	1.翻译后的结果
”雪碧“怎么用泰米尔语表示	{泰米尔语=语言, ”雪碧“=内容}	1.翻译后的结果
“芒果糯米鸡“怎么用斯瓦希里语表示	{“芒果糯米鸡“=内容, 斯瓦希里语=语言}	1.翻译后的结果
”雪碧“怎么用俄语表示	{俄语=语言, ”雪碧“=内容}	1.翻译后的结果
我喜欢欧洲旅行怎么用朝鲜语表示	{朝鲜语=语言, 我喜欢欧洲旅行=内容}	1.翻译后的结果
去美国旅行怎么用德语表示	{去美国旅行=内容, 德语=语言}	1.翻译后的结果
我喜欢欧洲旅行怎么用汉语表示	{汉语=语言, 我喜欢欧洲旅行=内容}	1.翻译后的结果
”雪碧“怎么用西班牙语表示	{西班牙语=语言, ”雪碧“=内容}	1.翻译后的结果
“芒果糯米鸡“怎么用汉语表示	{“芒果糯米鸡“=内容, 汉语=语言}	1.翻译后的结果
”雪碧“怎么用朝鲜语表示	{朝鲜语=语言, ”雪碧“=内容}	1.翻译后的结果
“芒果糯米鸡“怎么用日语表示	{“芒果糯米鸡“=内容, 日语=语言}	1.翻译后的结果
怎么拿法语说我喜欢欧洲旅行	{法语=语言, 我喜欢欧洲旅行=内容}	1.翻译后的结果
怎么拿韩语说去美国旅行	{韩语=语言, 去美国旅行=内容}	1.翻译后的结果
怎么拿朝鲜语说”雪碧“	{朝鲜语=语言, ”雪碧“=内容}	1.翻译后的结果
怎么拿斯瓦希里语说我喜欢欧洲旅行	{斯瓦希里语=语言, 我喜欢欧洲旅行=内容}	1.翻译后的结果
怎么拿英语说”雪碧“	{英语=语言, ”雪碧“=内容}	1.翻译后的结果
怎么拿泰米尔语说“芒果糯米鸡“	{“芒果糯米鸡“=内容, 泰米尔语=语言}	1.翻译后的结果
怎么拿俄语说去美国旅行	{俄语=语言, 去美国旅行=内容}	1.翻译后的结果
怎么拿德语说”雪碧“	{德语=语言, ”雪碧“=内容}	1.翻译后的结果
怎么拿汉语说“芒果糯米鸡“	{“芒果糯米鸡“=内容, 汉语=语言}	1.翻译后的结果
怎么拿日语说”雪碧“	{日语=语言, ”雪碧“=内容}	1.翻译后的结果
怎么拿英语说我喜欢欧洲旅行	{英语=语言, 我喜欢欧洲旅行=内容}	1.翻译后的结果
怎么拿泰米尔语说我喜欢欧洲旅行	{泰米尔语=语言, 我喜欢欧洲旅行=内容}	1.翻译后的结果
怎么拿法语说去美国旅行	{法语=语言, 去美国旅行=内容}	1.翻译后的结果
怎么拿韩语说“芒果糯米鸡“	{“芒果糯米鸡“=内容, 韩语=语言}	1.翻译后的结果
怎么拿韩语说我喜欢欧洲旅行	{韩语=语言, 我喜欢欧洲旅行=内容}	1.翻译后的结果
怎么拿西班牙语说去美国旅行	{西班牙语=语言, 去美国旅行=内容}	1.翻译后的结果
怎么拿泰米尔语说”雪碧“	{泰米尔语=语言, ”雪碧“=内容}	1.翻译后的结果
怎么拿越南语说“芒果糯米鸡“	{“芒果糯米鸡“=内容, 越南语=语言}	1.翻译后的结果
怎么拿英语说去美国旅行	{去美国旅行=内容, 英语=语言}	1.翻译后的结果
怎么拿阿拉伯语说“芒果糯米鸡“	{阿拉伯语=语言, “芒果糯米鸡“=内容}	1.翻译后的结果
怎么拿意大利语说我喜欢欧洲旅行	{意大利语=语言, 我喜欢欧洲旅行=内容}	1.翻译后的结果
怎么拿越南语说我喜欢欧洲旅行	{越南语=语言, 我喜欢欧洲旅行=内容}	1.翻译后的结果
怎么拿朝鲜语说去美国旅行	{朝鲜语=语言, 去美国旅行=内容}	1.翻译后的结果
怎么拿越南语说”雪碧“	{”雪碧“=内容, 越南语=语言}	1.翻译后的结果
怎么拿阿拉伯语说去美国旅行	{阿拉伯语=语言, 去美国旅行=内容}	1.翻译后的结果
怎么拿汉语说去美国旅行	{去美国旅行=内容, 汉语=语言}	1.翻译后的结果
怎么拿朝鲜语说我喜欢欧洲旅行	{朝鲜语=语言, 我喜欢欧洲旅行=内容}	1.翻译后的结果
怎么拿意大利语说去美国旅行	{去美国旅行=内容, 意大利语=语言}	1.翻译后的结果
怎么拿意大利语说“芒果糯米鸡“	{“芒果糯米鸡“=内容, 意大利语=语言}	1.翻译后的结果
怎么拿德语说去美国旅行	{去美国旅行=内容, 德语=语言}	1.翻译后的结果
怎么拿朝鲜语说“芒果糯米鸡“	{“芒果糯米鸡“=内容, 朝鲜语=语言}	1.翻译后的结果
怎么拿俄语说”雪碧“	{俄语=语言, ”雪碧“=内容}	1.翻译后的结果
怎么拿斯瓦希里语说去美国旅行	{斯瓦希里语=语言, 去美国旅行=内容}	1.翻译后的结果
怎么拿韩语说”雪碧“	{韩语=语言, ”雪碧“=内容}	1.翻译后的结果
怎么拿汉语说我喜欢欧洲旅行	{汉语=语言, 我喜欢欧洲旅行=内容}	1.翻译后的结果
怎么拿日语说我喜欢欧洲旅行	{日语=语言, 我喜欢欧洲旅行=内容}	1.翻译后的结果
怎么拿西班牙语说”雪碧“	{西班牙语=语言, ”雪碧“=内容}	1.翻译后的结果
怎么拿法语说“芒果糯米鸡“	{“芒果糯米鸡“=内容, 法语=语言}	1.翻译后的结果
怎么拿西班牙语说我喜欢欧洲旅行	{西班牙语=语言, 我喜欢欧洲旅行=内容}	1.翻译后的结果
怎么拿越南语说去美国旅行	{去美国旅行=内容, 越南语=语言}	1.翻译后的结果
怎么拿俄语说“芒果糯米鸡“	{“芒果糯米鸡“=内容, 俄语=语言}	1.翻译后的结果
”雪碧“怎么拿日语说	{日语=语言, ”雪碧“=内容}	1.翻译后的结果
”雪碧“怎么拿法语说	{法语=语言, ”雪碧“=内容}	1.翻译后的结果
“芒果糯米鸡“怎么拿日语说	{“芒果糯米鸡“=内容, 日语=语言}	1.翻译后的结果
去美国旅行怎么拿朝鲜语说	{去美国旅行=内容, 朝鲜语=语言}	1.翻译后的结果
”雪碧“怎么拿英语说	{”雪碧“=内容, 英语=语言}	1.翻译后的结果
“芒果糯米鸡“怎么拿阿拉伯语说	{阿拉伯语=语言, “芒果糯米鸡“=内容}	1.翻译后的结果
“芒果糯米鸡“怎么拿英语说	{“芒果糯米鸡“=内容, 英语=语言}	1.翻译后的结果
”雪碧“怎么拿泰米尔语说	{泰米尔语=语言, ”雪碧“=内容}	1.翻译后的结果
“芒果糯米鸡“怎么拿西班牙语说	{西班牙语=语言, “芒果糯米鸡“=内容}	1.翻译后的结果
去美国旅行怎么拿汉语说	{去美国旅行=内容, 汉语=语言}	1.翻译后的结果
我喜欢欧洲旅行怎么拿法语说	{法语=语言, 我喜欢欧洲旅行=内容}	1.翻译后的结果
“芒果糯米鸡“怎么拿泰米尔语说	{“芒果糯米鸡“=内容, 泰米尔语=语言}	1.翻译后的结果
去美国旅行怎么拿英语说	{去美国旅行=内容, 英语=语言}	1.翻译后的结果
我喜欢欧洲旅行怎么拿越南语说	{越南语=语言, 我喜欢欧洲旅行=内容}	1.翻译后的结果
“芒果糯米鸡“怎么拿意大利语说	{“芒果糯米鸡“=内容, 意大利语=语言}	1.翻译后的结果
去美国旅行怎么拿德语说	{去美国旅行=内容, 德语=语言}	1.翻译后的结果
”雪碧“怎么拿俄语说	{俄语=语言, ”雪碧“=内容}	1.翻译后的结果
去美国旅行怎么拿斯瓦希里语说	{去美国旅行=内容, 斯瓦希里语=语言}	1.翻译后的结果
我喜欢欧洲旅行怎么拿英语说	{英语=语言, 我喜欢欧洲旅行=内容}	1.翻译后的结果
我喜欢欧洲旅行怎么拿德语说	{德语=语言, 我喜欢欧洲旅行=内容}	1.翻译后的结果
“芒果糯米鸡“怎么拿德语说	{“芒果糯米鸡“=内容, 德语=语言}	1.翻译后的结果
去美国旅行怎么拿法语说	{法语=语言, 去美国旅行=内容}	1.翻译后的结果
去美国旅行怎么拿越南语说	{去美国旅行=内容, 越南语=语言}	1.翻译后的结果
”雪碧“怎么拿西班牙语说	{西班牙语=语言, ”雪碧“=内容}	1.翻译后的结果
我喜欢欧洲旅行怎么拿泰米尔语说	{泰米尔语=语言, 我喜欢欧洲旅行=内容}	1.翻译后的结果
我喜欢欧洲旅行怎么拿意大利语说	{意大利语=语言, 我喜欢欧洲旅行=内容}	1.翻译后的结果
“芒果糯米鸡“怎么拿斯瓦希里语说	{“芒果糯米鸡“=内容, 斯瓦希里语=语言}	1.翻译后的结果
我喜欢欧洲旅行怎么拿日语说	{日语=语言, 我喜欢欧洲旅行=内容}	1.翻译后的结果
”雪碧“怎么拿意大利语说	{意大利语=语言, ”雪碧“=内容}	1.翻译后的结果
我喜欢欧洲旅行怎么拿阿拉伯语说	{阿拉伯语=语言, 我喜欢欧洲旅行=内容}	1.翻译后的结果
“芒果糯米鸡“怎么拿朝鲜语说	{“芒果糯米鸡“=内容, 朝鲜语=语言}	1.翻译后的结果
“芒果糯米鸡“怎么拿俄语说	{“芒果糯米鸡“=内容, 俄语=语言}	1.翻译后的结果
去美国旅行怎么拿意大利语说	{去美国旅行=内容, 意大利语=语言}	1.翻译后的结果
“芒果糯米鸡“怎么拿汉语说	{“芒果糯米鸡“=内容, 汉语=语言}	1.翻译后的结果
“芒果糯米鸡“怎么拿法语说	{“芒果糯米鸡“=内容, 法语=语言}	1.翻译后的结果
“芒果糯米鸡“怎么拿越南语说	{“芒果糯米鸡“=内容, 越南语=语言}	1.翻译后的结果
去美国旅行怎么拿泰米尔语说	{去美国旅行=内容, 泰米尔语=语言}	1.翻译后的结果
”雪碧“怎么拿德语说	{德语=语言, ”雪碧“=内容}	1.翻译后的结果
我喜欢欧洲旅行怎么拿斯瓦希里语说	{斯瓦希里语=语言, 我喜欢欧洲旅行=内容}	1.翻译后的结果
意大利语的去美国旅行怎么说	{去美国旅行=内容, 意大利语=语言}	1.翻译后的结果
英语的我喜欢欧洲旅行怎么说	{英语=语言, 我喜欢欧洲旅行=内容}	1.翻译后的结果
德语的”雪碧“怎么说	{德语=语言, ”雪碧“=内容}	1.翻译后的结果
韩语的去美国旅行怎么说	{韩语=语言, 去美国旅行=内容}	1.翻译后的结果
阿拉伯语的去美国旅行怎么说	{阿拉伯语=语言, 去美国旅行=内容}	1.翻译后的结果
阿拉伯语的”雪碧“怎么说	{阿拉伯语=语言, ”雪碧“=内容}	1.翻译后的结果
朝鲜语的我喜欢欧洲旅行怎么说	{朝鲜语=语言, 我喜欢欧洲旅行=内容}	1.翻译后的结果
英语的”雪碧“怎么说	{英语=语言, ”雪碧“=内容}	1.翻译后的结果
俄语的去美国旅行怎么说	{俄语=语言, 去美国旅行=内容}	1.翻译后的结果
汉语的我喜欢欧洲旅行怎么说	{汉语=语言, 我喜欢欧洲旅行=内容}	1.翻译后的结果
汉语的”雪碧“怎么说	{汉语=语言, ”雪碧“=内容}	1.翻译后的结果
阿拉伯语的我喜欢欧洲旅行怎么说	{阿拉伯语=语言, 我喜欢欧洲旅行=内容}	1.翻译后的结果
西班牙语的“芒果糯米鸡“怎么说	{西班牙语=语言, “芒果糯米鸡“=内容}	1.翻译后的结果
英语的去美国旅行怎么说	{去美国旅行=内容, 英语=语言}	1.翻译后的结果
越南语的我喜欢欧洲旅行怎么说	{越南语=语言, 我喜欢欧洲旅行=内容}	1.翻译后的结果
泰米尔语的去美国旅行怎么说	{泰米尔语=语言, 去美国旅行=内容}	1.翻译后的结果
法语的去美国旅行怎么说	{法语=语言, 去美国旅行=内容}	1.翻译后的结果
德语的“芒果糯米鸡“怎么说	{“芒果糯米鸡“=内容, 德语=语言}	1.翻译后的结果
韩语的”雪碧“怎么说	{韩语=语言, ”雪碧“=内容}	1.翻译后的结果
俄语的我喜欢欧洲旅行怎么说	{俄语=语言, 我喜欢欧洲旅行=内容}	1.翻译后的结果
德语的去美国旅行怎么说	{去美国旅行=内容, 德语=语言}	1.翻译后的结果
日语的去美国旅行怎么说	{日语=语言, 去美国旅行=内容}	1.翻译后的结果
俄语的“芒果糯米鸡“怎么说	{“芒果糯米鸡“=内容, 俄语=语言}	1.翻译后的结果
俄语的”雪碧“怎么说	{俄语=语言, ”雪碧“=内容}	1.翻译后的结果
韩语的我喜欢欧洲旅行怎么说	{韩语=语言, 我喜欢欧洲旅行=内容}	1.翻译后的结果
西班牙语的我喜欢欧洲旅行怎么说	{西班牙语=语言, 我喜欢欧洲旅行=内容}	1.翻译后的结果
泰米尔语的”雪碧“怎么说	{泰米尔语=语言, ”雪碧“=内容}	1.翻译后的结果
朝鲜语的去美国旅行怎么说	{朝鲜语=语言, 去美国旅行=内容}	1.翻译后的结果
法语的我喜欢欧洲旅行怎么说	{法语=语言, 我喜欢欧洲旅行=内容}	1.翻译后的结果
斯瓦希里语的我喜欢欧洲旅行怎么说	{斯瓦希里语=语言, 我喜欢欧洲旅行=内容}	1.翻译后的结果
泰米尔语的我喜欢欧洲旅行怎么说	{泰米尔语=语言, 我喜欢欧洲旅行=内容}	1.翻译后的结果
意大利语的“芒果糯米鸡“怎么说	{“芒果糯米鸡“=内容, 意大利语=语言}	1.翻译后的结果
斯瓦希里语的“芒果糯米鸡“怎么说	{“芒果糯米鸡“=内容, 斯瓦希里语=语言}	1.翻译后的结果
“芒果糯米鸡“的西班牙语怎么说	{西班牙语=语言, “芒果糯米鸡“=内容}	1.翻译后的结果
“芒果糯米鸡“的朝鲜语怎么说	{“芒果糯米鸡“=内容, 朝鲜语=语言}	1.翻译后的结果
”雪碧“的意大利语怎么说	{意大利语=语言, ”雪碧“=内容}	1.翻译后的结果
“芒果糯米鸡“的德语怎么说	{“芒果糯米鸡“=内容, 德语=语言}	1.翻译后的结果
“芒果糯米鸡“的法语怎么说	{“芒果糯米鸡“=内容, 法语=语言}	1.翻译后的结果
去美国旅行的俄语怎么说	{俄语=语言, 去美国旅行=内容}	1.翻译后的结果
去美国旅行的意大利语怎么说	{去美国旅行=内容, 意大利语=语言}	1.翻译后的结果
去美国旅行的德语怎么说	{去美国旅行=内容, 德语=语言}	1.翻译后的结果
去美国旅行的西班牙语怎么说	{西班牙语=语言, 去美国旅行=内容}	1.翻译后的结果
去美国旅行的泰米尔语怎么说	{去美国旅行=内容, 泰米尔语=语言}	1.翻译后的结果
我喜欢欧洲旅行的西班牙语怎么说	{西班牙语=语言, 我喜欢欧洲旅行=内容}	1.翻译后的结果
”雪碧“的德语怎么说	{德语=语言, ”雪碧“=内容}	1.翻译后的结果
”雪碧“的韩语怎么说	{韩语=语言, ”雪碧“=内容}	1.翻译后的结果
”雪碧“的越南语怎么说	{”雪碧“=内容, 越南语=语言}	1.翻译后的结果
”雪碧“的阿拉伯语怎么说	{阿拉伯语=语言, ”雪碧“=内容}	1.翻译后的结果
”雪碧“的俄语怎么说	{俄语=语言, ”雪碧“=内容}	1.翻译后的结果
我喜欢欧洲旅行的越南语怎么说	{越南语=语言, 我喜欢欧洲旅行=内容}	1.翻译后的结果
去美国旅行的越南语怎么说	{去美国旅行=内容, 越南语=语言}	1.翻译后的结果
我喜欢欧洲旅行的日语怎么说	{日语=语言, 我喜欢欧洲旅行=内容}	1.翻译后的结果
去美国旅行的日语怎么说	{日语=语言, 去美国旅行=内容}	1.翻译后的结果
“芒果糯米鸡“的日语怎么说	{“芒果糯米鸡“=内容, 日语=语言}	1.翻译后的结果
我喜欢欧洲旅行的斯瓦希里语怎么说	{斯瓦希里语=语言, 我喜欢欧洲旅行=内容}	1.翻译后的结果
”雪碧“的泰米尔语怎么说	{泰米尔语=语言, ”雪碧“=内容}	1.翻译后的结果
我喜欢欧洲旅行的汉语怎么说	{汉语=语言, 我喜欢欧洲旅行=内容}	1.翻译后的结果
我喜欢欧洲旅行的意大利语怎么说	{意大利语=语言, 我喜欢欧洲旅行=内容}	1.翻译后的结果
去美国旅行的英语怎么说	{去美国旅行=内容, 英语=语言}	1.翻译后的结果
去美国旅行的汉语怎么说	{去美国旅行=内容, 汉语=语言}	1.翻译后的结果
“芒果糯米鸡“的越南语怎么说	{“芒果糯米鸡“=内容, 越南语=语言}	1.翻译后的结果
“芒果糯米鸡“的英语怎么说	{“芒果糯米鸡“=内容, 英语=语言}	1.翻译后的结果
”雪碧“的法语怎么说	{法语=语言, ”雪碧“=内容}	1.翻译后的结果
去美国旅行的阿拉伯语怎么说	{阿拉伯语=语言, 去美国旅行=内容}	1.翻译后的结果
我喜欢欧洲旅行的英语怎么说	{英语=语言, 我喜欢欧洲旅行=内容}	1.翻译后的结果
“芒果糯米鸡“的泰米尔语怎么说	{“芒果糯米鸡“=内容, 泰米尔语=语言}	1.翻译后的结果
“芒果糯米鸡“的俄语怎么说	{“芒果糯米鸡“=内容, 俄语=语言}	1.翻译后的结果
我喜欢欧洲旅行的朝鲜语怎么说	{朝鲜语=语言, 我喜欢欧洲旅行=内容}	1.翻译后的结果
我喜欢欧洲旅行的韩语怎么说	{韩语=语言, 我喜欢欧洲旅行=内容}	1.翻译后的结果
“芒果糯米鸡“的意大利语怎么说	{“芒果糯米鸡“=内容, 意大利语=语言}	1.翻译后的结果
“芒果糯米鸡“的斯瓦希里语怎么说	{“芒果糯米鸡“=内容, 斯瓦希里语=语言}	1.翻译后的结果
我喜欢欧洲旅行的法语怎么说	{法语=语言, 我喜欢欧洲旅行=内容}	1.翻译后的结果
怎么说“芒果糯米鸡“的法语	{“芒果糯米鸡“=内容, 法语=语言}	1.翻译后的结果
怎么说”雪碧“的泰米尔语	{泰米尔语=语言, ”雪碧“=内容}	1.翻译后的结果
怎么说”雪碧“的越南语	{”雪碧“=内容, 越南语=语言}	1.翻译后的结果
怎么说“芒果糯米鸡“的越南语	{“芒果糯米鸡“=内容, 越南语=语言}	1.翻译后的结果
怎么说我喜欢欧洲旅行的斯瓦希里语	{斯瓦希里语=语言, 我喜欢欧洲旅行=内容}	1.翻译后的结果
怎么说我喜欢欧洲旅行的日语	{日语=语言, 我喜欢欧洲旅行=内容}	1.翻译后的结果
怎么说“芒果糯米鸡“的德语	{“芒果糯米鸡“=内容, 德语=语言}	1.翻译后的结果
怎么说“芒果糯米鸡“的日语	{“芒果糯米鸡“=内容, 日语=语言}	1.翻译后的结果
怎么说去美国旅行的韩语	{韩语=语言, 去美国旅行=内容}	1.翻译后的结果
怎么说”雪碧“的日语	{日语=语言, ”雪碧“=内容}	1.翻译后的结果
怎么说去美国旅行的法语	{法语=语言, 去美国旅行=内容}	1.翻译后的结果
怎么说”雪碧“的法语	{法语=语言, ”雪碧“=内容}	1.翻译后的结果
怎么说”雪碧“的汉语	{汉语=语言, ”雪碧“=内容}	1.翻译后的结果
怎么说去美国旅行的德语	{去美国旅行=内容, 德语=语言}	1.翻译后的结果
怎么说去美国旅行的阿拉伯语	{阿拉伯语=语言, 去美国旅行=内容}	1.翻译后的结果
怎么说我喜欢欧洲旅行的韩语	{韩语=语言, 我喜欢欧洲旅行=内容}	1.翻译后的结果
怎么说“芒果糯米鸡“的斯瓦希里语	{“芒果糯米鸡“=内容, 斯瓦希里语=语言}	1.翻译后的结果
怎么说我喜欢欧洲旅行的法语	{法语=语言, 我喜欢欧洲旅行=内容}	1.翻译后的结果
怎么说去美国旅行的越南语	{去美国旅行=内容, 越南语=语言}	1.翻译后的结果
怎么说”雪碧“的德语	{德语=语言, ”雪碧“=内容}	1.翻译后的结果
怎么说“芒果糯米鸡“的意大利语	{“芒果糯米鸡“=内容, 意大利语=语言}	1.翻译后的结果
怎么说我喜欢欧洲旅行的意大利语	{意大利语=语言, 我喜欢欧洲旅行=内容}	1.翻译后的结果
怎么说“芒果糯米鸡“的俄语	{“芒果糯米鸡“=内容, 俄语=语言}	1.翻译后的结果
怎么说”雪碧“的俄语	{俄语=语言, ”雪碧“=内容}	1.翻译后的结果
怎么说我喜欢欧洲旅行的泰米尔语	{泰米尔语=语言, 我喜欢欧洲旅行=内容}	1.翻译后的结果
怎么说去美国旅行的英语	{去美国旅行=内容, 英语=语言}	1.翻译后的结果
怎么说”雪碧“的朝鲜语	{朝鲜语=语言, ”雪碧“=内容}	1.翻译后的结果
怎么说我喜欢欧洲旅行的越南语	{越南语=语言, 我喜欢欧洲旅行=内容}	1.翻译后的结果
怎么说去美国旅行的泰米尔语	{去美国旅行=内容, 泰米尔语=语言}	1.翻译后的结果
怎么说我喜欢欧洲旅行的俄语	{俄语=语言, 我喜欢欧洲旅行=内容}	1.翻译后的结果
怎么说我喜欢欧洲旅行的英语	{英语=语言, 我喜欢欧洲旅行=内容}	1.翻译后的结果
怎么说”雪碧“的阿拉伯语	{阿拉伯语=语言, ”雪碧“=内容}	1.翻译后的结果
怎么说去美国旅行的日语	{日语=语言, 去美国旅行=内容}	1.翻译后的结果
怎么说我喜欢欧洲旅行的汉语	{汉语=语言, 我喜欢欧洲旅行=内容}	1.翻译后的结果
怎么说去美国旅行的西班牙语	{西班牙语=语言, 去美国旅行=内容}	1.翻译后的结果
怎么说”雪碧“的斯瓦希里语	{斯瓦希里语=语言, ”雪碧“=内容}	1.翻译后的结果
怎么说我喜欢欧洲旅行的阿拉伯语	{阿拉伯语=语言, 我喜欢欧洲旅行=内容}	1.翻译后的结果
怎么说“芒果糯米鸡“的英语	{“芒果糯米鸡“=内容, 英语=语言}	1.翻译后的结果
去美国旅行翻译成朝鲜语	{去美国旅行=内容, 朝鲜语=语言}	1.翻译后的结果
我喜欢欧洲旅行翻译成韩语	{韩语=语言, 我喜欢欧洲旅行=内容}	1.翻译后的结果
去美国旅行翻译成汉语	{去美国旅行=内容, 汉语=语言}	1.翻译后的结果
我喜欢欧洲旅行翻译成俄语	{俄语=语言, 我喜欢欧洲旅行=内容}	1.翻译后的结果
“芒果糯米鸡“翻译成英语	{“芒果糯米鸡“=内容, 英语=语言}	1.翻译后的结果
”雪碧“翻译成俄语	{俄语=语言, ”雪碧“=内容}	1.翻译后的结果
我喜欢欧洲旅行翻译成日语	{日语=语言, 我喜欢欧洲旅行=内容}	1.翻译后的结果
我喜欢欧洲旅行翻译成德语	{德语=语言, 我喜欢欧洲旅行=内容}	1.翻译后的结果
“芒果糯米鸡“翻译成越南语	{“芒果糯米鸡“=内容, 越南语=语言}	1.翻译后的结果
去美国旅行翻译成泰米尔语	{去美国旅行=内容, 泰米尔语=语言}	1.翻译后的结果
“芒果糯米鸡“翻译成意大利语	{“芒果糯米鸡“=内容, 意大利语=语言}	1.翻译后的结果
我喜欢欧洲旅行翻译成西班牙语	{西班牙语=语言, 我喜欢欧洲旅行=内容}	1.翻译后的结果
”雪碧“翻译成英语	{”雪碧“=内容, 英语=语言}	1.翻译后的结果
“芒果糯米鸡“翻译成斯瓦希里语	{“芒果糯米鸡“=内容, 斯瓦希里语=语言}	1.翻译后的结果
”雪碧“翻译成越南语	{”雪碧“=内容, 越南语=语言}	1.翻译后的结果
”雪碧“翻译成法语	{法语=语言, ”雪碧“=内容}	1.翻译后的结果
去美国旅行翻译成日语	{日语=语言, 去美国旅行=内容}	1.翻译后的结果
”雪碧“翻译成德语	{德语=语言, ”雪碧“=内容}	1.翻译后的结果
“芒果糯米鸡“翻译成汉语	{“芒果糯米鸡“=内容, 汉语=语言}	1.翻译后的结果
“芒果糯米鸡“翻译成韩语	{“芒果糯米鸡“=内容, 韩语=语言}	1.翻译后的结果
“芒果糯米鸡“翻译成朝鲜语	{“芒果糯米鸡“=内容, 朝鲜语=语言}	1.翻译后的结果
“芒果糯米鸡“翻译成泰米尔语	{“芒果糯米鸡“=内容, 泰米尔语=语言}	1.翻译后的结果
去美国旅行翻译成阿拉伯语	{阿拉伯语=语言, 去美国旅行=内容}	1.翻译后的结果
去美国旅行翻译成韩语	{韩语=语言, 去美国旅行=内容}	1.翻译后的结果
“芒果糯米鸡“翻译成俄语	{“芒果糯米鸡“=内容, 俄语=语言}	1.翻译后的结果
我喜欢欧洲旅行翻译成泰米尔语	{泰米尔语=语言, 我喜欢欧洲旅行=内容}	1.翻译后的结果
我喜欢欧洲旅行翻译成汉语	{汉语=语言, 我喜欢欧洲旅行=内容}	1.翻译后的结果
我喜欢欧洲旅行翻译成法语	{法语=语言, 我喜欢欧洲旅行=内容}	1.翻译后的结果
去美国旅行翻译成法语	{法语=语言, 去美国旅行=内容}	1.翻译后的结果
“芒果糯米鸡“翻译成法语	{“芒果糯米鸡“=内容, 法语=语言}	1.翻译后的结果
”雪碧“翻译成韩语	{韩语=语言, ”雪碧“=内容}	1.翻译后的结果
去美国旅行翻译成越南语	{去美国旅行=内容, 越南语=语言}	1.翻译后的结果
“芒果糯米鸡“翻译成阿拉伯语	{阿拉伯语=语言, “芒果糯米鸡“=内容}	1.翻译后的结果
”雪碧“翻译成朝鲜语	{朝鲜语=语言, ”雪碧“=内容}	1.翻译后的结果
去美国旅行翻译成西班牙语	{西班牙语=语言, 去美国旅行=内容}	1.翻译后的结果
”雪碧“翻译成日语	{日语=语言, ”雪碧“=内容}	1.翻译后的结果
”雪碧“翻译成西班牙语	{西班牙语=语言, ”雪碧“=内容}	1.翻译后的结果
去美国旅行翻译成意大利语	{去美国旅行=内容, 意大利语=语言}	1.翻译后的结果
我喜欢欧洲旅行翻译成越南语	{越南语=语言, 我喜欢欧洲旅行=内容}	1.翻译后的结果
我喜欢欧洲旅行翻译成英语	{英语=语言, 我喜欢欧洲旅行=内容}	1.翻译后的结果
”雪碧“翻译成意大利语	{意大利语=语言, ”雪碧“=内容}	1.翻译后的结果
英语的”雪碧“怎么翻译	{英语=语言, ”雪碧“=内容}	1.翻译后的结果
西班牙语的去美国旅行怎么翻译	{西班牙语=语言, 去美国旅行=内容}	1.翻译后的结果
越南语的去美国旅行怎么翻译	{去美国旅行=内容, 越南语=语言}	1.翻译后的结果
意大利语的“芒果糯米鸡“怎么翻译	{“芒果糯米鸡“=内容, 意大利语=语言}	1.翻译后的结果
斯瓦希里语的”雪碧“怎么翻译	{斯瓦希里语=语言, ”雪碧“=内容}	1.翻译后的结果
朝鲜语的去美国旅行怎么翻译	{朝鲜语=语言, 去美国旅行=内容}	1.翻译后的结果
泰米尔语的去美国旅行怎么翻译	{泰米尔语=语言, 去美国旅行=内容}	1.翻译后的结果
越南语的我喜欢欧洲旅行怎么翻译	{越南语=语言, 我喜欢欧洲旅行=内容}	1.翻译后的结果
越南语的”雪碧“怎么翻译	{”雪碧“=内容, 越南语=语言}	1.翻译后的结果
西班牙语的我喜欢欧洲旅行怎么翻译	{西班牙语=语言, 我喜欢欧洲旅行=内容}	1.翻译后的结果
法语的”雪碧“怎么翻译	{法语=语言, ”雪碧“=内容}	1.翻译后的结果
西班牙语的”雪碧“怎么翻译	{西班牙语=语言, ”雪碧“=内容}	1.翻译后的结果
德语的“芒果糯米鸡“怎么翻译	{“芒果糯米鸡“=内容, 德语=语言}	1.翻译后的结果
英语的我喜欢欧洲旅行怎么翻译	{英语=语言, 我喜欢欧洲旅行=内容}	1.翻译后的结果
阿拉伯语的我喜欢欧洲旅行怎么翻译	{阿拉伯语=语言, 我喜欢欧洲旅行=内容}	1.翻译后的结果
俄语的“芒果糯米鸡“怎么翻译	{“芒果糯米鸡“=内容, 俄语=语言}	1.翻译后的结果
泰米尔语的”雪碧“怎么翻译	{泰米尔语=语言, ”雪碧“=内容}	1.翻译后的结果
斯瓦希里语的我喜欢欧洲旅行怎么翻译	{斯瓦希里语=语言, 我喜欢欧洲旅行=内容}	1.翻译后的结果
西班牙语的“芒果糯米鸡“怎么翻译	{西班牙语=语言, “芒果糯米鸡“=内容}	1.翻译后的结果
朝鲜语的“芒果糯米鸡“怎么翻译	{“芒果糯米鸡“=内容, 朝鲜语=语言}	1.翻译后的结果
俄语的”雪碧“怎么翻译	{俄语=语言, ”雪碧“=内容}	1.翻译后的结果
德语的我喜欢欧洲旅行怎么翻译	{德语=语言, 我喜欢欧洲旅行=内容}	1.翻译后的结果
俄语的我喜欢欧洲旅行怎么翻译	{俄语=语言, 我喜欢欧洲旅行=内容}	1.翻译后的结果
法语的“芒果糯米鸡“怎么翻译	{“芒果糯米鸡“=内容, 法语=语言}	1.翻译后的结果
意大利语的”雪碧“怎么翻译	{意大利语=语言, ”雪碧“=内容}	1.翻译后的结果
韩语的”雪碧“怎么翻译	{韩语=语言, ”雪碧“=内容}	1.翻译后的结果
日语怎么翻译去美国旅行	{日语=语言, 去美国旅行=内容}	1.翻译后的结果
德语怎么翻译“芒果糯米鸡“	{“芒果糯米鸡“=内容, 德语=语言}	1.翻译后的结果
西班牙语怎么翻译我喜欢欧洲旅行	{西班牙语=语言, 我喜欢欧洲旅行=内容}	1.翻译后的结果
越南语怎么翻译我喜欢欧洲旅行	{越南语=语言, 我喜欢欧洲旅行=内容}	1.翻译后的结果
汉语怎么翻译去美国旅行	{去美国旅行=内容, 汉语=语言}	1.翻译后的结果
俄语怎么翻译“芒果糯米鸡“	{“芒果糯米鸡“=内容, 俄语=语言}	1.翻译后的结果
英语怎么翻译我喜欢欧洲旅行	{英语=语言, 我喜欢欧洲旅行=内容}	1.翻译后的结果
德语怎么翻译我喜欢欧洲旅行	{德语=语言, 我喜欢欧洲旅行=内容}	1.翻译后的结果
法语怎么翻译“芒果糯米鸡“	{“芒果糯米鸡“=内容, 法语=语言}	1.翻译后的结果
俄语怎么翻译”雪碧“	{俄语=语言, ”雪碧“=内容}	1.翻译后的结果
斯瓦希里语怎么翻译“芒果糯米鸡“	{“芒果糯米鸡“=内容, 斯瓦希里语=语言}	1.翻译后的结果
韩语怎么翻译“芒果糯米鸡“	{“芒果糯米鸡“=内容, 韩语=语言}	1.翻译后的结果
德语怎么翻译去美国旅行	{去美国旅行=内容, 德语=语言}	1.翻译后的结果
意大利语怎么翻译去美国旅行	{去美国旅行=内容, 意大利语=语言}	1.翻译后的结果
朝鲜语怎么翻译”雪碧“	{朝鲜语=语言, ”雪碧“=内容}	1.翻译后的结果
阿拉伯语怎么翻译“芒果糯米鸡“	{阿拉伯语=语言, “芒果糯米鸡“=内容}	1.翻译后的结果
斯瓦希里语怎么翻译”雪碧“	{斯瓦希里语=语言, ”雪碧“=内容}	1.翻译后的结果
韩语怎么翻译”雪碧“	{韩语=语言, ”雪碧“=内容}	1.翻译后的结果
汉语怎么翻译”雪碧“	{汉语=语言, ”雪碧“=内容}	1.翻译后的结果
斯瓦希里语怎么翻译我喜欢欧洲旅行	{斯瓦希里语=语言, 我喜欢欧洲旅行=内容}	1.翻译后的结果
朝鲜语怎么翻译我喜欢欧洲旅行	{朝鲜语=语言, 我喜欢欧洲旅行=内容}	1.翻译后的结果
朝鲜语怎么翻译“芒果糯米鸡“	{“芒果糯米鸡“=内容, 朝鲜语=语言}	1.翻译后的结果
西班牙语怎么翻译”雪碧“	{西班牙语=语言, ”雪碧“=内容}	1.翻译后的结果
韩语怎么翻译去美国旅行	{韩语=语言, 去美国旅行=内容}	1.翻译后的结果
日语怎么翻译”雪碧“	{日语=语言, ”雪碧“=内容}	1.翻译后的结果
西班牙语怎么翻译去美国旅行	{西班牙语=语言, 去美国旅行=内容}	1.翻译后的结果
西班牙语怎么翻译“芒果糯米鸡“	{西班牙语=语言, “芒果糯米鸡“=内容}	1.翻译后的结果
俄语怎么翻译我喜欢欧洲旅行	{俄语=语言, 我喜欢欧洲旅行=内容}	1.翻译后的结果
俄语怎么翻译去美国旅行	{俄语=语言, 去美国旅行=内容}	1.翻译后的结果
意大利语怎么翻译“芒果糯米鸡“	{“芒果糯米鸡“=内容, 意大利语=语言}	1.翻译后的结果
韩语怎么翻译我喜欢欧洲旅行	{韩语=语言, 我喜欢欧洲旅行=内容}	1.翻译后的结果
阿拉伯语怎么翻译”雪碧“	{阿拉伯语=语言, ”雪碧“=内容}	1.翻译后的结果
英语怎么翻译“芒果糯米鸡“	{“芒果糯米鸡“=内容, 英语=语言}	1.翻译后的结果
汉语怎么翻译“芒果糯米鸡“	{“芒果糯米鸡“=内容, 汉语=语言}	1.翻译后的结果
越南语怎么翻译“芒果糯米鸡“	{“芒果糯米鸡“=内容, 越南语=语言}	1.翻译后的结果
意大利语怎么翻译我喜欢欧洲旅行	{意大利语=语言, 我喜欢欧洲旅行=内容}	1.翻译后的结果
越南语怎么翻译去美国旅行	{去美国旅行=内容, 越南语=语言}	1.翻译后的结果
日语怎么翻译我喜欢欧洲旅行	{日语=语言, 我喜欢欧洲旅行=内容}	1.翻译后的结果
法语怎么翻译去美国旅行	{法语=语言, 去美国旅行=内容}	1.翻译后的结果
法语怎么翻译我喜欢欧洲旅行	{法语=语言, 我喜欢欧洲旅行=内容}	1.翻译后的结果
泰米尔语怎么翻译去美国旅行	{泰米尔语=语言, 去美国旅行=内容}	1.翻译后的结果
斯瓦希里语怎么翻译去美国旅行	{斯瓦希里语=语言, 去美国旅行=内容}	1.翻译后的结果
泰米尔语怎么翻译我喜欢欧洲旅行	{泰米尔语=语言, 我喜欢欧洲旅行=内容}	1.翻译后的结果
意大利语怎么翻译”雪碧“	{意大利语=语言, ”雪碧“=内容}	1.翻译后的结果
把去美国旅行翻译成日语	{日语=语言, 去美国旅行=内容}	1.翻译后的结果
把”雪碧“翻译成韩语	{韩语=语言, ”雪碧“=内容}	1.翻译后的结果
把我喜欢欧洲旅行翻译成韩语	{韩语=语言, 我喜欢欧洲旅行=内容}	1.翻译后的结果
把”雪碧“翻译成越南语	{”雪碧“=内容, 越南语=语言}	1.翻译后的结果
把“芒果糯米鸡“翻译成汉语	{“芒果糯米鸡“=内容, 汉语=语言}	1.翻译后的结果
把我喜欢欧洲旅行翻译成日语	{日语=语言, 我喜欢欧洲旅行=内容}	1.翻译后的结果
把我喜欢欧洲旅行翻译成俄语	{俄语=语言, 我喜欢欧洲旅行=内容}	1.翻译后的结果
把”雪碧“翻译成汉语	{汉语=语言, ”雪碧“=内容}	1.翻译后的结果
把去美国旅行翻译成汉语	{去美国旅行=内容, 汉语=语言}	1.翻译后的结果
把“芒果糯米鸡“翻译成阿拉伯语	{阿拉伯语=语言, “芒果糯米鸡“=内容}	1.翻译后的结果
把”雪碧“翻译成法语	{法语=语言, ”雪碧“=内容}	1.翻译后的结果
把”雪碧“翻译成朝鲜语	{朝鲜语=语言, ”雪碧“=内容}	1.翻译后的结果
把去美国旅行翻译成意大利语	{去美国旅行=内容, 意大利语=语言}	1.翻译后的结果
把“芒果糯米鸡“翻译成英语	{“芒果糯米鸡“=内容, 英语=语言}	1.翻译后的结果
把“芒果糯米鸡“翻译成德语	{“芒果糯米鸡“=内容, 德语=语言}	1.翻译后的结果
把我喜欢欧洲旅行翻译成英语	{英语=语言, 我喜欢欧洲旅行=内容}	1.翻译后的结果
把我喜欢欧洲旅行翻译成西班牙语	{西班牙语=语言, 我喜欢欧洲旅行=内容}	1.翻译后的结果
把我喜欢欧洲旅行翻译成越南语	{越南语=语言, 我喜欢欧洲旅行=内容}	1.翻译后的结果
把去美国旅行翻译成韩语	{韩语=语言, 去美国旅行=内容}	1.翻译后的结果
把去美国旅行翻译成西班牙语	{西班牙语=语言, 去美国旅行=内容}	1.翻译后的结果
把去美国旅行翻译成斯瓦希里语	{去美国旅行=内容, 斯瓦希里语=语言}	1.翻译后的结果
把我喜欢欧洲旅行翻译成朝鲜语	{朝鲜语=语言, 我喜欢欧洲旅行=内容}	1.翻译后的结果
把我喜欢欧洲旅行翻译成斯瓦希里语	{斯瓦希里语=语言, 我喜欢欧洲旅行=内容}	1.翻译后的结果
把去美国旅行翻译成俄语	{俄语=语言, 去美国旅行=内容}	1.翻译后的结果
把“芒果糯米鸡“翻译成朝鲜语	{“芒果糯米鸡“=内容, 朝鲜语=语言}	1.翻译后的结果
把去美国旅行翻译成泰米尔语	{去美国旅行=内容, 泰米尔语=语言}	1.翻译后的结果
把去美国旅行翻译成越南语	{去美国旅行=内容, 越南语=语言}	1.翻译后的结果
把去美国旅行翻译成英语	{去美国旅行=内容, 英语=语言}	1.翻译后的结果
把“芒果糯米鸡“翻译成泰米尔语	{“芒果糯米鸡“=内容, 泰米尔语=语言}	1.翻译后的结果
把我喜欢欧洲旅行翻译成泰米尔语	{泰米尔语=语言, 我喜欢欧洲旅行=内容}	1.翻译后的结果
把”雪碧“翻译成日语	{日语=语言, ”雪碧“=内容}	1.翻译后的结果
把“芒果糯米鸡“翻译成越南语	{“芒果糯米鸡“=内容, 越南语=语言}	1.翻译后的结果
把“芒果糯米鸡“翻译成俄语	{“芒果糯米鸡“=内容, 俄语=语言}	1.翻译后的结果
把我喜欢欧洲旅行翻译成法语	{法语=语言, 我喜欢欧洲旅行=内容}	1.翻译后的结果
把”雪碧“翻译成意大利语	{意大利语=语言, ”雪碧“=内容}	1.翻译后的结果
把”雪碧“翻译成斯瓦希里语	{斯瓦希里语=语言, ”雪碧“=内容}	1.翻译后的结果
把我喜欢欧洲旅行翻译成阿拉伯语	{阿拉伯语=语言, 我喜欢欧洲旅行=内容}	1.翻译后的结果
把”雪碧“翻译成泰米尔语	{泰米尔语=语言, ”雪碧“=内容}	1.翻译后的结果
把”雪碧“翻译成西班牙语	{西班牙语=语言, ”雪碧“=内容}	1.翻译后的结果
把“芒果糯米鸡“翻译成西班牙语	{西班牙语=语言, “芒果糯米鸡“=内容}	1.翻译后的结果
把”雪碧“翻译成阿拉伯语	{阿拉伯语=语言, ”雪碧“=内容}	1.翻译后的结果
把“芒果糯米鸡“翻译成意大利语	{“芒果糯米鸡“=内容, 意大利语=语言}	1.翻译后的结果
把去美国旅行翻译成朝鲜语	{去美国旅行=内容, 朝鲜语=语言}	1.翻译后的结果
把“芒果糯米鸡“翻译成法语	{“芒果糯米鸡“=内容, 法语=语言}	1.翻译后的结果
我喜欢欧洲旅行翻译成西班牙语是什么	{西班牙语=语言, 我喜欢欧洲旅行=内容}	1.翻译后的结果
“芒果糯米鸡“翻译成韩语是什么	{“芒果糯米鸡“=内容, 韩语=语言}	1.翻译后的结果
我喜欢欧洲旅行翻译成泰米尔语是什么	{泰米尔语=语言, 我喜欢欧洲旅行=内容}	1.翻译后的结果
”雪碧“翻译成泰米尔语是什么	{泰米尔语=语言, ”雪碧“=内容}	1.翻译后的结果
去美国旅行翻译成斯瓦希里语是什么	{去美国旅行=内容, 斯瓦希里语=语言}	1.翻译后的结果
“芒果糯米鸡“翻译成法语是什么	{“芒果糯米鸡“=内容, 法语=语言}	1.翻译后的结果
“芒果糯米鸡“翻译成意大利语是什么	{“芒果糯米鸡“=内容, 意大利语=语言}	1.翻译后的结果
去美国旅行翻译成朝鲜语是什么	{去美国旅行=内容, 朝鲜语=语言}	1.翻译后的结果
去美国旅行翻译成意大利语是什么	{去美国旅行=内容, 意大利语=语言}	1.翻译后的结果
去美国旅行翻译成日语是什么	{日语=语言, 去美国旅行=内容}	1.翻译后的结果
”雪碧“翻译成英语是什么	{”雪碧“=内容, 英语=语言}	1.翻译后的结果
“芒果糯米鸡“翻译成阿拉伯语是什么	{阿拉伯语=语言, “芒果糯米鸡“=内容}	1.翻译后的结果
“芒果糯米鸡“翻译成越南语是什么	{“芒果糯米鸡“=内容, 越南语=语言}	1.翻译后的结果
”雪碧“翻译成法语是什么	{法语=语言, ”雪碧“=内容}	1.翻译后的结果
去美国旅行翻译成阿拉伯语是什么	{阿拉伯语=语言, 去美国旅行=内容}	1.翻译后的结果
我喜欢欧洲旅行翻译成韩语是什么	{韩语=语言, 我喜欢欧洲旅行=内容}	1.翻译后的结果
“芒果糯米鸡“翻译成斯瓦希里语是什么	{“芒果糯米鸡“=内容, 斯瓦希里语=语言}	1.翻译后的结果
”雪碧“翻译成德语是什么	{德语=语言, ”雪碧“=内容}	1.翻译后的结果
我喜欢欧洲旅行翻译成德语是什么	{德语=语言, 我喜欢欧洲旅行=内容}	1.翻译后的结果
”雪碧“翻译成韩语是什么	{韩语=语言, ”雪碧“=内容}	1.翻译后的结果
“芒果糯米鸡“翻译成英语是什么	{“芒果糯米鸡“=内容, 英语=语言}	1.翻译后的结果
去美国旅行翻译成越南语是什么	{去美国旅行=内容, 越南语=语言}	1.翻译后的结果
去美国旅行翻译成韩语是什么	{韩语=语言, 去美国旅行=内容}	1.翻译后的结果
“芒果糯米鸡“翻译成德语是什么	{“芒果糯米鸡“=内容, 德语=语言}	1.翻译后的结果
“芒果糯米鸡“翻译成西班牙语是什么	{西班牙语=语言, “芒果糯米鸡“=内容}	1.翻译后的结果
我喜欢欧洲旅行翻译成俄语是什么	{俄语=语言, 我喜欢欧洲旅行=内容}	1.翻译后的结果
我喜欢欧洲旅行翻译成意大利语是什么	{意大利语=语言, 我喜欢欧洲旅行=内容}	1.翻译后的结果
“芒果糯米鸡“翻译成汉语是什么	{“芒果糯米鸡“=内容, 汉语=语言}	1.翻译后的结果
我喜欢欧洲旅行翻译成日语是什么	{日语=语言, 我喜欢欧洲旅行=内容}	1.翻译后的结果
“芒果糯米鸡“翻译成朝鲜语是什么	{“芒果糯米鸡“=内容, 朝鲜语=语言}	1.翻译后的结果
”雪碧“翻译成日语是什么	{日语=语言, ”雪碧“=内容}	1.翻译后的结果
我喜欢欧洲旅行翻译成阿拉伯语是什么	{阿拉伯语=语言, 我喜欢欧洲旅行=内容}	1.翻译后的结果
我喜欢欧洲旅行翻译成法语是什么	{法语=语言, 我喜欢欧洲旅行=内容}	1.翻译后的结果
去美国旅行翻译成法语是什么	{法语=语言, 去美国旅行=内容}	1.翻译后的结果
”雪碧“翻译成汉语是什么	{汉语=语言, ”雪碧“=内容}	1.翻译后的结果
”雪碧“翻译成意大利语是什么	{意大利语=语言, ”雪碧“=内容}	1.翻译后的结果
去美国旅行翻译成英语是什么	{去美国旅行=内容, 英语=语言}	1.翻译后的结果
去美国旅行翻译成汉语是什么	{去美国旅行=内容, 汉语=语言}	1.翻译后的结果
”雪碧“翻译成斯瓦希里语是什么	{斯瓦希里语=语言, ”雪碧“=内容}	1.翻译后的结果
去美国旅行翻译成泰米尔语是什么	{去美国旅行=内容, 泰米尔语=语言}	1.翻译后的结果
去美国旅行翻译成德语是什么	{去美国旅行=内容, 德语=语言}	1.翻译后的结果
我喜欢欧洲旅行翻译成英语是什么	{英语=语言, 我喜欢欧洲旅行=内容}	1.翻译后的结果
”雪碧“翻译成西班牙语是什么	{西班牙语=语言, ”雪碧“=内容}	1.翻译后的结果
日语怎么翻译”雪碧“	{日语=语言, ”雪碧“=内容}	1.翻译后的结果
西班牙语怎么翻译去美国旅行	{西班牙语=语言, 去美国旅行=内容}	1.翻译后的结果
西班牙语怎么翻译”雪碧“	{西班牙语=语言, ”雪碧“=内容}	1.翻译后的结果
西班牙语怎么翻译“芒果糯米鸡“	{西班牙语=语言, “芒果糯米鸡“=内容}	1.翻译后的结果
韩语怎么翻译我喜欢欧洲旅行	{韩语=语言, 我喜欢欧洲旅行=内容}	1.翻译后的结果
阿拉伯语怎么翻译“芒果糯米鸡“	{阿拉伯语=语言, “芒果糯米鸡“=内容}	1.翻译后的结果
朝鲜语怎么翻译”雪碧“	{朝鲜语=语言, ”雪碧“=内容}	1.翻译后的结果
日语怎么翻译我喜欢欧洲旅行	{日语=语言, 我喜欢欧洲旅行=内容}	1.翻译后的结果
意大利语怎么翻译去美国旅行	{去美国旅行=内容, 意大利语=语言}	1.翻译后的结果
斯瓦希里语怎么翻译”雪碧“	{斯瓦希里语=语言, ”雪碧“=内容}	1.翻译后的结果
意大利语怎么翻译“芒果糯米鸡“	{“芒果糯米鸡“=内容, 意大利语=语言}	1.翻译后的结果
意大利语怎么翻译我喜欢欧洲旅行	{意大利语=语言, 我喜欢欧洲旅行=内容}	1.翻译后的结果
泰米尔语怎么翻译“芒果糯米鸡“	{“芒果糯米鸡“=内容, 泰米尔语=语言}	1.翻译后的结果
越南语怎么翻译“芒果糯米鸡“	{“芒果糯米鸡“=内容, 越南语=语言}	1.翻译后的结果
汉语怎么翻译去美国旅行	{去美国旅行=内容, 汉语=语言}	1.翻译后的结果
韩语怎么翻译“芒果糯米鸡“	{“芒果糯米鸡“=内容, 韩语=语言}	1.翻译后的结果
阿拉伯语怎么翻译我喜欢欧洲旅行	{阿拉伯语=语言, 我喜欢欧洲旅行=内容}	1.翻译后的结果
日语怎么翻译“芒果糯米鸡“	{“芒果糯米鸡“=内容, 日语=语言}	1.翻译后的结果
德语怎么翻译“芒果糯米鸡“	{“芒果糯米鸡“=内容, 德语=语言}	1.翻译后的结果
英语怎么翻译”雪碧“	{英语=语言, ”雪碧“=内容}	1.翻译后的结果
泰米尔语怎么翻译去美国旅行	{泰米尔语=语言, 去美国旅行=内容}	1.翻译后的结果
朝鲜语怎么翻译去美国旅行	{朝鲜语=语言, 去美国旅行=内容}	1.翻译后的结果
阿拉伯语怎么翻译去美国旅行	{阿拉伯语=语言, 去美国旅行=内容}	1.翻译后的结果
日语怎么翻译去美国旅行	{日语=语言, 去美国旅行=内容}	1.翻译后的结果
俄语怎么翻译去美国旅行	{俄语=语言, 去美国旅行=内容}	1.翻译后的结果
斯瓦希里语怎么翻译“芒果糯米鸡“	{“芒果糯米鸡“=内容, 斯瓦希里语=语言}	1.翻译后的结果
越南语怎么翻译去美国旅行	{去美国旅行=内容, 越南语=语言}	1.翻译后的结果
德语怎么翻译我喜欢欧洲旅行	{德语=语言, 我喜欢欧洲旅行=内容}	1.翻译后的结果
法语怎么翻译我喜欢欧洲旅行	{法语=语言, 我喜欢欧洲旅行=内容}	1.翻译后的结果
泰米尔语怎么翻译”雪碧“	{泰米尔语=语言, ”雪碧“=内容}	1.翻译后的结果
俄语怎么翻译我喜欢欧洲旅行	{俄语=语言, 我喜欢欧洲旅行=内容}	1.翻译后的结果
汉语怎么翻译”雪碧“	{汉语=语言, ”雪碧“=内容}	1.翻译后的结果
英语怎么翻译去美国旅行	{去美国旅行=内容, 英语=语言}	1.翻译后的结果
阿拉伯语怎么翻译”雪碧“	{阿拉伯语=语言, ”雪碧“=内容}	1.翻译后的结果
德语怎么翻译”雪碧“	{德语=语言, ”雪碧“=内容}	1.翻译后的结果
韩语怎么翻译”雪碧“	{韩语=语言, ”雪碧“=内容}	1.翻译后的结果
泰米尔语怎么翻译我喜欢欧洲旅行	{泰米尔语=语言, 我喜欢欧洲旅行=内容}	1.翻译后的结果
法语怎么翻译”雪碧“	{法语=语言, ”雪碧“=内容}	1.翻译后的结果
朝鲜语怎么翻译我喜欢欧洲旅行	{朝鲜语=语言, 我喜欢欧洲旅行=内容}	1.翻译后的结果
汉语怎么翻译我喜欢欧洲旅行	{汉语=语言, 我喜欢欧洲旅行=内容}	1.翻译后的结果
朝鲜语的“芒果糯米鸡“是什么	{“芒果糯米鸡“=内容, 朝鲜语=语言}	1.翻译后的结果
泰米尔语的”雪碧“是什么	{泰米尔语=语言, ”雪碧“=内容}	1.翻译后的结果
汉语的去美国旅行是什么	{去美国旅行=内容, 汉语=语言}	1.翻译后的结果
俄语的去美国旅行是什么	{俄语=语言, 去美国旅行=内容}	1.翻译后的结果
阿拉伯语的去美国旅行是什么	{阿拉伯语=语言, 去美国旅行=内容}	1.翻译后的结果
日语的”雪碧“是什么	{日语=语言, ”雪碧“=内容}	1.翻译后的结果
意大利语的“芒果糯米鸡“是什么	{“芒果糯米鸡“=内容, 意大利语=语言}	1.翻译后的结果
朝鲜语的”雪碧“是什么	{朝鲜语=语言, ”雪碧“=内容}	1.翻译后的结果
俄语的”雪碧“是什么	{俄语=语言, ”雪碧“=内容}	1.翻译后的结果
越南语的“芒果糯米鸡“是什么	{“芒果糯米鸡“=内容, 越南语=语言}	1.翻译后的结果
法语的“芒果糯米鸡“是什么	{“芒果糯米鸡“=内容, 法语=语言}	1.翻译后的结果
英语的”雪碧“是什么	{英语=语言, ”雪碧“=内容}	1.翻译后的结果
越南语的去美国旅行是什么	{去美国旅行=内容, 越南语=语言}	1.翻译后的结果
俄语的我喜欢欧洲旅行是什么	{俄语=语言, 我喜欢欧洲旅行=内容}	1.翻译后的结果
德语的“芒果糯米鸡“是什么	{“芒果糯米鸡“=内容, 德语=语言}	1.翻译后的结果
阿拉伯语的”雪碧“是什么	{阿拉伯语=语言, ”雪碧“=内容}	1.翻译后的结果
阿拉伯语的“芒果糯米鸡“是什么	{阿拉伯语=语言, “芒果糯米鸡“=内容}	1.翻译后的结果
法语的我喜欢欧洲旅行是什么	{法语=语言, 我喜欢欧洲旅行=内容}	1.翻译后的结果
日语的去美国旅行是什么	{日语=语言, 去美国旅行=内容}	1.翻译后的结果
日语的“芒果糯米鸡“是什么	{“芒果糯米鸡“=内容, 日语=语言}	1.翻译后的结果
朝鲜语的去美国旅行是什么	{朝鲜语=语言, 去美国旅行=内容}	1.翻译后的结果
斯瓦希里语的“芒果糯米鸡“是什么	{“芒果糯米鸡“=内容, 斯瓦希里语=语言}	1.翻译后的结果
斯瓦希里语的我喜欢欧洲旅行是什么	{斯瓦希里语=语言, 我喜欢欧洲旅行=内容}	1.翻译后的结果
俄语的“芒果糯米鸡“是什么	{“芒果糯米鸡“=内容, 俄语=语言}	1.翻译后的结果
日语的我喜欢欧洲旅行是什么	{日语=语言, 我喜欢欧洲旅行=内容}	1.翻译后的结果
英语的“芒果糯米鸡“是什么	{“芒果糯米鸡“=内容, 英语=语言}	1.翻译后的结果
西班牙语的去美国旅行是什么	{西班牙语=语言, 去美国旅行=内容}	1.翻译后的结果
韩语的去美国旅行是什么	{韩语=语言, 去美国旅行=内容}	1.翻译后的结果
泰米尔语的“芒果糯米鸡“是什么	{“芒果糯米鸡“=内容, 泰米尔语=语言}	1.翻译后的结果
德语的我喜欢欧洲旅行是什么	{德语=语言, 我喜欢欧洲旅行=内容}	1.翻译后的结果
西班牙语的“芒果糯米鸡“是什么	{西班牙语=语言, “芒果糯米鸡“=内容}	1.翻译后的结果
意大利语的去美国旅行是什么	{去美国旅行=内容, 意大利语=语言}	1.翻译后的结果
泰米尔语的我喜欢欧洲旅行是什么	{泰米尔语=语言, 我喜欢欧洲旅行=内容}	1.翻译后的结果
西班牙语的我喜欢欧洲旅行是什么	{西班牙语=语言, 我喜欢欧洲旅行=内容}	1.翻译后的结果
法语的去美国旅行是什么	{法语=语言, 去美国旅行=内容}	1.翻译后的结果
朝鲜语的我喜欢欧洲旅行是什么	{朝鲜语=语言, 我喜欢欧洲旅行=内容}	1.翻译后的结果
阿拉伯语的我喜欢欧洲旅行是什么	{阿拉伯语=语言, 我喜欢欧洲旅行=内容}	1.翻译后的结果
西班牙语的”雪碧“是什么	{西班牙语=语言, ”雪碧“=内容}	1.翻译后的结果
法语的”雪碧“是什么	{法语=语言, ”雪碧“=内容}	1.翻译后的结果
斯瓦希里语的”雪碧“是什么	{斯瓦希里语=语言, ”雪碧“=内容}	1.翻译后的结果
斯瓦希里语的去美国旅行是什么	{斯瓦希里语=语言, 去美国旅行=内容}	1.翻译后的结果
德语的”雪碧“是什么	{德语=语言, ”雪碧“=内容}	1.翻译后的结果
汉语的”雪碧“是什么	{汉语=语言, ”雪碧“=内容}	1.翻译后的结果
越南语的”雪碧“是什么	{”雪碧“=内容, 越南语=语言}	1.翻译后的结果
“芒果糯米鸡“的越南语是什么	{“芒果糯米鸡“=内容, 越南语=语言}	1.翻译后的结果
去美国旅行的德语是什么	{去美国旅行=内容, 德语=语言}	1.翻译后的结果
“芒果糯米鸡“的日语是什么	{“芒果糯米鸡“=内容, 日语=语言}	1.翻译后的结果
“芒果糯米鸡“的意大利语是什么	{“芒果糯米鸡“=内容, 意大利语=语言}	1.翻译后的结果
“芒果糯米鸡“的斯瓦希里语是什么	{“芒果糯米鸡“=内容, 斯瓦希里语=语言}	1.翻译后的结果
去美国旅行的日语是什么	{日语=语言, 去美国旅行=内容}	1.翻译后的结果
”雪碧“的朝鲜语是什么	{朝鲜语=语言, ”雪碧“=内容}	1.翻译后的结果
我喜欢欧洲旅行的俄语是什么	{俄语=语言, 我喜欢欧洲旅行=内容}	1.翻译后的结果
”雪碧“的日语是什么	{日语=语言, ”雪碧“=内容}	1.翻译后的结果
”雪碧“的西班牙语是什么	{西班牙语=语言, ”雪碧“=内容}	1.翻译后的结果
去美国旅行的西班牙语是什么	{西班牙语=语言, 去美国旅行=内容}	1.翻译后的结果
去美国旅行的韩语是什么	{韩语=语言, 去美国旅行=内容}	1.翻译后的结果
”雪碧“的越南语是什么	{”雪碧“=内容, 越南语=语言}	1.翻译后的结果
我喜欢欧洲旅行的西班牙语是什么	{西班牙语=语言, 我喜欢欧洲旅行=内容}	1.翻译后的结果
我喜欢欧洲旅行的英语是什么	{英语=语言, 我喜欢欧洲旅行=内容}	1.翻译后的结果
我喜欢欧洲旅行的斯瓦希里语是什么	{斯瓦希里语=语言, 我喜欢欧洲旅行=内容}	1.翻译后的结果
我喜欢欧洲旅行的意大利语是什么	{意大利语=语言, 我喜欢欧洲旅行=内容}	1.翻译后的结果
我喜欢欧洲旅行的汉语是什么	{汉语=语言, 我喜欢欧洲旅行=内容}	1.翻译后的结果
我喜欢欧洲旅行的越南语是什么	{越南语=语言, 我喜欢欧洲旅行=内容}	1.翻译后的结果
我喜欢欧洲旅行的法语是什么	{法语=语言, 我喜欢欧洲旅行=内容}	1.翻译后的结果
去美国旅行的意大利语是什么	{去美国旅行=内容, 意大利语=语言}	1.翻译后的结果
去美国旅行的法语是什么	{法语=语言, 去美国旅行=内容}	1.翻译后的结果
“芒果糯米鸡“的泰米尔语是什么	{“芒果糯米鸡“=内容, 泰米尔语=语言}	1.翻译后的结果
“芒果糯米鸡“的德语是什么	{“芒果糯米鸡“=内容, 德语=语言}	1.翻译后的结果
我喜欢欧洲旅行的朝鲜语是什么	{朝鲜语=语言, 我喜欢欧洲旅行=内容}	1.翻译后的结果
去美国旅行的斯瓦希里语是什么	{去美国旅行=内容, 斯瓦希里语=语言}	1.翻译后的结果
“芒果糯米鸡“的朝鲜语是什么	{“芒果糯米鸡“=内容, 朝鲜语=语言}	1.翻译后的结果
去美国旅行的越南语是什么	{去美国旅行=内容, 越南语=语言}	1.翻译后的结果
”雪碧“的汉语是什么	{汉语=语言, ”雪碧“=内容}	1.翻译后的结果
”雪碧“的俄语是什么	{俄语=语言, ”雪碧“=内容}	1.翻译后的结果
”雪碧“的韩语是什么	{韩语=语言, ”雪碧“=内容}	1.翻译后的结果
“芒果糯米鸡“的汉语是什么	{“芒果糯米鸡“=内容, 汉语=语言}	1.翻译后的结果
”雪碧“的英语是什么	{”雪碧“=内容, 英语=语言}	1.翻译后的结果
去美国旅行的朝鲜语是什么	{去美国旅行=内容, 朝鲜语=语言}	1.翻译后的结果
我喜欢欧洲旅行的韩语是什么	{韩语=语言, 我喜欢欧洲旅行=内容}	1.翻译后的结果
我喜欢欧洲旅行的阿拉伯语是什么	{阿拉伯语=语言, 我喜欢欧洲旅行=内容}	1.翻译后的结果
我喜欢欧洲旅行的日语是什么	{日语=语言, 我喜欢欧洲旅行=内容}	1.翻译后的结果
“芒果糯米鸡“的英语是什么	{“芒果糯米鸡“=内容, 英语=语言}	1.翻译后的结果
“芒果糯米鸡“的法语是什么	{“芒果糯米鸡“=内容, 法语=语言}	1.翻译后的结果
去美国旅行的阿拉伯语是什么	{阿拉伯语=语言, 去美国旅行=内容}	1.翻译后的结果
“芒果糯米鸡“的西班牙语是什么	{西班牙语=语言, “芒果糯米鸡“=内容}	1.翻译后的结果
去美国旅行的汉语是什么	{去美国旅行=内容, 汉语=语言}	1.翻译后的结果
去美国旅行的俄语是什么	{俄语=语言, 去美国旅行=内容}	1.翻译后的结果
“芒果糯米鸡“的阿拉伯语是什么	{阿拉伯语=语言, “芒果糯米鸡“=内容}	1.翻译后的结果
”雪碧“的阿拉伯语是什么	{阿拉伯语=语言, ”雪碧“=内容}	1.翻译后的结果
意大利语怎么表达”雪碧“	{意大利语=语言, ”雪碧“=内容}	1.翻译后的结果
汉语怎么表达”雪碧“	{汉语=语言, ”雪碧“=内容}	1.翻译后的结果
日语怎么表达”雪碧“	{日语=语言, ”雪碧“=内容}	1.翻译后的结果
泰米尔语怎么表达“芒果糯米鸡“	{“芒果糯米鸡“=内容, 泰米尔语=语言}	1.翻译后的结果
朝鲜语怎么表达“芒果糯米鸡“	{“芒果糯米鸡“=内容, 朝鲜语=语言}	1.翻译后的结果
斯瓦希里语怎么表达去美国旅行	{斯瓦希里语=语言, 去美国旅行=内容}	1.翻译后的结果
俄语怎么表达“芒果糯米鸡“	{“芒果糯米鸡“=内容, 俄语=语言}	1.翻译后的结果
汉语怎么表达“芒果糯米鸡“	{“芒果糯米鸡“=内容, 汉语=语言}	1.翻译后的结果
法语怎么表达”雪碧“	{法语=语言, ”雪碧“=内容}	1.翻译后的结果
斯瓦希里语怎么表达“芒果糯米鸡“	{“芒果糯米鸡“=内容, 斯瓦希里语=语言}	1.翻译后的结果
俄语怎么表达去美国旅行	{俄语=语言, 去美国旅行=内容}	1.翻译后的结果
朝鲜语怎么表达我喜欢欧洲旅行	{朝鲜语=语言, 我喜欢欧洲旅行=内容}	1.翻译后的结果
英语怎么表达我喜欢欧洲旅行	{英语=语言, 我喜欢欧洲旅行=内容}	1.翻译后的结果
意大利语怎么表达我喜欢欧洲旅行	{意大利语=语言, 我喜欢欧洲旅行=内容}	1.翻译后的结果
朝鲜语怎么表达去美国旅行	{朝鲜语=语言, 去美国旅行=内容}	1.翻译后的结果
阿拉伯语怎么表达我喜欢欧洲旅行	{阿拉伯语=语言, 我喜欢欧洲旅行=内容}	1.翻译后的结果
泰米尔语怎么表达去美国旅行	{泰米尔语=语言, 去美国旅行=内容}	1.翻译后的结果
德语怎么表达我喜欢欧洲旅行	{德语=语言, 我喜欢欧洲旅行=内容}	1.翻译后的结果
法语怎么表达去美国旅行	{法语=语言, 去美国旅行=内容}	1.翻译后的结果
西班牙语怎么表达“芒果糯米鸡“	{西班牙语=语言, “芒果糯米鸡“=内容}	1.翻译后的结果
西班牙语怎么表达我喜欢欧洲旅行	{西班牙语=语言, 我喜欢欧洲旅行=内容}	1.翻译后的结果
日语怎么表达去美国旅行	{日语=语言, 去美国旅行=内容}	1.翻译后的结果
韩语怎么表达我喜欢欧洲旅行	{韩语=语言, 我喜欢欧洲旅行=内容}	1.翻译后的结果
英语怎么表达去美国旅行	{去美国旅行=内容, 英语=语言}	1.翻译后的结果
德语怎么表达“芒果糯米鸡“	{“芒果糯米鸡“=内容, 德语=语言}	1.翻译后的结果
阿拉伯语怎么表达去美国旅行	{阿拉伯语=语言, 去美国旅行=内容}	1.翻译后的结果
泰米尔语怎么表达”雪碧“	{泰米尔语=语言, ”雪碧“=内容}	1.翻译后的结果
法语怎么表达“芒果糯米鸡“	{“芒果糯米鸡“=内容, 法语=语言}	1.翻译后的结果
韩语怎么表达“芒果糯米鸡“	{“芒果糯米鸡“=内容, 韩语=语言}	1.翻译后的结果
斯瓦希里语怎么表达”雪碧“	{斯瓦希里语=语言, ”雪碧“=内容}	1.翻译后的结果
西班牙语怎么表达”雪碧“	{西班牙语=语言, ”雪碧“=内容}	1.翻译后的结果
意大利语怎么表达“芒果糯米鸡“	{“芒果糯米鸡“=内容, 意大利语=语言}	1.翻译后的结果
韩语怎么表达去美国旅行	{韩语=语言, 去美国旅行=内容}	1.翻译后的结果
阿拉伯语怎么表达“芒果糯米鸡“	{阿拉伯语=语言, “芒果糯米鸡“=内容}	1.翻译后的结果
朝鲜语怎么表达”雪碧“	{朝鲜语=语言, ”雪碧“=内容}	1.翻译后的结果
俄语怎么表达”雪碧“	{俄语=语言, ”雪碧“=内容}	1.翻译后的结果
日语怎么表达我喜欢欧洲旅行	{日语=语言, 我喜欢欧洲旅行=内容}	1.翻译后的结果
泰米尔语怎么表达我喜欢欧洲旅行	{泰米尔语=语言, 我喜欢欧洲旅行=内容}	1.翻译后的结果
俄语怎么表达我喜欢欧洲旅行	{俄语=语言, 我喜欢欧洲旅行=内容}	1.翻译后的结果
汉语怎么表达我喜欢欧洲旅行	{汉语=语言, 我喜欢欧洲旅行=内容}	1.翻译后的结果
越南语怎么表达去美国旅行	{去美国旅行=内容, 越南语=语言}	1.翻译后的结果
汉语怎么表达去美国旅行	{去美国旅行=内容, 汉语=语言}	1.翻译后的结果
越南语怎么表达我喜欢欧洲旅行	{越南语=语言, 我喜欢欧洲旅行=内容}	1.翻译后的结果
日语怎么表达“芒果糯米鸡“	{“芒果糯米鸡“=内容, 日语=语言}	1.翻译后的结果
英语怎么表达“芒果糯米鸡“	{“芒果糯米鸡“=内容, 英语=语言}	1.翻译后的结果
英语怎么表达”雪碧“	{英语=语言, ”雪碧“=内容}	1.翻译后的结果
我喜欢欧洲旅行怎么用汉语表达	{汉语=语言, 我喜欢欧洲旅行=内容}	1.翻译后的结果
“芒果糯米鸡“怎么用西班牙语表达	{西班牙语=语言, “芒果糯米鸡“=内容}	1.翻译后的结果
”雪碧“怎么用泰米尔语表达	{泰米尔语=语言, ”雪碧“=内容}	1.翻译后的结果
去美国旅行怎么用西班牙语表达	{西班牙语=语言, 去美国旅行=内容}	1.翻译后的结果
“芒果糯米鸡“怎么用日语表达	{“芒果糯米鸡“=内容, 日语=语言}	1.翻译后的结果
我喜欢欧洲旅行怎么用德语表达	{德语=语言, 我喜欢欧洲旅行=内容}	1.翻译后的结果
”雪碧“怎么用韩语表达	{韩语=语言, ”雪碧“=内容}	1.翻译后的结果
我喜欢欧洲旅行怎么用泰米尔语表达	{泰米尔语=语言, 我喜欢欧洲旅行=内容}	1.翻译后的结果
去美国旅行怎么用泰米尔语表达	{去美国旅行=内容, 泰米尔语=语言}	1.翻译后的结果
”雪碧“怎么用朝鲜语表达	{朝鲜语=语言, ”雪碧“=内容}	1.翻译后的结果
我喜欢欧洲旅行怎么用英语表达	{英语=语言, 我喜欢欧洲旅行=内容}	1.翻译后的结果
去美国旅行怎么用意大利语表达	{去美国旅行=内容, 意大利语=语言}	1.翻译后的结果
”雪碧“怎么用西班牙语表达	{西班牙语=语言, ”雪碧“=内容}	1.翻译后的结果
“芒果糯米鸡“怎么用斯瓦希里语表达	{“芒果糯米鸡“=内容, 斯瓦希里语=语言}	1.翻译后的结果
去美国旅行怎么用阿拉伯语表达	{阿拉伯语=语言, 去美国旅行=内容}	1.翻译后的结果
我喜欢欧洲旅行怎么用西班牙语表达	{西班牙语=语言, 我喜欢欧洲旅行=内容}	1.翻译后的结果
我喜欢欧洲旅行怎么用阿拉伯语表达	{阿拉伯语=语言, 我喜欢欧洲旅行=内容}	1.翻译后的结果
去美国旅行怎么用朝鲜语表达	{去美国旅行=内容, 朝鲜语=语言}	1.翻译后的结果
我喜欢欧洲旅行怎么用意大利语表达	{意大利语=语言, 我喜欢欧洲旅行=内容}	1.翻译后的结果
”雪碧“怎么用英语表达	{”雪碧“=内容, 英语=语言}	1.翻译后的结果
我喜欢欧洲旅行怎么用越南语表达	{越南语=语言, 我喜欢欧洲旅行=内容}	1.翻译后的结果
去美国旅行怎么用汉语表达	{去美国旅行=内容, 汉语=语言}	1.翻译后的结果
去美国旅行怎么用德语表达	{去美国旅行=内容, 德语=语言}	1.翻译后的结果
”雪碧“怎么用阿拉伯语表达	{阿拉伯语=语言, ”雪碧“=内容}	1.翻译后的结果
去美国旅行怎么用法语表达	{法语=语言, 去美国旅行=内容}	1.翻译后的结果
去美国旅行怎么用英语表达	{去美国旅行=内容, 英语=语言}	1.翻译后的结果
“芒果糯米鸡“怎么用韩语表达	{“芒果糯米鸡“=内容, 韩语=语言}	1.翻译后的结果
“芒果糯米鸡“怎么用德语表达	{“芒果糯米鸡“=内容, 德语=语言}	1.翻译后的结果
”雪碧“怎么用法语表达	{法语=语言, ”雪碧“=内容}	1.翻译后的结果
我喜欢欧洲旅行怎么用日语表达	{日语=语言, 我喜欢欧洲旅行=内容}	1.翻译后的结果
我喜欢欧洲旅行怎么用法语表达	{法语=语言, 我喜欢欧洲旅行=内容}	1.翻译后的结果
”雪碧“怎么用俄语表达	{俄语=语言, ”雪碧“=内容}	1.翻译后的结果
”雪碧“怎么用意大利语表达	{意大利语=语言, ”雪碧“=内容}	1.翻译后的结果
“芒果糯米鸡“怎么用法语表达	{“芒果糯米鸡“=内容, 法语=语言}	1.翻译后的结果
去美国旅行怎么用日语表达	{日语=语言, 去美国旅行=内容}	1.翻译后的结果
我喜欢欧洲旅行怎么用俄语表达	{俄语=语言, 我喜欢欧洲旅行=内容}	1.翻译后的结果
去美国旅行怎么用越南语表达	{去美国旅行=内容, 越南语=语言}	1.翻译后的结果
我喜欢欧洲旅行怎么用韩语表达	{韩语=语言, 我喜欢欧洲旅行=内容}	1.翻译后的结果
“芒果糯米鸡“怎么用阿拉伯语表达	{阿拉伯语=语言, “芒果糯米鸡“=内容}	1.翻译后的结果
”雪碧“怎么用日语表达	{日语=语言, ”雪碧“=内容}	1.翻译后的结果
告诉我“芒果糯米鸡“的法语表达	{“芒果糯米鸡“=内容, 法语=语言}	1.翻译后的结果
告诉我“芒果糯米鸡“的阿拉伯语表达	{阿拉伯语=语言, “芒果糯米鸡“=内容}	1.翻译后的结果
告诉我去美国旅行的阿拉伯语表达	{阿拉伯语=语言, 去美国旅行=内容}	1.翻译后的结果
告诉我去美国旅行的汉语表达	{去美国旅行=内容, 汉语=语言}	1.翻译后的结果
告诉我“芒果糯米鸡“的朝鲜语表达	{“芒果糯米鸡“=内容, 朝鲜语=语言}	1.翻译后的结果
告诉我去美国旅行的俄语表达	{俄语=语言, 去美国旅行=内容}	1.翻译后的结果
告诉我去美国旅行的法语表达	{法语=语言, 去美国旅行=内容}	1.翻译后的结果
告诉我”雪碧“的法语表达	{法语=语言, ”雪碧“=内容}	1.翻译后的结果
告诉我“芒果糯米鸡“的俄语表达	{“芒果糯米鸡“=内容, 俄语=语言}	1.翻译后的结果
告诉我“芒果糯米鸡“的意大利语表达	{“芒果糯米鸡“=内容, 意大利语=语言}	1.翻译后的结果
告诉我”雪碧“的英语表达	{”雪碧“=内容, 英语=语言}	1.翻译后的结果
告诉我”雪碧“的阿拉伯语表达	{阿拉伯语=语言, ”雪碧“=内容}	1.翻译后的结果
告诉我去美国旅行的意大利语表达	{去美国旅行=内容, 意大利语=语言}	1.翻译后的结果
告诉我“芒果糯米鸡“的西班牙语表达	{西班牙语=语言, “芒果糯米鸡“=内容}	1.翻译后的结果
告诉我“芒果糯米鸡“的汉语表达	{“芒果糯米鸡“=内容, 汉语=语言}	1.翻译后的结果
告诉我我喜欢欧洲旅行的韩语表达	{韩语=语言, 我喜欢欧洲旅行=内容}	1.翻译后的结果
告诉我”雪碧“的韩语表达	{韩语=语言, ”雪碧“=内容}	1.翻译后的结果
告诉我我喜欢欧洲旅行的俄语表达	{俄语=语言, 我喜欢欧洲旅行=内容}	1.翻译后的结果
告诉我”雪碧“的意大利语表达	{意大利语=语言, ”雪碧“=内容}	1.翻译后的结果
告诉我“芒果糯米鸡“的德语表达	{“芒果糯米鸡“=内容, 德语=语言}	1.翻译后的结果
告诉我”雪碧“的汉语表达	{汉语=语言, ”雪碧“=内容}	1.翻译后的结果
告诉我去美国旅行的朝鲜语表达	{去美国旅行=内容, 朝鲜语=语言}	1.翻译后的结果
告诉我”雪碧“的泰米尔语表达	{泰米尔语=语言, ”雪碧“=内容}	1.翻译后的结果
告诉我”雪碧“的俄语表达	{俄语=语言, ”雪碧“=内容}	1.翻译后的结果
告诉我“芒果糯米鸡“的韩语表达	{“芒果糯米鸡“=内容, 韩语=语言}	1.翻译后的结果
告诉我我喜欢欧洲旅行的法语表达	{法语=语言, 我喜欢欧洲旅行=内容}	1.翻译后的结果
告诉我”雪碧“的斯瓦希里语表达	{斯瓦希里语=语言, ”雪碧“=内容}	1.翻译后的结果
告诉我”雪碧“的西班牙语表达	{西班牙语=语言, ”雪碧“=内容}	1.翻译后的结果
告诉我去美国旅行的越南语表达	{去美国旅行=内容, 越南语=语言}	1.翻译后的结果
告诉我“芒果糯米鸡“的越南语表达	{“芒果糯米鸡“=内容, 越南语=语言}	1.翻译后的结果
告诉我我喜欢欧洲旅行的越南语表达	{越南语=语言, 我喜欢欧洲旅行=内容}	1.翻译后的结果
告诉我去美国旅行的英语表达	{去美国旅行=内容, 英语=语言}	1.翻译后的结果
告诉我“芒果糯米鸡“的日语表达	{“芒果糯米鸡“=内容, 日语=语言}	1.翻译后的结果
告诉我去美国旅行的泰米尔语表达	{去美国旅行=内容, 泰米尔语=语言}	1.翻译后的结果
告诉我我喜欢欧洲旅行的英语表达	{英语=语言, 我喜欢欧洲旅行=内容}	1.翻译后的结果
告诉我“芒果糯米鸡“的泰米尔语表达	{“芒果糯米鸡“=内容, 泰米尔语=语言}	1.翻译后的结果
告诉我”雪碧“的日语表达	{日语=语言, ”雪碧“=内容}	1.翻译后的结果
告诉我去美国旅行的韩语表达	{韩语=语言, 去美国旅行=内容}	1.翻译后的结果
告诉我“芒果糯米鸡“的英语表达	{“芒果糯米鸡“=内容, 英语=语言}	1.翻译后的结果
告诉我”雪碧“的德语表达	{德语=语言, ”雪碧“=内容}	1.翻译后的结果
告诉我我喜欢欧洲旅行的阿拉伯语表达	{阿拉伯语=语言, 我喜欢欧洲旅行=内容}	1.翻译后的结果
告诉我”雪碧“的越南语表达	{”雪碧“=内容, 越南语=语言}	1.翻译后的结果
告诉我我喜欢欧洲旅行的斯瓦希里语表达	{斯瓦希里语=语言, 我喜欢欧洲旅行=内容}	1.翻译后的结果
告诉我去美国旅行的德语表达	{去美国旅行=内容, 德语=语言}	1.翻译后的结果
告诉我我喜欢欧洲旅行的朝鲜语表达	{朝鲜语=语言, 我喜欢欧洲旅行=内容}	1.翻译后的结果
告诉我“芒果糯米鸡“的斯瓦希里语表达	{“芒果糯米鸡“=内容, 斯瓦希里语=语言}	1.翻译后的结果
告诉我我喜欢欧洲旅行的意大利语表达	{意大利语=语言, 我喜欢欧洲旅行=内容}	1.翻译后的结果
告诉我去美国旅行的日语表达	{日语=语言, 去美国旅行=内容}	1.翻译后的结果
告诉我我喜欢欧洲旅行的汉语表达	{汉语=语言, 我喜欢欧洲旅行=内容}	1.翻译后的结果
告诉我我喜欢欧洲旅行的韩语说法	{韩语=语言, 我喜欢欧洲旅行=内容}	1.翻译后的结果
告诉我“芒果糯米鸡“的阿拉伯语说法	{阿拉伯语=语言, “芒果糯米鸡“=内容}	1.翻译后的结果
告诉我“芒果糯米鸡“的日语说法	{“芒果糯米鸡“=内容, 日语=语言}	1.翻译后的结果
告诉我”雪碧“的越南语说法	{”雪碧“=内容, 越南语=语言}	1.翻译后的结果
告诉我去美国旅行的俄语说法	{俄语=语言, 去美国旅行=内容}	1.翻译后的结果
告诉我我喜欢欧洲旅行的英语说法	{英语=语言, 我喜欢欧洲旅行=内容}	1.翻译后的结果
告诉我我喜欢欧洲旅行的越南语说法	{越南语=语言, 我喜欢欧洲旅行=内容}	1.翻译后的结果
告诉我”雪碧“的斯瓦希里语说法	{斯瓦希里语=语言, ”雪碧“=内容}	1.翻译后的结果
告诉我“芒果糯米鸡“的德语说法	{“芒果糯米鸡“=内容, 德语=语言}	1.翻译后的结果
告诉我我喜欢欧洲旅行的汉语说法	{汉语=语言, 我喜欢欧洲旅行=内容}	1.翻译后的结果
告诉我“芒果糯米鸡“的越南语说法	{“芒果糯米鸡“=内容, 越南语=语言}	1.翻译后的结果
告诉我“芒果糯米鸡“的西班牙语说法	{西班牙语=语言, “芒果糯米鸡“=内容}	1.翻译后的结果
告诉我我喜欢欧洲旅行的法语说法	{法语=语言, 我喜欢欧洲旅行=内容}	1.翻译后的结果
告诉我去美国旅行的斯瓦希里语说法	{去美国旅行=内容, 斯瓦希里语=语言}	1.翻译后的结果
告诉我去美国旅行的意大利语说法	{去美国旅行=内容, 意大利语=语言}	1.翻译后的结果
告诉我”雪碧“的德语说法	{德语=语言, ”雪碧“=内容}	1.翻译后的结果
告诉我我喜欢欧洲旅行的俄语说法	{俄语=语言, 我喜欢欧洲旅行=内容}	1.翻译后的结果
告诉我去美国旅行的朝鲜语说法	{去美国旅行=内容, 朝鲜语=语言}	1.翻译后的结果
告诉我“芒果糯米鸡“的俄语说法	{“芒果糯米鸡“=内容, 俄语=语言}	1.翻译后的结果
告诉我我喜欢欧洲旅行的意大利语说法	{意大利语=语言, 我喜欢欧洲旅行=内容}	1.翻译后的结果
告诉我去美国旅行的德语说法	{去美国旅行=内容, 德语=语言}	1.翻译后的结果
告诉我”雪碧“的意大利语说法	{意大利语=语言, ”雪碧“=内容}	1.翻译后的结果
告诉我“芒果糯米鸡“的意大利语说法	{“芒果糯米鸡“=内容, 意大利语=语言}	1.翻译后的结果
告诉我我喜欢欧洲旅行的阿拉伯语说法	{阿拉伯语=语言, 我喜欢欧洲旅行=内容}	1.翻译后的结果
告诉我我喜欢欧洲旅行的泰米尔语说法	{泰米尔语=语言, 我喜欢欧洲旅行=内容}	1.翻译后的结果
告诉我去美国旅行的阿拉伯语说法	{阿拉伯语=语言, 去美国旅行=内容}	1.翻译后的结果
告诉我”雪碧“的日语说法	{日语=语言, ”雪碧“=内容}	1.翻译后的结果
告诉我”雪碧“的法语说法	{法语=语言, ”雪碧“=内容}	1.翻译后的结果
告诉我“芒果糯米鸡“的英语说法	{“芒果糯米鸡“=内容, 英语=语言}	1.翻译后的结果
告诉我我喜欢欧洲旅行的西班牙语说法	{西班牙语=语言, 我喜欢欧洲旅行=内容}	1.翻译后的结果
告诉我”雪碧“的英语说法	{”雪碧“=内容, 英语=语言}	1.翻译后的结果
告诉我去美国旅行的泰米尔语说法	{去美国旅行=内容, 泰米尔语=语言}	1.翻译后的结果
告诉我去美国旅行的日语说法	{日语=语言, 去美国旅行=内容}	1.翻译后的结果
告诉我去美国旅行的西班牙语说法	{西班牙语=语言, 去美国旅行=内容}	1.翻译后的结果
告诉我”雪碧“的西班牙语说法	{西班牙语=语言, ”雪碧“=内容}	1.翻译后的结果
告诉我我喜欢欧洲旅行的斯瓦希里语说法	{斯瓦希里语=语言, 我喜欢欧洲旅行=内容}	1.翻译后的结果
告诉我”雪碧“的阿拉伯语说法	{阿拉伯语=语言, ”雪碧“=内容}	1.翻译后的结果
告诉我我喜欢欧洲旅行的朝鲜语说法	{朝鲜语=语言, 我喜欢欧洲旅行=内容}	1.翻译后的结果
告诉我”雪碧“的韩语说法	{韩语=语言, ”雪碧“=内容}	1.翻译后的结果
告诉我“芒果糯米鸡“的斯瓦希里语说法	{“芒果糯米鸡“=内容, 斯瓦希里语=语言}	1.翻译后的结果
告诉我我喜欢欧洲旅行的德语说法	{德语=语言, 我喜欢欧洲旅行=内容}	1.翻译后的结果
告诉我去美国旅行的汉语说法	{去美国旅行=内容, 汉语=语言}	1.翻译后的结果
去美国旅行的汉语表达	{去美国旅行=内容, 汉语=语言}	1.翻译后的结果
“芒果糯米鸡“的俄语表达	{“芒果糯米鸡“=内容, 俄语=语言}	1.翻译后的结果
我喜欢欧洲旅行的日语表达	{日语=语言, 我喜欢欧洲旅行=内容}	1.翻译后的结果
我喜欢欧洲旅行的阿拉伯语表达	{阿拉伯语=语言, 我喜欢欧洲旅行=内容}	1.翻译后的结果
我喜欢欧洲旅行的法语表达	{法语=语言, 我喜欢欧洲旅行=内容}	1.翻译后的结果
”雪碧“的阿拉伯语表达	{阿拉伯语=语言, ”雪碧“=内容}	1.翻译后的结果
去美国旅行的阿拉伯语表达	{阿拉伯语=语言, 去美国旅行=内容}	1.翻译后的结果
”雪碧“的法语表达	{法语=语言, ”雪碧“=内容}	1.翻译后的结果
”雪碧“的朝鲜语表达	{朝鲜语=语言, ”雪碧“=内容}	1.翻译后的结果
我喜欢欧洲旅行的斯瓦希里语表达	{斯瓦希里语=语言, 我喜欢欧洲旅行=内容}	1.翻译后的结果
我喜欢欧洲旅行的德语表达	{德语=语言, 我喜欢欧洲旅行=内容}	1.翻译后的结果
我喜欢欧洲旅行的泰米尔语表达	{泰米尔语=语言, 我喜欢欧洲旅行=内容}	1.翻译后的结果
“芒果糯米鸡“的西班牙语表达	{西班牙语=语言, “芒果糯米鸡“=内容}	1.翻译后的结果
我喜欢欧洲旅行的俄语表达	{俄语=语言, 我喜欢欧洲旅行=内容}	1.翻译后的结果
”雪碧“的德语表达	{德语=语言, ”雪碧“=内容}	1.翻译后的结果
去美国旅行的法语表达	{法语=语言, 去美国旅行=内容}	1.翻译后的结果
”雪碧“的意大利语表达	{意大利语=语言, ”雪碧“=内容}	1.翻译后的结果
“芒果糯米鸡“的汉语表达	{“芒果糯米鸡“=内容, 汉语=语言}	1.翻译后的结果
“芒果糯米鸡“的阿拉伯语表达	{阿拉伯语=语言, “芒果糯米鸡“=内容}	1.翻译后的结果
”雪碧“的俄语表达	{俄语=语言, ”雪碧“=内容}	1.翻译后的结果
去美国旅行的俄语表达	{俄语=语言, 去美国旅行=内容}	1.翻译后的结果
”雪碧“的日语表达	{日语=语言, ”雪碧“=内容}	1.翻译后的结果
去美国旅行的斯瓦希里语表达	{去美国旅行=内容, 斯瓦希里语=语言}	1.翻译后的结果
去美国旅行的西班牙语表达	{西班牙语=语言, 去美国旅行=内容}	1.翻译后的结果
”雪碧“的斯瓦希里语表达	{斯瓦希里语=语言, ”雪碧“=内容}	1.翻译后的结果
“芒果糯米鸡“的朝鲜语表达	{“芒果糯米鸡“=内容, 朝鲜语=语言}	1.翻译后的结果
“芒果糯米鸡“的韩语表达	{“芒果糯米鸡“=内容, 韩语=语言}	1.翻译后的结果
去美国旅行的韩语表达	{韩语=语言, 去美国旅行=内容}	1.翻译后的结果
去美国旅行的英语表达	{去美国旅行=内容, 英语=语言}	1.翻译后的结果
我喜欢欧洲旅行的意大利语表达	{意大利语=语言, 我喜欢欧洲旅行=内容}	1.翻译后的结果
“芒果糯米鸡“的德语表达	{“芒果糯米鸡“=内容, 德语=语言}	1.翻译后的结果
我喜欢欧洲旅行的西班牙语表达	{西班牙语=语言, 我喜欢欧洲旅行=内容}	1.翻译后的结果
我喜欢欧洲旅行的越南语表达	{越南语=语言, 我喜欢欧洲旅行=内容}	1.翻译后的结果
”雪碧“的越南语表达	{”雪碧“=内容, 越南语=语言}	1.翻译后的结果
”雪碧“的西班牙语表达	{西班牙语=语言, ”雪碧“=内容}	1.翻译后的结果
我喜欢欧洲旅行的朝鲜语表达	{朝鲜语=语言, 我喜欢欧洲旅行=内容}	1.翻译后的结果
“芒果糯米鸡“的泰米尔语表达	{“芒果糯米鸡“=内容, 泰米尔语=语言}	1.翻译后的结果
“芒果糯米鸡“的法语表达	{“芒果糯米鸡“=内容, 法语=语言}	1.翻译后的结果
去美国旅行的泰米尔语表达	{去美国旅行=内容, 泰米尔语=语言}	1.翻译后的结果
”雪碧“的韩语说法	{韩语=语言, ”雪碧“=内容}	1.翻译后的结果
我喜欢欧洲旅行的韩语说法	{韩语=语言, 我喜欢欧洲旅行=内容}	1.翻译后的结果
”雪碧“的西班牙语说法	{西班牙语=语言, ”雪碧“=内容}	1.翻译后的结果
去美国旅行的俄语说法	{俄语=语言, 去美国旅行=内容}	1.翻译后的结果
“芒果糯米鸡“的德语说法	{“芒果糯米鸡“=内容, 德语=语言}	1.翻译后的结果
我喜欢欧洲旅行的朝鲜语说法	{朝鲜语=语言, 我喜欢欧洲旅行=内容}	1.翻译后的结果
去美国旅行的西班牙语说法	{西班牙语=语言, 去美国旅行=内容}	1.翻译后的结果
去美国旅行的汉语说法	{去美国旅行=内容, 汉语=语言}	1.翻译后的结果
去美国旅行的朝鲜语说法	{去美国旅行=内容, 朝鲜语=语言}	1.翻译后的结果
去美国旅行的斯瓦希里语说法	{去美国旅行=内容, 斯瓦希里语=语言}	1.翻译后的结果
去美国旅行的韩语说法	{韩语=语言, 去美国旅行=内容}	1.翻译后的结果
”雪碧“的德语说法	{德语=语言, ”雪碧“=内容}	1.翻译后的结果
我喜欢欧洲旅行的阿拉伯语说法	{阿拉伯语=语言, 我喜欢欧洲旅行=内容}	1.翻译后的结果
我喜欢欧洲旅行的日语说法	{日语=语言, 我喜欢欧洲旅行=内容}	1.翻译后的结果
”雪碧“的越南语说法	{”雪碧“=内容, 越南语=语言}	1.翻译后的结果
“芒果糯米鸡“的斯瓦希里语说法	{“芒果糯米鸡“=内容, 斯瓦希里语=语言}	1.翻译后的结果
”雪碧“的斯瓦希里语说法	{斯瓦希里语=语言, ”雪碧“=内容}	1.翻译后的结果
我喜欢欧洲旅行的意大利语说法	{意大利语=语言, 我喜欢欧洲旅行=内容}	1.翻译后的结果
“芒果糯米鸡“的俄语说法	{“芒果糯米鸡“=内容, 俄语=语言}	1.翻译后的结果
”雪碧“的阿拉伯语说法	{阿拉伯语=语言, ”雪碧“=内容}	1.翻译后的结果
我喜欢欧洲旅行的法语说法	{法语=语言, 我喜欢欧洲旅行=内容}	1.翻译后的结果
去美国旅行的法语说法	{法语=语言, 去美国旅行=内容}	1.翻译后的结果
“芒果糯米鸡“的阿拉伯语说法	{阿拉伯语=语言, “芒果糯米鸡“=内容}	1.翻译后的结果
我喜欢欧洲旅行的泰米尔语说法	{泰米尔语=语言, 我喜欢欧洲旅行=内容}	1.翻译后的结果
”雪碧“的意大利语说法	{意大利语=语言, ”雪碧“=内容}	1.翻译后的结果
去美国旅行的阿拉伯语说法	{阿拉伯语=语言, 去美国旅行=内容}	1.翻译后的结果
去美国旅行的日语说法	{日语=语言, 去美国旅行=内容}	1.翻译后的结果
“芒果糯米鸡“的西班牙语说法	{西班牙语=语言, “芒果糯米鸡“=内容}	1.翻译后的结果
去美国旅行的越南语说法	{去美国旅行=内容, 越南语=语言}	1.翻译后的结果
”雪碧“的朝鲜语说法	{朝鲜语=语言, ”雪碧“=内容}	1.翻译后的结果
去美国旅行的德语说法	{去美国旅行=内容, 德语=语言}	1.翻译后的结果
”雪碧“的泰米尔语说法	{泰米尔语=语言, ”雪碧“=内容}	1.翻译后的结果
”雪碧“的汉语说法	{汉语=语言, ”雪碧“=内容}	1.翻译后的结果
我喜欢欧洲旅行的越南语说法	{越南语=语言, 我喜欢欧洲旅行=内容}	1.翻译后的结果
”雪碧“的英语说法	{”雪碧“=内容, 英语=语言}	1.翻译后的结果
我喜欢欧洲旅行的英语说法	{英语=语言, 我喜欢欧洲旅行=内容}	1.翻译后的结果
“芒果糯米鸡“的泰米尔语说法	{“芒果糯米鸡“=内容, 泰米尔语=语言}	1.翻译后的结果
去美国旅行的泰米尔语说法	{去美国旅行=内容, 泰米尔语=语言}	1.翻译后的结果
”雪碧“的俄语说法	{俄语=语言, ”雪碧“=内容}	1.翻译后的结果
”雪碧“的法语说法	{法语=语言, ”雪碧“=内容}	1.翻译后的结果
