芭堤雅怎么样	{芭堤雅=城市}	城市的详细介绍
纽约市怎么样	{纽约市=城市}	城市的详细介绍
香港怎么样	{香港=城市}	城市的详细介绍
东京怎么样	{东京=城市}	城市的详细介绍
新加坡怎么样	{新加坡=城市}	城市的详细介绍
台北怎么样	{台北=城市}	城市的详细介绍
里昂怎么样	{里昂=城市}	城市的详细介绍
普吉岛怎么样	{普吉岛=城市}	城市的详细介绍
巴黎怎么样	{巴黎=城市}	城市的详细介绍
吉萨怎么样	{吉萨=城市}	城市的详细介绍
东京如何	{东京=城市}	城市的详细介绍
澳门如何	{澳门=城市}	城市的详细介绍
芭堤雅如何	{芭堤雅=城市}	城市的详细介绍
新加坡如何	{新加坡=城市}	城市的详细介绍
首尔如何	{首尔=城市}	城市的详细介绍
里昂如何	{里昂=城市}	城市的详细介绍
普吉岛如何	{普吉岛=城市}	城市的详细介绍
纽约市如何	{纽约市=城市}	城市的详细介绍
香港如何	{香港=城市}	城市的详细介绍
台北如何	{台北=城市}	城市的详细介绍
里昂的介绍	{里昂=城市}	城市的详细介绍
台北的介绍	{台北=城市}	城市的详细介绍
澳门的介绍	{澳门=城市}	城市的详细介绍
新加坡的介绍	{新加坡=城市}	城市的详细介绍
普吉岛的介绍	{普吉岛=城市}	城市的详细介绍
西归浦的介绍	{西归浦=城市}	城市的详细介绍
东京的介绍	{东京=城市}	城市的详细介绍
芭堤雅的介绍	{芭堤雅=城市}	城市的详细介绍
香港的介绍	{香港=城市}	城市的详细介绍
吉萨的介绍	{吉萨=城市}	城市的详细介绍
首尔的介绍	{首尔=城市}	城市的详细介绍
巴黎的介绍	{巴黎=城市}	城市的详细介绍
给我介绍一下里昂	{里昂=城市}	城市的详细介绍
给我介绍一下东京	{东京=城市}	城市的详细介绍
给我介绍一下香港	{香港=城市}	城市的详细介绍
给我介绍一下普吉岛	{普吉岛=城市}	城市的详细介绍
给我介绍一下芭堤雅	{芭堤雅=城市}	城市的详细介绍
给我介绍一下澳门	{澳门=城市}	城市的详细介绍
给我介绍一下纽约市	{纽约市=城市}	城市的详细介绍
给我介绍一下首尔	{首尔=城市}	城市的详细介绍
给我介绍一下新加坡	{新加坡=城市}	城市的详细介绍
给我介绍一下吉萨	{吉萨=城市}	城市的详细介绍
给我介绍一下西归浦	{西归浦=城市}	城市的详细介绍
纽约市的详情	{纽约市=城市}	城市的详细介绍
里昂的详情	{里昂=城市}	城市的详细介绍
澳门的详情	{澳门=城市}	城市的详细介绍
台北的详情	{台北=城市}	城市的详细介绍
西归浦的详情	{西归浦=城市}	城市的详细介绍
普吉岛的详情	{普吉岛=城市}	城市的详细介绍
新加坡的详情	{新加坡=城市}	城市的详细介绍
巴黎的详情	{巴黎=城市}	城市的详细介绍
首尔的详情	{首尔=城市}	城市的详细介绍
东京的详情	{东京=城市}	城市的详细介绍
吉萨的详情	{吉萨=城市}	城市的详细介绍
香港的简介	{香港=城市}	城市的详细介绍
纽约市的简介	{纽约市=城市}	城市的详细介绍
里昂的简介	{里昂=城市}	城市的详细介绍
巴黎的简介	{巴黎=城市}	城市的详细介绍
吉萨的简介	{吉萨=城市}	城市的详细介绍
芭堤雅的简介	{芭堤雅=城市}	城市的详细介绍
东京的简介	{东京=城市}	城市的详细介绍
西归浦的简介	{西归浦=城市}	城市的详细介绍
首尔的简介	{首尔=城市}	城市的详细介绍
普吉岛的简介	{普吉岛=城市}	城市的详细介绍
台北的简介	{台北=城市}	城市的详细介绍
巴黎的美景	{巴黎=城市, 美景=城市特定信息}	[城市特定信息]
里昂的语言	{语言=城市特定信息, 里昂=城市}	[城市特定信息]
香港的面积	{香港=城市, 面积=城市特定信息}	[城市特定信息]
香港的人口	{人口=城市特定信息, 香港=城市}	[城市特定信息]
里昂的历史	{里昂=城市, 历史=城市特定信息}	[城市特定信息]
芭堤雅的历史	{历史=城市特定信息, 芭堤雅=城市}	[城市特定信息]
新加坡的美景	{新加坡=城市, 美景=城市特定信息}	[城市特定信息]
香港的语言	{语言=城市特定信息, 香港=城市}	[城市特定信息]
澳门的典故	{典故=城市特定信息, 澳门=城市}	[城市特定信息]
澳门的货币	{澳门=城市, 货币=城市特定信息}	[城市特定信息]
新加坡的购物推荐	{购物推荐=城市特定信息, 新加坡=城市}	[城市特定信息]
新加坡的人口	{人口=城市特定信息, 新加坡=城市}	[城市特定信息]
首尔的人口	{人口=城市特定信息, 首尔=城市}	[城市特定信息]
西归浦的特色	{西归浦=城市, 特色=城市特定信息}	[城市特定信息]
东京的特色	{特色=城市特定信息, 东京=城市}	[城市特定信息]
台北的美景	{台北=城市, 美景=城市特定信息}	[城市特定信息]
新加坡的语言	{语言=城市特定信息, 新加坡=城市}	[城市特定信息]
芭堤雅的购物推荐	{购物推荐=城市特定信息, 芭堤雅=城市}	[城市特定信息]
巴黎的历史	{巴黎=城市, 历史=城市特定信息}	[城市特定信息]
东京的美食	{美食=城市特定信息, 东京=城市}	[城市特定信息]
澳门的特色	{特色=城市特定信息, 澳门=城市}	[城市特定信息]
普吉岛的典故	{典故=城市特定信息, 普吉岛=城市}	[城市特定信息]
普吉岛的特色	{特色=城市特定信息, 普吉岛=城市}	[城市特定信息]
芭堤雅的语言	{语言=城市特定信息, 芭堤雅=城市}	[城市特定信息]
首尔的典故	{典故=城市特定信息, 首尔=城市}	[城市特定信息]
芭堤雅的典故	{典故=城市特定信息, 芭堤雅=城市}	[城市特定信息]
巴黎的典故	{巴黎=城市, 典故=城市特定信息}	[城市特定信息]
东京的美景	{东京=城市, 美景=城市特定信息}	[城市特定信息]
香港的美景	{香港=城市, 美景=城市特定信息}	[城市特定信息]
里昂的购物推荐	{购物推荐=城市特定信息, 里昂=城市}	[城市特定信息]
台北的特色	{特色=城市特定信息, 台北=城市}	[城市特定信息]
新加坡的历史	{历史=城市特定信息, 新加坡=城市}	[城市特定信息]
西归浦的美景	{西归浦=城市, 美景=城市特定信息}	[城市特定信息]
纽约市的语言	{纽约市=城市, 语言=城市特定信息}	[城市特定信息]
吉萨的典故	{吉萨=城市, 典故=城市特定信息}	[城市特定信息]
芭堤雅的面积	{芭堤雅=城市, 面积=城市特定信息}	[城市特定信息]
香港的特色	{香港=城市, 特色=城市特定信息}	[城市特定信息]
里昂的美食	{美食=城市特定信息, 里昂=城市}	[城市特定信息]
台北的人口	{人口=城市特定信息, 台北=城市}	[城市特定信息]
东京的货币	{东京=城市, 货币=城市特定信息}	[城市特定信息]
里昂的特色	{里昂=城市, 特色=城市特定信息}	[城市特定信息]
西归浦的人口	{人口=城市特定信息, 西归浦=城市}	[城市特定信息]
纽约市的货币	{纽约市=城市, 货币=城市特定信息}	[城市特定信息]
台北的语言	{语言=城市特定信息, 台北=城市}	[城市特定信息]
新加坡的特色	{特色=城市特定信息, 新加坡=城市}	[城市特定信息]
台北的位置	{位置=城市特定信息, 台北=城市}	[城市特定信息]
普吉岛的美景	{普吉岛=城市, 美景=城市特定信息}	[城市特定信息]
里昂的典故	{里昂=城市, 典故=城市特定信息}	[城市特定信息]
澳门的购物推荐	{购物推荐=城市特定信息, 澳门=城市}	[城市特定信息]
巴黎的位置	{巴黎=城市, 位置=城市特定信息}	[城市特定信息]
新加坡的美食	{美食=城市特定信息, 新加坡=城市}	[城市特定信息]
吉萨的历史	{吉萨=城市, 历史=城市特定信息}	[城市特定信息]
普吉岛的历史	{历史=城市特定信息, 普吉岛=城市}	[城市特定信息]
巴黎的货币	{巴黎=城市, 货币=城市特定信息}	[城市特定信息]
澳门的位置	{澳门=城市, 位置=城市特定信息}	[城市特定信息]
里昂的美景	{里昂=城市, 美景=城市特定信息}	[城市特定信息]
台北的货币	{货币=城市特定信息, 台北=城市}	[城市特定信息]
普吉岛的美食	{美食=城市特定信息, 普吉岛=城市}	[城市特定信息]
澳门的美食	{美食=城市特定信息, 澳门=城市}	[城市特定信息]
台北的面积	{台北=城市, 面积=城市特定信息}	[城市特定信息]
芭堤雅的位置	{芭堤雅=城市, 位置=城市特定信息}	[城市特定信息]
西归浦的美食	{美食=城市特定信息, 西归浦=城市}	[城市特定信息]
西归浦的典故	{西归浦=城市, 典故=城市特定信息}	[城市特定信息]
澳门的人口	{人口=城市特定信息, 澳门=城市}	[城市特定信息]
里昂的位置	{里昂=城市, 位置=城市特定信息}	[城市特定信息]
普吉岛的购物推荐	{购物推荐=城市特定信息, 普吉岛=城市}	[城市特定信息]
普吉岛的语言	{语言=城市特定信息, 普吉岛=城市}	[城市特定信息]
新加坡的典故	{典故=城市特定信息, 新加坡=城市}	[城市特定信息]
芭堤雅的货币	{芭堤雅=城市, 货币=城市特定信息}	[城市特定信息]
吉萨的面积	{吉萨=城市, 面积=城市特定信息}	[城市特定信息]
普吉岛的位置	{普吉岛=城市, 位置=城市特定信息}	[城市特定信息]
东京的面积	{东京=城市, 面积=城市特定信息}	[城市特定信息]
吉萨的美食	{美食=城市特定信息, 吉萨=城市}	[城市特定信息]
芭堤雅的特色	{特色=城市特定信息, 芭堤雅=城市}	[城市特定信息]
澳门的面积	{澳门=城市, 面积=城市特定信息}	[城市特定信息]
芭堤雅的人口	{人口=城市特定信息, 芭堤雅=城市}	[城市特定信息]
东京的人口	{人口=城市特定信息, 东京=城市}	[城市特定信息]
巴黎的语言	{巴黎=城市, 语言=城市特定信息}	[城市特定信息]
巴黎的面积	{巴黎=城市, 面积=城市特定信息}	[城市特定信息]
里昂的货币	{里昂=城市, 货币=城市特定信息}	[城市特定信息]
纽约市的人口	{人口=城市特定信息, 纽约市=城市}	[城市特定信息]
纽约市的美景	{纽约市=城市, 美景=城市特定信息}	[城市特定信息]
巴黎的美食	{巴黎=城市, 美食=城市特定信息}	[城市特定信息]
香港的历史	{香港=城市, 历史=城市特定信息}	[城市特定信息]
普吉岛的人口	{人口=城市特定信息, 普吉岛=城市}	[城市特定信息]
普吉岛的货币	{普吉岛=城市, 货币=城市特定信息}	[城市特定信息]
吉萨的货币	{吉萨=城市, 货币=城市特定信息}	[城市特定信息]
香港的典故	{香港=城市, 典故=城市特定信息}	[城市特定信息]
西归浦的历史	{西归浦=城市, 历史=城市特定信息}	[城市特定信息]
普吉岛的面积	{普吉岛=城市, 面积=城市特定信息}	[城市特定信息]
西归浦的购物推荐	{购物推荐=城市特定信息, 西归浦=城市}	[城市特定信息]
芭堤雅的美食	{美食=城市特定信息, 芭堤雅=城市}	[城市特定信息]
新加坡的位置	{新加坡=城市, 位置=城市特定信息}	[城市特定信息]
吉萨的购物推荐	{购物推荐=城市特定信息, 吉萨=城市}	[城市特定信息]
纽约市的位置	{纽约市=城市, 位置=城市特定信息}	[城市特定信息]
里昂的人口	{人口=城市特定信息, 里昂=城市}	[城市特定信息]
台北的购物推荐	{购物推荐=城市特定信息, 台北=城市}	[城市特定信息]
里昂的面积	{里昂=城市, 面积=城市特定信息}	[城市特定信息]
西归浦的面积	{西归浦=城市, 面积=城市特定信息}	[城市特定信息]
台北的美食	{美食=城市特定信息, 台北=城市}	[城市特定信息]
香港货币	{香港=城市, 货币=城市特定信息}	[城市特定信息]
普吉岛人口	{人口=城市特定信息, 普吉岛=城市}	[城市特定信息]
香港购物推荐	{购物推荐=城市特定信息, 香港=城市}	[城市特定信息]
台北面积	{台北=城市, 面积=城市特定信息}	[城市特定信息]
东京人口	{人口=城市特定信息, 东京=城市}	[城市特定信息]
香港美景	{香港=城市, 美景=城市特定信息}	[城市特定信息]
台北购物推荐	{购物推荐=城市特定信息, 台北=城市}	[城市特定信息]
纽约市语言	{纽约市=城市, 语言=城市特定信息}	[城市特定信息]
澳门货币	{澳门=城市, 货币=城市特定信息}	[城市特定信息]
芭堤雅特色	{特色=城市特定信息, 芭堤雅=城市}	[城市特定信息]
西归浦美食	{美食=城市特定信息, 西归浦=城市}	[城市特定信息]
新加坡位置	{新加坡=城市, 位置=城市特定信息}	[城市特定信息]
芭堤雅典故	{典故=城市特定信息, 芭堤雅=城市}	[城市特定信息]
普吉岛典故	{典故=城市特定信息, 普吉岛=城市}	[城市特定信息]
西归浦历史	{西归浦=城市, 历史=城市特定信息}	[城市特定信息]
巴黎购物推荐	{巴黎=城市, 购物推荐=城市特定信息}	[城市特定信息]
西归浦典故	{西归浦=城市, 典故=城市特定信息}	[城市特定信息]
台北人口	{人口=城市特定信息, 台北=城市}	[城市特定信息]
吉萨位置	{吉萨=城市, 位置=城市特定信息}	[城市特定信息]
澳门购物推荐	{购物推荐=城市特定信息, 澳门=城市}	[城市特定信息]
台北语言	{语言=城市特定信息, 台北=城市}	[城市特定信息]
芭堤雅购物推荐	{购物推荐=城市特定信息, 芭堤雅=城市}	[城市特定信息]
芭堤雅语言	{语言=城市特定信息, 芭堤雅=城市}	[城市特定信息]
西归浦美景	{西归浦=城市, 美景=城市特定信息}	[城市特定信息]
首尔位置	{位置=城市特定信息, 首尔=城市}	[城市特定信息]
西归浦位置	{西归浦=城市, 位置=城市特定信息}	[城市特定信息]
巴黎美景	{巴黎=城市, 美景=城市特定信息}	[城市特定信息]
台北位置	{位置=城市特定信息, 台北=城市}	[城市特定信息]
澳门位置	{澳门=城市, 位置=城市特定信息}	[城市特定信息]
新加坡货币	{新加坡=城市, 货币=城市特定信息}	[城市特定信息]
香港面积	{香港=城市, 面积=城市特定信息}	[城市特定信息]
澳门典故	{典故=城市特定信息, 澳门=城市}	[城市特定信息]
东京美食	{美食=城市特定信息, 东京=城市}	[城市特定信息]
西归浦面积	{西归浦=城市, 面积=城市特定信息}	[城市特定信息]
纽约市货币	{纽约市=城市, 货币=城市特定信息}	[城市特定信息]
里昂位置	{里昂=城市, 位置=城市特定信息}	[城市特定信息]
吉萨典故	{吉萨=城市, 典故=城市特定信息}	[城市特定信息]
普吉岛美景	{普吉岛=城市, 美景=城市特定信息}	[城市特定信息]
首尔美景	{首尔=城市, 美景=城市特定信息}	[城市特定信息]
普吉岛特色	{特色=城市特定信息, 普吉岛=城市}	[城市特定信息]
吉萨美食	{美食=城市特定信息, 吉萨=城市}	[城市特定信息]
台北美景	{台北=城市, 美景=城市特定信息}	[城市特定信息]
普吉岛面积	{普吉岛=城市, 面积=城市特定信息}	[城市特定信息]
首尔购物推荐	{购物推荐=城市特定信息, 首尔=城市}	[城市特定信息]
西归浦特色	{西归浦=城市, 特色=城市特定信息}	[城市特定信息]
巴黎货币	{巴黎=城市, 货币=城市特定信息}	[城市特定信息]
芭堤雅面积	{芭堤雅=城市, 面积=城市特定信息}	[城市特定信息]
澳门特色	{特色=城市特定信息, 澳门=城市}	[城市特定信息]
里昂美景	{里昂=城市, 美景=城市特定信息}	[城市特定信息]
普吉岛美食	{美食=城市特定信息, 普吉岛=城市}	[城市特定信息]
吉萨面积	{吉萨=城市, 面积=城市特定信息}	[城市特定信息]
澳门历史	{历史=城市特定信息, 澳门=城市}	[城市特定信息]
台北美食	{美食=城市特定信息, 台北=城市}	[城市特定信息]
东京特色	{特色=城市特定信息, 东京=城市}	[城市特定信息]
普吉岛购物推荐	{购物推荐=城市特定信息, 普吉岛=城市}	[城市特定信息]
里昂典故	{里昂=城市, 典故=城市特定信息}	[城市特定信息]
首尔历史	{历史=城市特定信息, 首尔=城市}	[城市特定信息]
里昂货币	{里昂=城市, 货币=城市特定信息}	[城市特定信息]
纽约市人口	{人口=城市特定信息, 纽约市=城市}	[城市特定信息]
东京位置	{东京=城市, 位置=城市特定信息}	[城市特定信息]
巴黎语言	{巴黎=城市, 语言=城市特定信息}	[城市特定信息]
西归浦购物推荐	{购物推荐=城市特定信息, 西归浦=城市}	[城市特定信息]
首尔美食	{美食=城市特定信息, 首尔=城市}	[城市特定信息]
里昂特色	{里昂=城市, 特色=城市特定信息}	[城市特定信息]
普吉岛货币	{普吉岛=城市, 货币=城市特定信息}	[城市特定信息]
巴黎历史	{巴黎=城市, 历史=城市特定信息}	[城市特定信息]
香港位置	{香港=城市, 位置=城市特定信息}	[城市特定信息]
东京美景	{东京=城市, 美景=城市特定信息}	[城市特定信息]
新加坡购物推荐	{购物推荐=城市特定信息, 新加坡=城市}	[城市特定信息]
普吉岛位置	{普吉岛=城市, 位置=城市特定信息}	[城市特定信息]
里昂人口	{人口=城市特定信息, 里昂=城市}	[城市特定信息]
巴黎美食	{巴黎=城市, 美食=城市特定信息}	[城市特定信息]
首尔典故	{典故=城市特定信息, 首尔=城市}	[城市特定信息]
东京货币	{东京=城市, 货币=城市特定信息}	[城市特定信息]
里昂历史	{里昂=城市, 历史=城市特定信息}	[城市特定信息]
里昂语言	{语言=城市特定信息, 里昂=城市}	[城市特定信息]
里昂面积	{里昂=城市, 面积=城市特定信息}	[城市特定信息]
首尔面积	{首尔=城市, 面积=城市特定信息}	[城市特定信息]
纽约市历史	{纽约市=城市, 历史=城市特定信息}	[城市特定信息]
巴黎特色	{巴黎=城市, 特色=城市特定信息}	[城市特定信息]
台北典故	{典故=城市特定信息, 台北=城市}	[城市特定信息]
香港美食	{美食=城市特定信息, 香港=城市}	[城市特定信息]
吉萨人口	{人口=城市特定信息, 吉萨=城市}	[城市特定信息]
首尔语言	{语言=城市特定信息, 首尔=城市}	[城市特定信息]
巴黎人口	{人口=城市特定信息, 巴黎=城市}	[城市特定信息]
香港特色	{香港=城市, 特色=城市特定信息}	[城市特定信息]
新加坡美食	{美食=城市特定信息, 新加坡=城市}	[城市特定信息]
纽约市购物推荐	{纽约市=城市, 购物推荐=城市特定信息}	[城市特定信息]
东京历史	{历史=城市特定信息, 东京=城市}	[城市特定信息]
西归浦语言	{语言=城市特定信息, 西归浦=城市}	[城市特定信息]
吉萨历史	{吉萨=城市, 历史=城市特定信息}	[城市特定信息]
普吉岛历史	{历史=城市特定信息, 普吉岛=城市}	[城市特定信息]
芭堤雅位置	{芭堤雅=城市, 位置=城市特定信息}	[城市特定信息]
西归浦人口	{人口=城市特定信息, 西归浦=城市}	[城市特定信息]
首尔的人口情况	{人口=城市特定信息, 首尔=城市}	[城市特定信息]
东京的特色情况	{特色=城市特定信息, 东京=城市}	[城市特定信息]
纽约市的面积情况	{纽约市=城市, 面积=城市特定信息}	[城市特定信息]
吉萨的历史情况	{吉萨=城市, 历史=城市特定信息}	[城市特定信息]
里昂的位置情况	{里昂=城市, 位置=城市特定信息}	[城市特定信息]
首尔的典故情况	{典故=城市特定信息, 首尔=城市}	[城市特定信息]
东京的历史情况	{历史=城市特定信息, 东京=城市}	[城市特定信息]
巴黎的美食情况	{巴黎=城市, 美食=城市特定信息}	[城市特定信息]
东京的人口情况	{人口=城市特定信息, 东京=城市}	[城市特定信息]
东京的美食情况	{美食=城市特定信息, 东京=城市}	[城市特定信息]
纽约市的购物推荐情况	{纽约市=城市, 购物推荐=城市特定信息}	[城市特定信息]
新加坡的购物推荐情况	{购物推荐=城市特定信息, 新加坡=城市}	[城市特定信息]
吉萨的人口情况	{人口=城市特定信息, 吉萨=城市}	[城市特定信息]
首尔的美食情况	{美食=城市特定信息, 首尔=城市}	[城市特定信息]
普吉岛的人口情况	{人口=城市特定信息, 普吉岛=城市}	[城市特定信息]
首尔的货币情况	{货币=城市特定信息, 首尔=城市}	[城市特定信息]
吉萨的语言情况	{语言=城市特定信息, 吉萨=城市}	[城市特定信息]
纽约市的货币情况	{纽约市=城市, 货币=城市特定信息}	[城市特定信息]
西归浦的货币情况	{西归浦=城市, 货币=城市特定信息}	[城市特定信息]
首尔的购物推荐情况	{购物推荐=城市特定信息, 首尔=城市}	[城市特定信息]
新加坡的美食情况	{美食=城市特定信息, 新加坡=城市}	[城市特定信息]
纽约市的美食情况	{美食=城市特定信息, 纽约市=城市}	[城市特定信息]
台北的购物推荐情况	{购物推荐=城市特定信息, 台北=城市}	[城市特定信息]
新加坡的货币情况	{新加坡=城市, 货币=城市特定信息}	[城市特定信息]
东京的典故情况	{典故=城市特定信息, 东京=城市}	[城市特定信息]
香港的货币情况	{香港=城市, 货币=城市特定信息}	[城市特定信息]
新加坡的典故情况	{典故=城市特定信息, 新加坡=城市}	[城市特定信息]
纽约市的典故情况	{纽约市=城市, 典故=城市特定信息}	[城市特定信息]
吉萨的美食情况	{美食=城市特定信息, 吉萨=城市}	[城市特定信息]
新加坡的特色情况	{特色=城市特定信息, 新加坡=城市}	[城市特定信息]
台北的人口情况	{人口=城市特定信息, 台北=城市}	[城市特定信息]
西归浦的历史情况	{西归浦=城市, 历史=城市特定信息}	[城市特定信息]
吉萨的货币情况	{吉萨=城市, 货币=城市特定信息}	[城市特定信息]
吉萨的特色情况	{吉萨=城市, 特色=城市特定信息}	[城市特定信息]
普吉岛的美景情况	{普吉岛=城市, 美景=城市特定信息}	[城市特定信息]
澳门的人口情况	{人口=城市特定信息, 澳门=城市}	[城市特定信息]
里昂的人口情况	{人口=城市特定信息, 里昂=城市}	[城市特定信息]
澳门的购物推荐情况	{购物推荐=城市特定信息, 澳门=城市}	[城市特定信息]
澳门的美景情况	{澳门=城市, 美景=城市特定信息}	[城市特定信息]
台北的货币情况	{货币=城市特定信息, 台北=城市}	[城市特定信息]
新加坡的美景情况	{新加坡=城市, 美景=城市特定信息}	[城市特定信息]
西归浦的美食情况	{美食=城市特定信息, 西归浦=城市}	[城市特定信息]
台北的历史情况	{历史=城市特定信息, 台北=城市}	[城市特定信息]
芭堤雅的人口情况	{人口=城市特定信息, 芭堤雅=城市}	[城市特定信息]
巴黎的语言情况	{巴黎=城市, 语言=城市特定信息}	[城市特定信息]
新加坡的人口情况	{人口=城市特定信息, 新加坡=城市}	[城市特定信息]
巴黎的典故情况	{巴黎=城市, 典故=城市特定信息}	[城市特定信息]
西归浦的特色情况	{西归浦=城市, 特色=城市特定信息}	[城市特定信息]
普吉岛的购物推荐情况	{购物推荐=城市特定信息, 普吉岛=城市}	[城市特定信息]
芭堤雅的历史情况	{历史=城市特定信息, 芭堤雅=城市}	[城市特定信息]
澳门的典故情况	{典故=城市特定信息, 澳门=城市}	[城市特定信息]
西归浦的位置情况	{西归浦=城市, 位置=城市特定信息}	[城市特定信息]
澳门的特色情况	{特色=城市特定信息, 澳门=城市}	[城市特定信息]
里昂的历史情况	{里昂=城市, 历史=城市特定信息}	[城市特定信息]
新加坡有什么好玩的	{好玩的=城市特定信息相关, 新加坡=城市}	[城市特定信息]
澳门有什么好买的	{好买的=城市特定信息相关, 澳门=城市}	[城市特定信息]
香港有什么好玩的	{香港=城市, 好玩的=城市特定信息相关}	[城市特定信息]
纽约市有什么好买的	{纽约市=城市, 好买的=城市特定信息相关}	[城市特定信息]
吉萨有什么好吃的	{好吃的=城市特定信息相关, 吉萨=城市}	[城市特定信息]
吉萨有什么好玩的	{吉萨=城市, 好玩的=城市特定信息相关}	[城市特定信息]
东京有什么好玩的	{好玩的=城市特定信息相关, 东京=城市}	[城市特定信息]
西归浦有什么好吃的	{西归浦=城市, 好吃的=城市特定信息相关}	[城市特定信息]
普吉岛有什么好买的	{好买的=城市特定信息相关, 普吉岛=城市}	[城市特定信息]
新加坡有什么好吃的	{好吃的=城市特定信息相关, 新加坡=城市}	[城市特定信息]
芭堤雅有什么好买的	{好买的=城市特定信息相关, 芭堤雅=城市}	[城市特定信息]
里昂有什么好吃的	{里昂=城市, 好吃的=城市特定信息相关}	[城市特定信息]
澳门有什么值得买	{澳门=城市, 值得买=城市特定信息相关}	[城市特定信息]
纽约市有什么值得买	{纽约市=城市, 值得买=城市特定信息相关}	[城市特定信息]
巴黎有什么值得买	{巴黎=城市, 值得买=城市特定信息相关}	[城市特定信息]
香港有什么好吃的	{好吃的=城市特定信息相关, 香港=城市}	[城市特定信息]
香港有什么好买的	{香港=城市, 好买的=城市特定信息相关}	[城市特定信息]
里昂有什么好玩的	{里昂=城市, 好玩的=城市特定信息相关}	[城市特定信息]
西归浦有什么好玩的	{西归浦=城市, 好玩的=城市特定信息相关}	[城市特定信息]
东京有什么好吃的	{好吃的=城市特定信息相关, 东京=城市}	[城市特定信息]
东京有什么好买的	{好买的=城市特定信息相关, 东京=城市}	[城市特定信息]
普吉岛有什么值得买	{普吉岛=城市, 值得买=城市特定信息相关}	[城市特定信息]
吉萨有什么值得买	{吉萨=城市, 值得买=城市特定信息相关}	[城市特定信息]
巴黎有什么好玩的	{巴黎=城市, 好玩的=城市特定信息相关}	[城市特定信息]
普吉岛有什么好玩的	{好玩的=城市特定信息相关, 普吉岛=城市}	[城市特定信息]
西归浦有什么好买的	{西归浦=城市, 好买的=城市特定信息相关}	[城市特定信息]
普吉岛有什么好吃的	{好吃的=城市特定信息相关, 普吉岛=城市}	[城市特定信息]
东京有什么值得买	{东京=城市, 值得买=城市特定信息相关}	[城市特定信息]
纽约市有什么好吃的	{纽约市=城市, 好吃的=城市特定信息相关}	[城市特定信息]
巴黎有什么好买的	{巴黎=城市, 好买的=城市特定信息相关}	[城市特定信息]
芭堤雅有什么好玩的	{好玩的=城市特定信息相关, 芭堤雅=城市}	[城市特定信息]
首尔有什么好买的	{好买的=城市特定信息相关, 首尔=城市}	[城市特定信息]
澳门有什么好玩的	{好玩的=城市特定信息相关, 澳门=城市}	[城市特定信息]
芭堤雅有什么好吃的	{好吃的=城市特定信息相关, 芭堤雅=城市}	[城市特定信息]
巴黎有什么好吃的	{巴黎=城市, 好吃的=城市特定信息相关}	[城市特定信息]
吉萨有什么好买的	{吉萨=城市, 好买的=城市特定信息相关}	[城市特定信息]
里昂有什么好买的	{里昂=城市, 好买的=城市特定信息相关}	[城市特定信息]
首尔有什么值得买	{首尔=城市, 值得买=城市特定信息相关}	[城市特定信息]
首尔有什么好玩的	{好玩的=城市特定信息相关, 首尔=城市}	[城市特定信息]
西归浦有什么特色	{西归浦=城市}	特色
普吉岛有什么特色	{普吉岛=城市}	特色
澳门有什么特色	{澳门=城市}	特色
巴黎有什么特色	{巴黎=城市}	特色
芭堤雅有什么特色	{芭堤雅=城市}	特色
香港有什么特色	{香港=城市}	特色
纽约市有什么特色	{纽约市=城市}	特色
台北有什么特色	{台北=城市}	特色
新加坡有什么特色	{新加坡=城市}	特色
里昂有什么特色	{里昂=城市}	特色
东京有什么特色	{东京=城市}	特色
芭堤雅的特色是什么	{芭堤雅=城市}	特色
吉萨的特色是什么	{吉萨=城市}	特色
香港的特色是什么	{香港=城市}	特色
巴黎的特色是什么	{巴黎=城市}	特色
首尔的特色是什么	{首尔=城市}	特色
西归浦的特色是什么	{西归浦=城市}	特色
普吉岛的特色是什么	{普吉岛=城市}	特色
纽约市的特色是什么	{纽约市=城市}	特色
台北的特色是什么	{台北=城市}	特色
里昂的特色是什么	{里昂=城市}	特色
新加坡的特色是什么	{新加坡=城市}	特色
澳门的特色都有什么	{澳门=城市}	特色
新加坡的特色都有什么	{新加坡=城市}	特色
普吉岛的特色都有什么	{普吉岛=城市}	特色
香港的特色都有什么	{香港=城市}	特色
巴黎的特色都有什么	{巴黎=城市}	特色
东京的特色都有什么	{东京=城市}	特色
首尔的特色都有什么	{首尔=城市}	特色
西归浦的特色都有什么	{西归浦=城市}	特色
吉萨的特色都有什么	{吉萨=城市}	特色
里昂的特色都有什么	{里昂=城市}	特色
在普吉岛有什么特色吗	{普吉岛=城市}	特色
在澳门有什么特色吗	{澳门=城市}	特色
在台北有什么特色吗	{台北=城市}	特色
在西归浦有什么特色吗	{西归浦=城市}	特色
在东京有什么特色吗	{东京=城市}	特色
在新加坡有什么特色吗	{新加坡=城市}	特色
在巴黎有什么特色吗	{巴黎=城市}	特色
在吉萨有什么特色吗	{吉萨=城市}	特色
在里昂有什么特色吗	{里昂=城市}	特色
在香港有什么特色吗	{香港=城市}	特色
在纽约市有什么特色吗	{纽约市=城市}	特色
在芭堤雅有什么特色吗	{芭堤雅=城市}	特色
在东京有哪些特色	{东京=城市}	特色
在吉萨有哪些特色	{吉萨=城市}	特色
在普吉岛有哪些特色	{普吉岛=城市}	特色
在芭堤雅有哪些特色	{芭堤雅=城市}	特色
在首尔有哪些特色	{首尔=城市}	特色
在新加坡有哪些特色	{新加坡=城市}	特色
在西归浦有哪些特色	{西归浦=城市}	特色
在巴黎有哪些特色	{巴黎=城市}	特色
在澳门有哪些特色	{澳门=城市}	特色
在纽约市有哪些特色	{纽约市=城市}	特色
宫古岛说什么语言	{宫古岛=地区国家城市}	语言
枫丹白露说什么语言	{枫丹白露=地区国家城市}	语言
釜山说什么语言	{釜山=地区国家城市}	语言
罗腾堡说什么语言	{罗腾堡=地区国家城市}	语言
东南亚说什么语言	{东南亚=地区国家城市}	语言
顺化说什么语言	{顺化=地区国家城市}	语言
东枝说什么语言	{东枝=地区国家城市}	语言
圣克鲁斯说什么语言	{圣克鲁斯=地区国家城市}	语言
开普敦说什么语言	{开普敦=地区国家城市}	语言
卢卡拉说什么语言	{卢卡拉=地区国家城市}	语言
林雪平说什么语言	{林雪平=地区国家城市}	语言
春武里府说什么语言	{春武里府=地区国家城市}	语言
布拉加说什么语言	{布拉加=地区国家城市}	语言
斯米兰群岛说什么语言	{斯米兰群岛=地区国家城市}	语言
普纳奥亚说什么语言	{普纳奥亚=地区国家城市}	语言
布鲁日说什么语言	{布鲁日=地区国家城市}	语言
圣安娜说什么语言	{圣安娜=地区国家城市}	语言
塔哈岛说什么语言	{塔哈岛=地区国家城市}	语言
谢尔盖耶夫说什么语言	{谢尔盖耶夫=地区国家城市}	语言
埃德蒙顿说什么语言	{埃德蒙顿=地区国家城市}	语言
莫尔斯比港说什么语言	{莫尔斯比港=地区国家城市}	语言
格拉纳达说什么语言	{格拉纳达=地区国家城市}	语言
新不列颠岛说什么语言	{新不列颠岛=地区国家城市}	语言
马斯帕洛马斯说什么语言	{马斯帕洛马斯=地区国家城市}	语言
吉达说什么语言	{吉达=地区国家城市}	语言
南设得兰群岛说什么语言	{南设得兰群岛=地区国家城市}	语言
基尔根尼说什么语言	{基尔根尼=地区国家城市}	语言
滑铁卢说什么语言	{滑铁卢=地区国家城市}	语言
热浪岛说什么语言	{热浪岛=地区国家城市}	语言
磅湛说什么语言	{磅湛=地区国家城市}	语言
木浦市说什么语言	{木浦市=地区国家城市}	语言
吉马良斯说什么语言	{吉马良斯=地区国家城市}	语言
曼谷说什么语言	{曼谷=地区国家城市}	语言
锡耶纳说什么语言	{锡耶纳=地区国家城市}	语言
龙目岛说什么语言	{龙目岛=地区国家城市}	语言
潘切市说什么语言	{潘切市=地区国家城市}	语言
丰沙湾说什么语言	{丰沙湾=地区国家城市}	语言
布阿苏说什么语言	{布阿苏=地区国家城市}	语言
花莲说什么语言	{花莲=地区国家城市}	语言
昆卡说什么语言	{昆卡=地区国家城市}	语言
新西兰说什么语言	{新西兰=地区国家城市}	语言
曼德勒说什么语言	{曼德勒=地区国家城市}	语言
伯克利说什么语言	{伯克利=地区国家城市}	语言
卡塔赫纳说什么语言	{卡塔赫纳=地区国家城市}	语言
下龙湾说什么语言	{下龙湾=地区国家城市}	语言
达卡说什么语言	{达卡=地区国家城市}	语言
新北说什么语言	{新北=地区国家城市}	语言
眉谬说什么语言	{眉谬=地区国家城市}	语言
帕岸岛说什么语言	{帕岸岛=地区国家城市}	语言
越南说什么语言	{越南=地区国家城市}	语言
门迪说什么语言	{门迪=地区国家城市}	语言
卡梅尔说什么语言	{卡梅尔=地区国家城市}	语言
索伦托说什么语言	{索伦托=地区国家城市}	语言
华盛顿说什么语言	{华盛顿=地区国家城市}	语言
法国说什么语言	{法国=地区国家城市}	语言
施瓦茨说什么语言	{施瓦茨=地区国家城市}	语言
米科诺斯岛说什么语言	{米科诺斯岛=地区国家城市}	语言
帕皮提说什么语言	{帕皮提=地区国家城市}	语言
列治文说什么语言	{列治文=地区国家城市}	语言
富吉拉说什么语言	{富吉拉=地区国家城市}	语言
宜兰说什么语言	{宜兰=地区国家城市}	语言
费特希耶说什么语言	{费特希耶=地区国家城市}	语言
基隆说什么语言	{基隆=地区国家城市}	语言
登别说什么语言	{登别=地区国家城市}	语言
拜县说什么语言	{拜县=地区国家城市}	语言
莱蒂西亚说什么语言	{莱蒂西亚=地区国家城市}	语言
芭堤雅说什么语言	{芭堤雅=地区国家城市}	语言
马萨达说什么语言	{马萨达=地区国家城市}	语言
比隆说什么语言	{比隆=地区国家城市}	语言
克拉根福说什么语言	{克拉根福=地区国家城市}	语言
巴塞罗那说什么语言	{巴塞罗那=地区国家城市}	语言
艾恩说什么语言	{艾恩=地区国家城市}	语言
贝特谢安说什么语言	{贝特谢安=地区国家城市}	语言
澎湖列岛说什么语言	{澎湖列岛=地区国家城市}	语言
阿利坎特说什么语言	{阿利坎特=地区国家城市}	语言
费城说什么语言	{费城=地区国家城市}	语言
莫斯科说什么语言	{莫斯科=地区国家城市}	语言
西班牙说什么语言	{西班牙=地区国家城市}	语言
科克说什么语言	{科克=地区国家城市}	语言
雷斯蒙说什么语言	{雷斯蒙=地区国家城市}	语言
廷布说什么语言	{廷布=地区国家城市}	语言
佩雷拉说什么语言	{佩雷拉=地区国家城市}	语言
新竹说什么语言	{新竹=地区国家城市}	语言
高松说什么语言	{高松=地区国家城市}	语言
米蒂亚罗岛说什么语言	{米蒂亚罗岛=地区国家城市}	语言
中国说什么语言	{中国=地区国家城市}	语言
德国说什么语言	{德国=地区国家城市}	语言
塔维拉说什么语言	{塔维拉=地区国家城市}	语言
苏伊士说什么语言	{苏伊士=地区国家城市}	语言
大田说什么语言	{大田=地区国家城市}	语言
苏拉哈说什么语言	{苏拉哈=地区国家城市}	语言
巴登-巴登说什么语言	{巴登-巴登=地区国家城市}	语言
霍尼亚拉说什么语言	{霍尼亚拉=地区国家城市}	语言
庞贝说什么语言	{庞贝=地区国家城市}	语言
伊瓜苏港说什么语言	{伊瓜苏港=地区国家城市}	语言
凡尔赛说什么语言	{凡尔赛=地区国家城市}	语言
日内瓦说什么语言	{日内瓦=地区国家城市}	语言
雅加达说什么语言	{雅加达=地区国家城市}	语言
丹老说什么语言	{丹老=地区国家城市}	语言
不莱梅说什么语言	{不莱梅=地区国家城市}	语言
忠州说哪种语言	{忠州=地区国家城市}	语言
万象说哪种语言	{万象=地区国家城市}	语言
拿骚说哪种语言	{拿骚=地区国家城市}	语言
帕岸岛说哪种语言	{帕岸岛=地区国家城市}	语言
夜丰颂说哪种语言	{夜丰颂=地区国家城市}	语言
圣玛尔塔说哪种语言	{圣玛尔塔=地区国家城市}	语言
提比里亚说哪种语言	{提比里亚=地区国家城市}	语言
瓦胡卡岛说哪种语言	{瓦胡卡岛=地区国家城市}	语言
苏伊士说哪种语言	{苏伊士=地区国家城市}	语言
泰尔奇说哪种语言	{泰尔奇=地区国家城市}	语言
撒丁岛说哪种语言	{撒丁岛=地区国家城市}	语言
海兰泡说哪种语言	{海兰泡=地区国家城市}	语言
磅湛说哪种语言	{磅湛=地区国家城市}	语言
费城说哪种语言	{费城=地区国家城市}	语言
巴东说哪种语言	{巴东=地区国家城市}	语言
淡水说哪种语言	{淡水=地区国家城市}	语言
德国说哪种语言	{德国=地区国家城市}	语言
普诺说哪种语言	{普诺=地区国家城市}	语言
蒙达说哪种语言	{蒙达=地区国家城市}	语言
卡梅尔说哪种语言	{卡梅尔=地区国家城市}	语言
彰化说哪种语言	{彰化=地区国家城市}	语言
利物浦说哪种语言	{利物浦=地区国家城市}	语言
拉斯维加斯说哪种语言	{拉斯维加斯=地区国家城市}	语言
奥比都斯说哪种语言	{奥比都斯=地区国家城市}	语言
开罗说哪种语言	{开罗=地区国家城市}	语言
兹沃勒说哪种语言	{兹沃勒=地区国家城市}	语言
伊斯兰堡说哪种语言	{伊斯兰堡=地区国家城市}	语言
乌纳瓦图纳说哪种语言	{乌纳瓦图纳=地区国家城市}	语言
斐济说哪种语言	{斐济=地区国家城市}	语言
夜功府说哪种语言	{夜功府=地区国家城市}	语言
华欣说哪种语言	{华欣=地区国家城市}	语言
摩尔曼斯克说哪种语言	{摩尔曼斯克=地区国家城市}	语言
芭堤雅说哪种语言	{芭堤雅=地区国家城市}	语言
悉尼说哪种语言	{悉尼=地区国家城市}	语言
依云说哪种语言	{依云=地区国家城市}	语言
克拉克说哪种语言	{克拉克=地区国家城市}	语言
西班牙说哪种语言	{西班牙=地区国家城市}	语言
德尔斐说哪种语言	{德尔斐=地区国家城市}	语言
斯里兰卡说哪种语言	{斯里兰卡=地区国家城市}	语言
棉花堡说哪种语言	{棉花堡=地区国家城市}	语言
帕坦说哪种语言	{帕坦=地区国家城市}	语言
捷克布杰约维采说哪种语言	{捷克布杰约维采=地区国家城市}	语言
阿克雷里说哪种语言	{阿克雷里=地区国家城市}	语言
拉斯佩齐亚说哪种语言	{拉斯佩齐亚=地区国家城市}	语言
苏黎世说哪种语言	{苏黎世=地区国家城市}	语言
卡普里岛说哪种语言	{卡普里岛=地区国家城市}	语言
博卡拉说哪种语言	{博卡拉=地区国家城市}	语言
米茨佩拉蒙说哪种语言	{米茨佩拉蒙=地区国家城市}	语言
瓦尼莫说哪种语言	{瓦尼莫=地区国家城市}	语言
苗栗说哪种语言	{苗栗=地区国家城市}	语言
尔湾说哪种语言	{尔湾=地区国家城市}	语言
博洛尼亚说哪种语言	{博洛尼亚=地区国家城市}	语言
吉马良斯说哪种语言	{吉马良斯=地区国家城市}	语言
拉斯海马说哪种语言	{拉斯海马=地区国家城市}	语言
台东说哪种语言	{台东=地区国家城市}	语言
釜山说哪种语言	{釜山=地区国家城市}	语言
蓝梦岛说哪种语言	{蓝梦岛=地区国家城市}	语言
达沃说哪种语言	{达沃=地区国家城市}	语言
克拉根福说哪种语言	{克拉根福=地区国家城市}	语言
水原说哪种语言	{水原=地区国家城市}	语言
加德满都说哪种语言	{加德满都=地区国家城市}	语言
珀斯说哪种语言	{珀斯=地区国家城市}	语言
蒙特勒说哪种语言	{蒙特勒=地区国家城市}	语言
班贝格说哪种语言	{班贝格=地区国家城市}	语言
圣安娜说哪种语言	{圣安娜=地区国家城市}	语言
新不列颠岛说哪种语言	{新不列颠岛=地区国家城市}	语言
赫达说哪种语言	{赫达=地区国家城市}	语言
仁川说哪种语言	{仁川=地区国家城市}	语言
大叻说哪种语言	{大叻=地区国家城市}	语言
济州岛说哪种语言	{济州岛=地区国家城市}	语言
潘切市说哪种语言	{潘切市=地区国家城市}	语言
诺丁汉说哪种语言	{诺丁汉=地区国家城市}	语言
木浦市说哪种语言	{木浦市=地区国家城市}	语言
沙夫豪森说哪种语言	{沙夫豪森=地区国家城市}	语言
特隆赫姆说哪种语言	{特隆赫姆=地区国家城市}	语言
巴格达说哪种语言	{巴格达=地区国家城市}	语言
斯特拉斯堡说哪种语言	{斯特拉斯堡=地区国家城市}	语言
蒂阿瑙说哪种语言	{蒂阿瑙=地区国家城市}	语言
亚洲说哪种语言	{亚洲=地区国家城市}	语言
菲律宾说哪种语言	{菲律宾=地区国家城市}	语言
阿努拉德普勒说哪种语言	{阿努拉德普勒=地区国家城市}	语言
埃尔卡拉法特说哪种语言	{埃尔卡拉法特=地区国家城市}	语言
布雷说哪种语言	{布雷=地区国家城市}	语言
沙湾拿吉说哪种语言	{沙湾拿吉=地区国家城市}	语言
埃兹说哪种语言	{埃兹=地区国家城市}	语言
纽卡斯尔说哪种语言	{纽卡斯尔=地区国家城市}	语言
新潟说哪种语言	{新潟=地区国家城市}	语言
卢塞恩说哪种语言	{卢塞恩=地区国家城市}	语言
爱丁堡说哪种语言	{爱丁堡=地区国家城市}	语言
马当说哪种语言	{马当=地区国家城市}	语言
春武里府说哪种语言	{春武里府=地区国家城市}	语言
毛里求斯说哪种语言	{毛里求斯=地区国家城市}	语言
奥斯陆说哪种语言	{奥斯陆=地区国家城市}	语言
蒙特雷说哪种语言	{蒙特雷=地区国家城市}	语言
海牙说哪种语言	{海牙=地区国家城市}	语言
晋州市说哪种语言	{晋州市=地区国家城市}	语言
法尤姆说哪种语言	{法尤姆=地区国家城市}	语言
凯库拉说哪种语言	{凯库拉=地区国家城市}	语言
巴塞罗那说哪种语言	{巴塞罗那=地区国家城市}	语言
五渔村说哪种语言	{五渔村=地区国家城市}	语言
富川人讲什么话	{富川=地区国家城市}	语言
南安普顿人讲什么话	{南安普顿=地区国家城市}	语言
南非人讲什么话	{南非=地区国家城市}	语言
夜功府人讲什么话	{夜功府=地区国家城市}	语言
马拉加人讲什么话	{马拉加=地区国家城市}	语言
欧洲人讲什么话	{欧洲=地区国家城市}	语言
南迪人讲什么话	{南迪=地区国家城市}	语言
开普敦人讲什么话	{开普敦=地区国家城市}	语言
新北人讲什么话	{新北=地区国家城市}	语言
贝尔谢巴人讲什么话	{贝尔谢巴=地区国家城市}	语言
马来西亚人讲什么话	{马来西亚=地区国家城市}	语言
台北人讲什么话	{台北=地区国家城市}	语言
马尔多纳多港人讲什么话	{马尔多纳多港=地区国家城市}	语言
内比都人讲什么话	{内比都=地区国家城市}	语言
格雷梅人讲什么话	{格雷梅=地区国家城市}	语言
谢菲尔德人讲什么话	{谢菲尔德=地区国家城市}	语言
洛桑人讲什么话	{洛桑=地区国家城市}	语言
内罗毕人讲什么话	{内罗毕=地区国家城市}	语言
兰卡威人讲什么话	{兰卡威=地区国家城市}	语言
吉隆坡人讲什么话	{吉隆坡=地区国家城市}	语言
北碧府人讲什么话	{北碧府=地区国家城市}	语言
大田人讲什么话	{大田=地区国家城市}	语言
帕劳人讲什么话	{帕劳=地区国家城市}	语言
加勒人讲什么话	{加勒=地区国家城市}	语言
根特人讲什么话	{根特=地区国家城市}	语言
伊尔库茨克人讲什么话	{伊尔库茨克=地区国家城市}	语言
达尔文人讲什么话	{达尔文=地区国家城市}	语言
暹粒人讲什么话	{暹粒=地区国家城市}	语言
特鲁希略人讲什么话	{特鲁希略=地区国家城市}	语言
维也纳人讲什么话	{维也纳=地区国家城市}	语言
列日人讲什么话	{列日=地区国家城市}	语言
熊本人讲什么话	{熊本=地区国家城市}	语言
阿维尼翁人讲什么话	{阿维尼翁=地区国家城市}	语言
普那卡人讲什么话	{普那卡=地区国家城市}	语言
贝特谢安人讲什么话	{贝特谢安=地区国家城市}	语言
伊朗人讲什么话	{伊朗=地区国家城市}	语言
城南市人讲什么话	{城南市=地区国家城市}	语言
丹布勒人讲什么话	{丹布勒=地区国家城市}	语言
全州人讲什么话	{全州=地区国家城市}	语言
惠灵顿人讲什么话	{惠灵顿=地区国家城市}	语言
阿威罗人讲什么话	{阿威罗=地区国家城市}	语言
罗托鲁瓦人讲什么话	{罗托鲁瓦=地区国家城市}	语言
马尔默人讲什么话	{马尔默=地区国家城市}	语言
丁格尔人讲什么话	{丁格尔=地区国家城市}	语言
米湖人讲什么话	{米湖=地区国家城市}	语言
库尔纳人讲什么话	{库尔纳=地区国家城市}	语言
圣安德烈人讲什么话	{圣安德烈=地区国家城市}	语言
卢塞恩人讲什么话	{卢塞恩=地区国家城市}	语言
马德望人讲什么话	{马德望=地区国家城市}	语言
马德里人讲什么话	{马德里=地区国家城市}	语言
胡萨维克人讲什么话	{胡萨维克=地区国家城市}	语言
英国湖区人讲什么话	{英国湖区=地区国家城市}	语言
汉诺威人讲什么话	{汉诺威=地区国家城市}	语言
斯帕人讲什么话	{斯帕=地区国家城市}	语言
姬路人讲什么话	{姬路=地区国家城市}	语言
古晋人讲什么话	{古晋=地区国家城市}	语言
卡法亚特人讲什么话	{卡法亚特=地区国家城市}	语言
马尔代夫人讲什么话	{马尔代夫=地区国家城市}	语言
沃斯人讲什么话	{沃斯=地区国家城市}	语言
沙特人讲什么话	{沙特=地区国家城市}	语言
荷兰人讲什么话	{荷兰=地区国家城市}	语言
圣克拉拉人讲什么话	{圣克拉拉=地区国家城市}	语言
新加坡人讲什么话	{新加坡=地区国家城市}	语言
拿骚人讲什么话	{拿骚=地区国家城市}	语言
波贝人讲什么话	{波贝=地区国家城市}	语言
乌鲁班巴人讲什么话	{乌鲁班巴=地区国家城市}	语言
塔巴人讲什么话	{塔巴=地区国家城市}	语言
赖扬人讲什么话	{赖扬=地区国家城市}	语言
琅南塔人讲什么话	{琅南塔=地区国家城市}	语言
墨尔本人讲什么话	{墨尔本=地区国家城市}	语言
布鲁塞尔人讲什么话	{布鲁塞尔=地区国家城市}	语言
高威人讲什么话	{高威=地区国家城市}	语言
仰光人讲什么话	{仰光=地区国家城市}	语言
万隆人讲什么话	{万隆=地区国家城市}	语言
杰尔人讲什么话	{杰尔=地区国家城市}	语言
华富里人讲什么话	{华富里=地区国家城市}	语言
苗栗人讲什么话	{苗栗=地区国家城市}	语言
温莎市人讲什么话	{温莎市=地区国家城市}	语言
道格拉斯港人讲什么话	{道格拉斯港=地区国家城市}	语言
科尔多瓦人讲什么话	{科尔多瓦=地区国家城市}	语言
厄吕代尼兹人讲什么话	{厄吕代尼兹=地区国家城市}	语言
帕岸岛人讲什么话	{帕岸岛=地区国家城市}	语言
碧瑶人讲什么话	{碧瑶=地区国家城市}	语言
马斯帕洛马斯人讲什么话	{马斯帕洛马斯=地区国家城市}	语言
热浪岛人讲什么话	{热浪岛=地区国家城市}	语言
利马人讲什么话	{利马=地区国家城市}	语言
奥比都斯人讲什么话	{奥比都斯=地区国家城市}	语言
菲律宾人讲什么话	{菲律宾=地区国家城市}	语言
安东人讲什么话	{安东=地区国家城市}	语言
龙目岛人讲什么话	{龙目岛=地区国家城市}	语言
拉斯海马人讲什么话	{拉斯海马=地区国家城市}	语言
阿雷基帕人讲什么话	{阿雷基帕=地区国家城市}	语言
阿尔科巴萨人讲什么话	{阿尔科巴萨=地区国家城市}	语言
贝尼多姆人讲什么话	{贝尼多姆=地区国家城市}	语言
基督城人讲什么话	{基督城=地区国家城市}	语言
贝尔马尔人讲什么话	{贝尔马尔=地区国家城市}	语言
美奈人讲什么话	{美奈=地区国家城市}	语言
罗什平纳人讲什么话	{罗什平纳=地区国家城市}	语言
设拉子人讲什么话	{设拉子=地区国家城市}	语言
莱顿人讲什么话	{莱顿=地区国家城市}	语言
金斯顿人说什么话	{金斯顿=地区国家城市}	语言
托考伊人说什么话	{托考伊=地区国家城市}	语言
谢尔盖耶夫人说什么话	{谢尔盖耶夫=地区国家城市}	语言
佩雷拉人说什么话	{佩雷拉=地区国家城市}	语言
塔拉戈纳人说什么话	{塔拉戈纳=地区国家城市}	语言
关岛人说什么话	{关岛=地区国家城市}	语言
雅加达人说什么话	{雅加达=地区国家城市}	语言
莱蒂西亚人说什么话	{莱蒂西亚=地区国家城市}	语言
蒙特雷人说什么话	{蒙特雷=地区国家城市}	语言
巴斯人说什么话	{巴斯=地区国家城市}	语言
埃格尔人说什么话	{埃格尔=地区国家城市}	语言
库斯科人说什么话	{库斯科=地区国家城市}	语言
尼甘布人说什么话	{尼甘布=地区国家城市}	语言
乌纳瓦图纳人说什么话	{乌纳瓦图纳=地区国家城市}	语言
纳哈里亚人说什么话	{纳哈里亚=地区国家城市}	语言
安塔利亚人说什么话	{安塔利亚=地区国家城市}	语言
普诺人说什么话	{普诺=地区国家城市}	语言
锡尔赫特人说什么话	{锡尔赫特=地区国家城市}	语言
威克洛郡人说什么话	{威克洛郡=地区国家城市}	语言
芽庄人说什么话	{芽庄=地区国家城市}	语言
莱比锡人说什么话	{莱比锡=地区国家城市}	语言
普吉岛人说什么话	{普吉岛=地区国家城市}	语言
富川人说什么话	{富川=地区国家城市}	语言
阿卡人说什么话	{阿卡=地区国家城市}	语言
香港人说什么话	{香港=地区国家城市}	语言
阿尔布费拉人说什么话	{阿尔布费拉=地区国家城市}	语言
约翰内斯堡人说什么话	{约翰内斯堡=地区国家城市}	语言
霍基蒂卡人说什么话	{霍基蒂卡=地区国家城市}	语言
大田人说什么话	{大田=地区国家城市}	语言
尼斯人说什么话	{尼斯=地区国家城市}	语言
米湖人说什么话	{米湖=地区国家城市}	语言
水原人说什么话	{水原=地区国家城市}	语言
达尔文人说什么话	{达尔文=地区国家城市}	语言
赞丹人说什么话	{赞丹=地区国家城市}	语言
艾恩人说什么话	{艾恩=地区国家城市}	语言
伊斯梅利亚人说什么话	{伊斯梅利亚=地区国家城市}	语言
坦加勒人说什么话	{坦加勒=地区国家城市}	语言
卡尔加里人说什么话	{卡尔加里=地区国家城市}	语言
西西里岛人说什么话	{西西里岛=地区国家城市}	语言
美奈人说什么话	{美奈=地区国家城市}	语言
古晋人说什么话	{古晋=地区国家城市}	语言
佛罗伦萨人说什么话	{佛罗伦萨=地区国家城市}	语言
木尔坦人说什么话	{木尔坦=地区国家城市}	语言
卡梅尔人说什么话	{卡梅尔=地区国家城市}	语言
兰卡威人说什么话	{兰卡威=地区国家城市}	语言
波尔图人说什么话	{波尔图=地区国家城市}	语言
鹿特丹人说什么话	{鹿特丹=地区国家城市}	语言
帕萨迪纳人说什么话	{帕萨迪纳=地区国家城市}	语言
亚历山大人说什么话	{亚历山大=地区国家城市}	语言
堪培拉人说什么话	{堪培拉=地区国家城市}	语言
匈牙利人说什么话	{匈牙利=地区国家城市}	语言
玛丽亚温泉市人说什么话	{玛丽亚温泉市=地区国家城市}	语言
尔湾人说什么话	{尔湾=地区国家城市}	语言
宜兰人说什么话	{宜兰=地区国家城市}	语言
海参崴人说什么话	{海参崴=地区国家城市}	语言
那霸人说什么话	{那霸=地区国家城市}	语言
大阪人说什么话	{大阪=地区国家城市}	语言
科隆人说什么话	{科隆=地区国家城市}	语言
纳帕人说什么话	{纳帕=地区国家城市}	语言
芭堤雅人说什么话	{芭堤雅=地区国家城市}	语言
马贝拉人说什么话	{马贝拉=地区国家城市}	语言
奥地利人说什么话	{奥地利=地区国家城市}	语言
帕坦人说什么话	{帕坦=地区国家城市}	语言
卢塞恩人说什么话	{卢塞恩=地区国家城市}	语言
意大利人说什么话	{意大利=地区国家城市}	语言
努韦巴人说什么话	{努韦巴=地区国家城市}	语言
库什蒂亚人说什么话	{库什蒂亚=地区国家城市}	语言
罗什平纳人说什么话	{罗什平纳=地区国家城市}	语言
栋索尔人说什么话	{栋索尔=地区国家城市}	语言
毛里求斯人说什么话	{毛里求斯=地区国家城市}	语言
德累斯顿人说什么话	{德累斯顿=地区国家城市}	语言
胡阿希内岛人说什么话	{胡阿希内岛=地区国家城市}	语言
班多尔班人说什么话	{班多尔班=地区国家城市}	语言
高山人说什么话	{高山=地区国家城市}	语言
不莱梅人说什么话	{不莱梅=地区国家城市}	语言
卧龙岗人说什么话	{卧龙岗=地区国家城市}	语言
乌姆盖万人说什么话	{乌姆盖万=地区国家城市}	语言
奥比都斯人说什么话	{奥比都斯=地区国家城市}	语言
加的斯人说什么话	{加的斯=地区国家城市}	语言
卢克索人说什么话	{卢克索=地区国家城市}	语言
美国人说什么话	{美国=地区国家城市}	语言
格罗宁根人说什么话	{格罗宁根=地区国家城市}	语言
法蒂玛人说什么话	{法蒂玛=地区国家城市}	语言
圣卡洛斯-德巴里洛切人说什么话	{圣卡洛斯-德巴里洛切=地区国家城市}	语言
比萨人说什么话	{比萨=地区国家城市}	语言
民丹岛人说什么话	{民丹岛=地区国家城市}	语言
斯里兰卡人说什么话	{斯里兰卡=地区国家城市}	语言
邦劳人说什么话	{邦劳=地区国家城市}	语言
基尔根尼人说什么话	{基尔根尼=地区国家城市}	语言
普罗旺斯人说什么话	{普罗旺斯=地区国家城市}	语言
西奈山人说什么话	{西奈山=地区国家城市}	语言
都柏林人说什么话	{都柏林=地区国家城市}	语言
斗湖人说什么话	{斗湖=地区国家城市}	语言
美因茨人说什么话	{美因茨=地区国家城市}	语言
那慕尔人说什么话	{那慕尔=地区国家城市}	语言
姬路人说什么话	{姬路=地区国家城市}	语言
春武里府人说什么话	{春武里府=地区国家城市}	语言
伊兹密尔人说什么话	{伊兹密尔=地区国家城市}	语言
迪拜人说什么话	{迪拜=地区国家城市}	语言
斯塔万格人说什么话	{斯塔万格=地区国家城市}	语言
新竹人使用什么语言	{新竹=地区国家城市}	语言
马来西亚人使用什么语言	{马来西亚=地区国家城市}	语言
马当人使用什么语言	{马当=地区国家城市}	语言
琅多人使用什么语言	{琅多=地区国家城市}	语言
拉杰沙希人使用什么语言	{拉杰沙希=地区国家城市}	语言
丹老人使用什么语言	{丹老=地区国家城市}	语言
越南人使用什么语言	{越南=地区国家城市}	语言
帕罗人使用什么语言	{帕罗=地区国家城市}	语言
道格拉斯港人使用什么语言	{道格拉斯港=地区国家城市}	语言
罗马人使用什么语言	{罗马=地区国家城市}	语言
新不列颠岛人使用什么语言	{新不列颠岛=地区国家城市}	语言
基洛纳人使用什么语言	{基洛纳=地区国家城市}	语言
浦项市人使用什么语言	{浦项市=地区国家城市}	语言
纳克索斯人使用什么语言	{纳克索斯=地区国家城市}	语言
圣吉尔根人使用什么语言	{圣吉尔根=地区国家城市}	语言
里约热内卢人使用什么语言	{里约热内卢=地区国家城市}	语言
萨克拉门托人使用什么语言	{萨克拉门托=地区国家城市}	语言
圣地亚哥-德孔波斯特拉人使用什么语言	{圣地亚哥-德孔波斯特拉=地区国家城市}	语言
斯卡恩人使用什么语言	{斯卡恩=地区国家城市}	语言
大溪地人使用什么语言	{大溪地=地区国家城市}	语言
杜马盖地人使用什么语言	{杜马盖地=地区国家城市}	语言
卢克索人使用什么语言	{卢克索=地区国家城市}	语言
南非人使用什么语言	{南非=地区国家城市}	语言
大不里士人使用什么语言	{大不里士=地区国家城市}	语言
丁格尔人使用什么语言	{丁格尔=地区国家城市}	语言
布莱顿人使用什么语言	{布莱顿=地区国家城市}	语言
花莲人使用什么语言	{花莲=地区国家城市}	语言
厄尔查尔坦人使用什么语言	{厄尔查尔坦=地区国家城市}	语言
伯克利人使用什么语言	{伯克利=地区国家城市}	语言
都灵人使用什么语言	{都灵=地区国家城市}	语言
塔拉戈纳人使用什么语言	{塔拉戈纳=地区国家城市}	语言
纳帕人使用什么语言	{纳帕=地区国家城市}	语言
克里斯蒂安桑人使用什么语言	{克里斯蒂安桑=地区国家城市}	语言
费城人使用什么语言	{费城=地区国家城市}	语言
芬兰人使用什么语言	{芬兰=地区国家城市}	语言
俄斯特拉发人使用什么语言	{俄斯特拉发=地区国家城市}	语言
德国人使用什么语言	{德国=地区国家城市}	语言
日内瓦人使用什么语言	{日内瓦=地区国家城市}	语言
比隆人使用什么语言	{比隆=地区国家城市}	语言
海德堡人使用什么语言	{海德堡=地区国家城市}	语言
达沃斯人使用什么语言	{达沃斯=地区国家城市}	语言
扎金索斯人使用什么语言	{扎金索斯=地区国家城市}	语言
乌得勒支人使用什么语言	{乌得勒支=地区国家城市}	语言
莫尔斯比港人使用什么语言	{莫尔斯比港=地区国家城市}	语言
布鲁日人使用什么语言	{布鲁日=地区国家城市}	语言
箱根人使用什么语言	{箱根=地区国家城市}	语言
乌普萨拉人使用什么语言	{乌普萨拉=地区国家城市}	语言
马德里人使用什么语言	{马德里=地区国家城市}	语言
匈牙利人使用什么语言	{匈牙利=地区国家城市}	语言
韩国人使用什么语言	{韩国=地区国家城市}	语言
恩格尔贝格人使用什么语言	{恩格尔贝格=地区国家城市}	语言
诺丁汉人使用什么语言	{诺丁汉=地区国家城市}	语言
米茨佩拉蒙人使用什么语言	{米茨佩拉蒙=地区国家城市}	语言
瓦伦西亚人使用什么语言	{瓦伦西亚=地区国家城市}	语言
巴拉顿菲赖德人使用什么语言	{巴拉顿菲赖德=地区国家城市}	语言
维也纳人使用什么语言	{维也纳=地区国家城市}	语言
以色列人使用什么语言	{以色列=地区国家城市}	语言
西西里岛人使用什么语言	{西西里岛=地区国家城市}	语言
拉瓦格人使用什么语言	{拉瓦格=地区国家城市}	语言
胡志明市人使用什么语言	{胡志明市=地区国家城市}	语言
柏威夏人使用什么语言	{柏威夏=地区国家城市}	语言
眉谬人使用什么语言	{眉谬=地区国家城市}	语言
磅湛人使用什么语言	{磅湛=地区国家城市}	语言
新西伯利亚人使用什么语言	{新西伯利亚=地区国家城市}	语言
雅加达人使用什么语言	{雅加达=地区国家城市}	语言
加的斯人使用什么语言	{加的斯=地区国家城市}	语言
圣塔芭芭拉人使用什么语言	{圣塔芭芭拉=地区国家城市}	语言
马尔多纳多港人使用什么语言	{马尔多纳多港=地区国家城市}	语言
哈尔施塔特人使用什么语言	{哈尔施塔特=地区国家城市}	语言
佩雷拉人使用什么语言	{佩雷拉=地区国家城市}	语言
塔维拉人使用什么语言	{塔维拉=地区国家城市}	语言
瓜拉登嘉楼人使用什么语言	{瓜拉登嘉楼=地区国家城市}	语言
贝希特斯加登人使用什么语言	{贝希特斯加登=地区国家城市}	语言
大叻人使用什么语言	{大叻=地区国家城市}	语言
尼姆人使用什么语言	{尼姆=地区国家城市}	语言
萨斯卡通人使用什么语言	{萨斯卡通=地区国家城市}	语言
华富里人使用什么语言	{华富里=地区国家城市}	语言
希拉人使用什么语言	{希拉=地区国家城市}	语言
劳特布龙嫩人使用什么语言	{劳特布龙嫩=地区国家城市}	语言
玛瑙斯市人使用什么语言	{玛瑙斯市=地区国家城市}	语言
台东人使用什么语言	{台东=地区国家城市}	语言
广岛人使用什么语言	{广岛=地区国家城市}	语言
巴基斯坦人使用什么语言	{巴基斯坦=地区国家城市}	语言
图卢兹人使用什么语言	{图卢兹=地区国家城市}	语言
瑞典人使用什么语言	{瑞典=地区国家城市}	语言
柏林人使用什么语言	{柏林=地区国家城市}	语言
原州市人使用什么语言	{原州市=地区国家城市}	语言
阿根廷人使用什么语言	{阿根廷=地区国家城市}	语言
拉姆拉人使用什么语言	{拉姆拉=地区国家城市}	语言
卢戈人使用什么语言	{卢戈=地区国家城市}	语言
珀斯人使用什么语言	{珀斯=地区国家城市}	语言
蒙特利尔人使用什么语言	{蒙特利尔=地区国家城市}	语言
澳门人使用什么语言	{澳门=地区国家城市}	语言
北京人使用什么语言	{北京=地区国家城市}	语言
伊斯坦布尔人使用什么语言	{伊斯坦布尔=地区国家城市}	语言
金泽人使用什么语言	{金泽=地区国家城市}	语言
科克人使用什么语言	{科克=地区国家城市}	语言
万象人使用什么语言	{万象=地区国家城市}	语言
赫尔辛格人使用什么语言	{赫尔辛格=地区国家城市}	语言
台南人使用什么语言	{台南=地区国家城市}	语言
在卡斯凯什什么语言通用	{卡斯凯什=地区国家城市}	语言
在格拉斯什么语言通用	{格拉斯=地区国家城市}	语言
在阿利坎特什么语言通用	{阿利坎特=地区国家城市}	语言
在施拉德明什么语言通用	{施拉德明=地区国家城市}	语言
在利兹什么语言通用	{利兹=地区国家城市}	语言
在南美什么语言通用	{南美=地区国家城市}	语言
在岘港什么语言通用	{岘港=地区国家城市}	语言
在艾图塔基什么语言通用	{艾图塔基=地区国家城市}	语言
在凯库拉什么语言通用	{凯库拉=地区国家城市}	语言
在纳塔尔什么语言通用	{纳塔尔=地区国家城市}	语言
在丹布勒什么语言通用	{丹布勒=地区国家城市}	语言
在罗什平纳什么语言通用	{罗什平纳=地区国家城市}	语言
在马当什么语言通用	{马当=地区国家城市}	语言
在利默里克什么语言通用	{利默里克=地区国家城市}	语言
在阿雷基帕什么语言通用	{阿雷基帕=地区国家城市}	语言
在巴西利亚什么语言通用	{巴西利亚=地区国家城市}	语言
在胡志明市什么语言通用	{胡志明市=地区国家城市}	语言
在帕萨迪纳什么语言通用	{帕萨迪纳=地区国家城市}	语言
在沙迦什么语言通用	{沙迦=地区国家城市}	语言
在纳哈里亚什么语言通用	{纳哈里亚=地区国家城市}	语言
在图尔奈什么语言通用	{图尔奈=地区国家城市}	语言
在大分什么语言通用	{大分=地区国家城市}	语言
在乌普萨拉什么语言通用	{乌普萨拉=地区国家城市}	语言
在海宁什么语言通用	{海宁=地区国家城市}	语言
在捷克什么语言通用	{捷克=地区国家城市}	语言
在亚洲什么语言通用	{亚洲=地区国家城市}	语言
在休伊什么语言通用	{休伊=地区国家城市}	语言
在南极半岛什么语言通用	{南极半岛=地区国家城市}	语言
在马贝拉什么语言通用	{马贝拉=地区国家城市}	语言
在安卡拉什么语言通用	{安卡拉=地区国家城市}	语言
在莱比锡什么语言通用	{莱比锡=地区国家城市}	语言
在沙姆沙伊赫什么语言通用	{沙姆沙伊赫=地区国家城市}	语言
在龙仁市什么语言通用	{龙仁市=地区国家城市}	语言
在恩纳什么语言通用	{恩纳=地区国家城市}	语言
在采尔马特什么语言通用	{采尔马特=地区国家城市}	语言
在达沃斯什么语言通用	{达沃斯=地区国家城市}	语言
在伏尔加格勒什么语言通用	{伏尔加格勒=地区国家城市}	语言
在隆德什么语言通用	{隆德=地区国家城市}	语言
在吴哥窟什么语言通用	{吴哥窟=地区国家城市}	语言
在土耳其什么语言通用	{土耳其=地区国家城市}	语言
在威尼斯什么语言通用	{威尼斯=地区国家城市}	语言
在布达佩斯什么语言通用	{布达佩斯=地区国家城市}	语言
在波茨坦什么语言通用	{波茨坦=地区国家城市}	语言
在沃斯什么语言通用	{沃斯=地区国家城市}	语言
在埃因霍温什么语言通用	{埃因霍温=地区国家城市}	语言
在薄荷岛什么语言通用	{薄荷岛=地区国家城市}	语言
在彭措林什么语言通用	{彭措林=地区国家城市}	语言
在中国什么语言通用	{中国=地区国家城市}	语言
在罗瓦涅米什么语言通用	{罗瓦涅米=地区国家城市}	语言
在巴东什么语言通用	{巴东=地区国家城市}	语言
在费特希耶什么语言通用	{费特希耶=地区国家城市}	语言
在苏兹达尔什么语言通用	{苏兹达尔=地区国家城市}	语言
在博拉博拉岛什么语言通用	{博拉博拉岛=地区国家城市}	语言
在波隆纳鲁沃什么语言通用	{波隆纳鲁沃=地区国家城市}	语言
在挪威什么语言通用	{挪威=地区国家城市}	语言
在塞得港什么语言通用	{塞得港=地区国家城市}	语言
在奥胡斯什么语言通用	{奥胡斯=地区国家城市}	语言
在胡阿希内岛什么语言通用	{胡阿希内岛=地区国家城市}	语言
在阿雷格里港什么语言通用	{阿雷格里港=地区国家城市}	语言
在伯克利什么语言通用	{伯克利=地区国家城市}	语言
在鲁西永什么语言通用	{鲁西永=地区国家城市}	语言
在华富里什么语言通用	{华富里=地区国家城市}	语言
在库斯科什么语言通用	{库斯科=地区国家城市}	语言
在厄吕代尼兹什么语言通用	{厄吕代尼兹=地区国家城市}	语言
在埼玉什么语言通用	{埼玉=地区国家城市}	语言
在帕斯托什么语言通用	{帕斯托=地区国家城市}	语言
在马斯帕洛马斯什么语言通用	{马斯帕洛马斯=地区国家城市}	语言
在利马什么语言通用	{利马=地区国家城市}	语言
在关岛什么语言通用	{关岛=地区国家城市}	语言
在贝尔法斯特什么语言通用	{贝尔法斯特=地区国家城市}	语言
在巴西什么语言通用	{巴西=地区国家城市}	语言
在蓬特雷西纳什么语言通用	{蓬特雷西纳=地区国家城市}	语言
在槟城什么语言通用	{槟城=地区国家城市}	语言
在布拉加什么语言通用	{布拉加=地区国家城市}	语言
在文根什么语言通用	{文根=地区国家城市}	语言
在木浦市什么语言通用	{木浦市=地区国家城市}	语言
在霍巴特什么语言通用	{霍巴特=地区国家城市}	语言
在马德里什么语言通用	{马德里=地区国家城市}	语言
在多特蒙德什么语言通用	{多特蒙德=地区国家城市}	语言
在长滩岛什么语言通用	{长滩岛=地区国家城市}	语言
在卡普里岛什么语言通用	{卡普里岛=地区国家城市}	语言
在台东什么语言通用	{台东=地区国家城市}	语言
在凯奇凯梅特什么语言通用	{凯奇凯梅特=地区国家城市}	语言
在以色列什么语言通用	{以色列=地区国家城市}	语言
在普纳奥亚什么语言通用	{普纳奥亚=地区国家城市}	语言
在埃伊尔斯塔济什么语言通用	{埃伊尔斯塔济=地区国家城市}	语言
在达哈卜什么语言通用	{达哈卜=地区国家城市}	语言
在莫尔斯比港什么语言通用	{莫尔斯比港=地区国家城市}	语言
在戈公什么语言通用	{戈公=地区国家城市}	语言
在浦项市什么语言通用	{浦项市=地区国家城市}	语言
在春川什么语言通用	{春川=地区国家城市}	语言
在蓝毗尼什么语言通用	{蓝毗尼=地区国家城市}	语言
在阿根廷什么语言通用	{阿根廷=地区国家城市}	语言
在卡尔加里什么语言通用	{卡尔加里=地区国家城市}	语言
在悉尼什么语言通用	{悉尼=地区国家城市}	语言
在吉大港什么语言通用	{吉大港=地区国家城市}	语言
在熊本什么语言通用	{熊本=地区国家城市}	语言
在哈尔施塔特什么语言通用	{哈尔施塔特=地区国家城市}	语言
在圣马洛什么语言通用	{圣马洛=地区国家城市}	语言
在林雪平什么语言通用	{林雪平=地区国家城市}	语言
维罗纳普遍使用什么语言	{维罗纳=地区国家城市}	语言
圣卡洛斯-德巴里洛切普遍使用什么语言	{圣卡洛斯-德巴里洛切=地区国家城市}	语言
金边普遍使用什么语言	{金边=地区国家城市}	语言
罗弗敦群岛普遍使用什么语言	{罗弗敦群岛=地区国家城市}	语言
富良野普遍使用什么语言	{富良野=地区国家城市}	语言
塔哈岛普遍使用什么语言	{塔哈岛=地区国家城市}	语言
花莲普遍使用什么语言	{花莲=地区国家城市}	语言
图尔奈普遍使用什么语言	{图尔奈=地区国家城市}	语言
济州岛普遍使用什么语言	{济州岛=地区国家城市}	语言
匈牙利普遍使用什么语言	{匈牙利=地区国家城市}	语言
阿里山普遍使用什么语言	{阿里山=地区国家城市}	语言
科伦坡普遍使用什么语言	{科伦坡=地区国家城市}	语言
黑维兹普遍使用什么语言	{黑维兹=地区国家城市}	语言
蓝梦岛普遍使用什么语言	{蓝梦岛=地区国家城市}	语言
斯德哥尔摩普遍使用什么语言	{斯德哥尔摩=地区国家城市}	语言
希腊普遍使用什么语言	{希腊=地区国家城市}	语言
恩格尔贝格普遍使用什么语言	{恩格尔贝格=地区国家城市}	语言
基洛夫普遍使用什么语言	{基洛夫=地区国家城市}	语言
罗勇普遍使用什么语言	{罗勇=地区国家城市}	语言
丰沙尔普遍使用什么语言	{丰沙尔=地区国家城市}	语言
东南亚普遍使用什么语言	{东南亚=地区国家城市}	语言
登别普遍使用什么语言	{登别=地区国家城市}	语言
阿罗萨普遍使用什么语言	{阿罗萨=地区国家城市}	语言
温尼伯普遍使用什么语言	{温尼伯=地区国家城市}	语言
温特图尔普遍使用什么语言	{温特图尔=地区国家城市}	语言
和歌山普遍使用什么语言	{和歌山=地区国家城市}	语言
科克斯巴扎尔普遍使用什么语言	{科克斯巴扎尔=地区国家城市}	语言
蒙特利尔普遍使用什么语言	{蒙特利尔=地区国家城市}	语言
弗莱堡普遍使用什么语言	{弗莱堡=地区国家城市}	语言
圣保罗普遍使用什么语言	{圣保罗=地区国家城市}	语言
新西伯利亚普遍使用什么语言	{新西伯利亚=地区国家城市}	语言
因斯布鲁克普遍使用什么语言	{因斯布鲁克=地区国家城市}	语言
槟城普遍使用什么语言	{槟城=地区国家城市}	语言
班贝格普遍使用什么语言	{班贝格=地区国家城市}	语言
函馆普遍使用什么语言	{函馆=地区国家城市}	语言
阿努拉德普勒普遍使用什么语言	{阿努拉德普勒=地区国家城市}	语言
帕皮提普遍使用什么语言	{帕皮提=地区国家城市}	语言
坡州普遍使用什么语言	{坡州=地区国家城市}	语言
阿纳海姆普遍使用什么语言	{阿纳海姆=地区国家城市}	语言
河内普遍使用什么语言	{河内=地区国家城市}	语言
伊瓜苏市普遍使用什么语言	{伊瓜苏市=地区国家城市}	语言
朗塞斯顿普遍使用什么语言	{朗塞斯顿=地区国家城市}	语言
皮皮岛普遍使用什么语言	{皮皮岛=地区国家城市}	语言
伯明翰普遍使用什么语言	{伯明翰=地区国家城市}	语言
澳门普遍使用什么语言	{澳门=地区国家城市}	语言
凡尔赛普遍使用什么语言	{凡尔赛=地区国家城市}	语言
卡梅尔普遍使用什么语言	{卡梅尔=地区国家城市}	语言
芒特哈根普遍使用什么语言	{芒特哈根=地区国家城市}	语言
巴厘巴板普遍使用什么语言	{巴厘巴板=地区国家城市}	语言
贝克斯菲尔德普遍使用什么语言	{贝克斯菲尔德=地区国家城市}	语言
棕榈泉普遍使用什么语言	{棕榈泉=地区国家城市}	语言
会晒普遍使用什么语言	{会晒=地区国家城市}	语言
宜兰普遍使用什么语言	{宜兰=地区国家城市}	语言
伦敦普遍使用什么语言	{伦敦=地区国家城市}	语言
美瑛普遍使用什么语言	{美瑛=地区国家城市}	语言
马德望普遍使用什么语言	{马德望=地区国家城市}	语言
垦丁普遍使用什么语言	{垦丁=地区国家城市}	语言
华盛顿普遍使用什么语言	{华盛顿=地区国家城市}	语言
布阿苏普遍使用什么语言	{布阿苏=地区国家城市}	语言
汉诺威普遍使用什么语言	{汉诺威=地区国家城市}	语言
惠斯勒普遍使用什么语言	{惠斯勒=地区国家城市}	语言
累西腓普遍使用什么语言	{累西腓=地区国家城市}	语言
巴布亚新几内亚普遍使用什么语言	{巴布亚新几内亚=地区国家城市}	语言
卡尚普遍使用什么语言	{卡尚=地区国家城市}	语言
哥本哈根普遍使用什么语言	{哥本哈根=地区国家城市}	语言
圣吉米尼亚诺普遍使用什么语言	{圣吉米尼亚诺=地区国家城市}	语言
指宿市普遍使用什么语言	{指宿市=地区国家城市}	语言
广岛普遍使用什么语言	{广岛=地区国家城市}	语言
尼泊尔普遍使用什么语言	{尼泊尔=地区国家城市}	语言
金斯顿普遍使用什么语言	{金斯顿=地区国家城市}	语言
日光普遍使用什么语言	{日光=地区国家城市}	语言
本托特普遍使用什么语言	{本托特=地区国家城市}	语言
波恩普遍使用什么语言	{波恩=地区国家城市}	语言
秘鲁普遍使用什么语言	{秘鲁=地区国家城市}	语言
鹿特丹普遍使用什么语言	{鹿特丹=地区国家城市}	语言
爪哇岛普遍使用什么语言	{爪哇岛=地区国家城市}	语言
奥洛穆茨普遍使用什么语言	{奥洛穆茨=地区国家城市}	语言
苗栗普遍使用什么语言	{苗栗=地区国家城市}	语言
内比都普遍使用什么语言	{内比都=地区国家城市}	语言
弗里堡普遍使用什么语言	{弗里堡=地区国家城市}	语言
喀山普遍使用什么语言	{喀山=地区国家城市}	语言
伊斯梅利亚普遍使用什么语言	{伊斯梅利亚=地区国家城市}	语言
薄荷岛普遍使用什么语言	{薄荷岛=地区国家城市}	语言
圣加仑普遍使用什么语言	{圣加仑=地区国家城市}	语言
捷克布杰约维采普遍使用什么语言	{捷克布杰约维采=地区国家城市}	语言
塞维利亚普遍使用什么语言	{塞维利亚=地区国家城市}	语言
蒙特雷普遍使用什么语言	{蒙特雷=地区国家城市}	语言
欧洲普遍使用什么语言	{欧洲=地区国家城市}	语言
吉萨普遍使用什么语言	{吉萨=地区国家城市}	语言
希拉普遍使用什么语言	{希拉=地区国家城市}	语言
西班牙普遍使用什么语言	{西班牙=地区国家城市}	语言
比隆普遍使用什么语言	{比隆=地区国家城市}	语言
沙巴普遍使用什么语言	{沙巴=地区国家城市}	语言
沙姆沙伊赫普遍使用什么语言	{沙姆沙伊赫=地区国家城市}	语言
延雪平普遍使用什么语言	{延雪平=地区国家城市}	语言
奈良普遍使用什么语言	{奈良=地区国家城市}	语言
马尔代夫普遍使用什么语言	{马尔代夫=地区国家城市}	语言
利默里克普遍使用什么语言	{利默里克=地区国家城市}	语言
本迪布尔普遍使用什么语言	{本迪布尔=地区国家城市}	语言
蒂瑟默哈拉默普遍使用什么语言	{蒂瑟默哈拉默=地区国家城市}	语言
在拿撒勒什么语言通用	{拿撒勒=地区国家城市}	语言
在达沃什么语言通用	{达沃=地区国家城市}	语言
在里斯本什么语言通用	{里斯本=地区国家城市}	语言
在卡尔加里什么语言通用	{卡尔加里=地区国家城市}	语言
在吉隆坡什么语言通用	{吉隆坡=地区国家城市}	语言
在库兰达什么语言通用	{库兰达=地区国家城市}	语言
在拉姆拉什么语言通用	{拉姆拉=地区国家城市}	语言
在因特拉肯什么语言通用	{因特拉肯=地区国家城市}	语言
在克里特岛什么语言通用	{克里特岛=地区国家城市}	语言
在不莱梅什么语言通用	{不莱梅=地区国家城市}	语言
在奥洛穆茨什么语言通用	{奥洛穆茨=地区国家城市}	语言
在攀牙什么语言通用	{攀牙=地区国家城市}	语言
在迪拜什么语言通用	{迪拜=地区国家城市}	语言
在米科诺斯岛什么语言通用	{米科诺斯岛=地区国家城市}	语言
在南设得兰群岛什么语言通用	{南设得兰群岛=地区国家城市}	语言
在弗洛姆什么语言通用	{弗洛姆=地区国家城市}	语言
在德黑兰什么语言通用	{德黑兰=地区国家城市}	语言
在塞维利亚什么语言通用	{塞维利亚=地区国家城市}	语言
在魁北克市什么语言通用	{魁北克市=地区国家城市}	语言
在宫古岛什么语言通用	{宫古岛=地区国家城市}	语言
在旭川什么语言通用	{旭川=地区国家城市}	语言
在弗拉基米尔什么语言通用	{弗拉基米尔=地区国家城市}	语言
在潘切市什么语言通用	{潘切市=地区国家城市}	语言
在阿罗萨什么语言通用	{阿罗萨=地区国家城市}	语言
在印度尼西亚什么语言通用	{印度尼西亚=地区国家城市}	语言
在千叶市什么语言通用	{千叶市=地区国家城市}	语言
在普雷韦扎什么语言通用	{普雷韦扎=地区国家城市}	语言
在阿洛陶什么语言通用	{阿洛陶=地区国家城市}	语言
在八打灵再也什么语言通用	{八打灵再也=地区国家城市}	语言
在克鲁姆洛夫什么语言通用	{克鲁姆洛夫=地区国家城市}	语言
在内坦亚什么语言通用	{内坦亚=地区国家城市}	语言
在努韦巴什么语言通用	{努韦巴=地区国家城市}	语言
在伊朗什么语言通用	{伊朗=地区国家城市}	语言
在乌得勒支什么语言通用	{乌得勒支=地区国家城市}	语言
在华盛顿什么语言通用	{华盛顿=地区国家城市}	语言
在西哈努克什么语言通用	{西哈努克=地区国家城市}	语言
在巴塔利亚什么语言通用	{巴塔利亚=地区国家城市}	语言
在纽伦堡什么语言通用	{纽伦堡=地区国家城市}	语言
在吉萨什么语言通用	{吉萨=地区国家城市}	语言
在沙夫豪森什么语言通用	{沙夫豪森=地区国家城市}	语言
在缅甸什么语言通用	{缅甸=地区国家城市}	语言
在利贝雷茨什么语言通用	{利贝雷茨=地区国家城市}	语言
在奥胡斯什么语言通用	{奥胡斯=地区国家城市}	语言
在民丹岛什么语言通用	{民丹岛=地区国家城市}	语言
在加拿大什么语言通用	{加拿大=地区国家城市}	语言
在拉瓦格什么语言通用	{拉瓦格=地区国家城市}	语言
在万象什么语言通用	{万象=地区国家城市}	语言
在锡尔赫特什么语言通用	{锡尔赫特=地区国家城市}	语言
在丽水什么语言通用	{丽水=地区国家城市}	语言
在老挝什么语言通用	{老挝=地区国家城市}	语言
在卡拉奇什么语言通用	{卡拉奇=地区国家城市}	语言
在顺化什么语言通用	{顺化=地区国家城市}	语言
在水原什么语言通用	{水原=地区国家城市}	语言
在吉马良斯什么语言通用	{吉马良斯=地区国家城市}	语言
在伯尔尼什么语言通用	{伯尔尼=地区国家城市}	语言
在塞班什么语言通用	{塞班=地区国家城市}	语言
在延雪平什么语言通用	{延雪平=地区国家城市}	语言
在博洛尼亚什么语言通用	{博洛尼亚=地区国家城市}	语言
在会安什么语言通用	{会安=地区国家城市}	语言
在吴哥窟什么语言通用	{吴哥窟=地区国家城市}	语言
在台南什么语言通用	{台南=地区国家城市}	语言
在埃因霍温什么语言通用	{埃因霍温=地区国家城市}	语言
在阿克雷里什么语言通用	{阿克雷里=地区国家城市}	语言
在厄勒布鲁什么语言通用	{厄勒布鲁=地区国家城市}	语言
在沙迦什么语言通用	{沙迦=地区国家城市}	语言
在新北什么语言通用	{新北=地区国家城市}	语言
在毛里求斯什么语言通用	{毛里求斯=地区国家城市}	语言
在塔斯马尼亚岛什么语言通用	{塔斯马尼亚岛=地区国家城市}	语言
在马萨达什么语言通用	{马萨达=地区国家城市}	语言
在埃武拉什么语言通用	{埃武拉=地区国家城市}	语言
在塞舌尔什么语言通用	{塞舌尔=地区国家城市}	语言
在芝加哥什么语言通用	{芝加哥=地区国家城市}	语言
在卡尚什么语言通用	{卡尚=地区国家城市}	语言
在马德望什么语言通用	{马德望=地区国家城市}	语言
在萨能什么语言通用	{萨能=地区国家城市}	语言
在阿巴斯港什么语言通用	{阿巴斯港=地区国家城市}	语言
在曼德勒什么语言通用	{曼德勒=地区国家城市}	语言
在卢戈什么语言通用	{卢戈=地区国家城市}	语言
在美蕊沙什么语言通用	{美蕊沙=地区国家城市}	语言
在佛罗伦萨什么语言通用	{佛罗伦萨=地区国家城市}	语言
在隆德什么语言通用	{隆德=地区国家城市}	语言
在雅加达什么语言通用	{雅加达=地区国家城市}	语言
在栋索尔什么语言通用	{栋索尔=地区国家城市}	语言
在箱根什么语言通用	{箱根=地区国家城市}	语言
在锡瓦绿洲什么语言通用	{锡瓦绿洲=地区国家城市}	语言
在班多尔班什么语言通用	{班多尔班=地区国家城市}	语言
在胡阿希内岛什么语言通用	{胡阿希内岛=地区国家城市}	语言
在耶路撒冷什么语言通用	{耶路撒冷=地区国家城市}	语言
在万隆什么语言通用	{万隆=地区国家城市}	语言
在富士山什么语言通用	{富士山=地区国家城市}	语言
在波恩什么语言通用	{波恩=地区国家城市}	语言
在珀斯什么语言通用	{珀斯=地区国家城市}	语言
在泰尔奇什么语言通用	{泰尔奇=地区国家城市}	语言
在马特勒什么语言通用	{马特勒=地区国家城市}	语言
在爱丽丝泉什么语言通用	{爱丽丝泉=地区国家城市}	语言
在墨尔本什么语言通用	{墨尔本=地区国家城市}	语言
在里弗赛德什么语言通用	{里弗赛德=地区国家城市}	语言
在多哈什么语言通用	{多哈=地区国家城市}	语言
在梅尔克什么语言通用	{梅尔克=地区国家城市}	语言
在圣地亚哥-德孔波斯特拉什么语言通用	{圣地亚哥-德孔波斯特拉=地区国家城市}	语言
适合情侣去玩儿的城市	{情侣=适宜人群}	城市list
适合动漫迷去玩儿的城市	{动漫迷=适宜人群}	城市list
适合亲子去玩儿的城市	{亲子=适宜人群}	城市list
哪些城市适合情侣去玩儿	{情侣=适宜人群}	城市list
哪些城市适合动漫迷去玩儿	{动漫迷=适宜人群}	城市list
推荐适合动漫迷的城市	{动漫迷=适宜人群}	城市list
推荐适合情侣的城市	{情侣=适宜人群}	城市list
推荐适合亲子的城市	{亲子=适宜人群}	城市list
有没有适合动漫迷的城市	{动漫迷=适宜人群}	城市list
有没有适合情侣的城市	{情侣=适宜人群}	城市list
有没有适合亲子的城市	{亲子=适宜人群}	城市list
有哪些适合动漫迷的城市	{动漫迷=适宜人群}	城市list
有哪些适合亲子的城市	{亲子=适宜人群}	城市list
有哪些适合情侣的城市	{情侣=适宜人群}	城市list
哪些城市适合亲子	{亲子=适宜人群}	城市list
哪些城市适合动漫迷	{动漫迷=适宜人群}	城市list
哪些城市适合情侣	{情侣=适宜人群}	城市list
什么城市适合情侣	{情侣=适宜人群}	城市list
什么城市适合动漫迷	{动漫迷=适宜人群}	城市list
什么城市适合亲子	{亲子=适宜人群}	城市list
适合情侣的城市	{情侣=适宜人群}	城市list
适合亲子的城市	{亲子=适宜人群}	城市list
适合动漫迷的城市	{动漫迷=适宜人群}	城市list
挪威适合亲子去玩儿的城市	{亲子=适宜人群, 挪威=地区国家}	城市list
中国适合情侣去玩儿的城市	{情侣=适宜人群, 中国=地区国家}	城市list
帕劳适合亲子去玩儿的城市	{帕劳=地区国家, 亲子=适宜人群}	城市list
南极洲适合亲子去玩儿的城市	{亲子=适宜人群, 南极洲=地区国家}	城市list
巴西适合亲子去玩儿的城市	{巴西=地区国家, 亲子=适宜人群}	城市list
菲律宾适合亲子去玩儿的城市	{亲子=适宜人群, 菲律宾=地区国家}	城市list
冰岛适合情侣去玩儿的城市	{冰岛=地区国家, 情侣=适宜人群}	城市list
塞舌尔适合动漫迷去玩儿的城市	{动漫迷=适宜人群, 塞舌尔=地区国家}	城市list
以色列适合情侣去玩儿的城市	{以色列=地区国家, 情侣=适宜人群}	城市list
法属波利尼西亚适合情侣去玩儿的城市	{情侣=适宜人群, 法属波利尼西亚=地区国家}	城市list
德国适合亲子去玩儿的城市	{亲子=适宜人群, 德国=地区国家}	城市list
南非适合动漫迷去玩儿的城市	{动漫迷=适宜人群, 南非=地区国家}	城市list
新西兰适合情侣去玩儿的城市	{情侣=适宜人群, 新西兰=地区国家}	城市list
加拿大适合动漫迷去玩儿的城市	{动漫迷=适宜人群, 加拿大=地区国家}	城市list
日本适合情侣去玩儿的城市	{情侣=适宜人群, 日本=地区国家}	城市list
柬埔寨适合情侣去玩儿的城市	{柬埔寨=地区国家, 情侣=适宜人群}	城市list
土耳其适合动漫迷去玩儿的城市	{动漫迷=适宜人群, 土耳其=地区国家}	城市list
德国适合动漫迷去玩儿的城市	{动漫迷=适宜人群, 德国=地区国家}	城市list
斐济适合亲子去玩儿的城市	{斐济=地区国家, 亲子=适宜人群}	城市list
越南适合情侣去玩儿的城市	{情侣=适宜人群, 越南=地区国家}	城市list
埃及适合亲子去玩儿的城市	{亲子=适宜人群, 埃及=地区国家}	城市list
以色列适合动漫迷去玩儿的城市	{动漫迷=适宜人群, 以色列=地区国家}	城市list
美国适合动漫迷去玩儿的城市	{美国=地区国家, 动漫迷=适宜人群}	城市list
南极洲适合情侣去玩儿的城市	{情侣=适宜人群, 南极洲=地区国家}	城市list
印度尼西亚适合亲子去玩儿的城市	{亲子=适宜人群, 印度尼西亚=地区国家}	城市list
巴布亚新几内亚适合动漫迷去玩儿的城市	{动漫迷=适宜人群, 巴布亚新几内亚=地区国家}	城市list
卡塔尔适合动漫迷去玩儿的城市	{动漫迷=适宜人群, 卡塔尔=地区国家}	城市list
斐济适合动漫迷去玩儿的城市	{动漫迷=适宜人群, 斐济=地区国家}	城市list
爱尔兰适合亲子去玩儿的城市	{爱尔兰=地区国家, 亲子=适宜人群}	城市list
马来西亚适合动漫迷去玩儿的城市	{动漫迷=适宜人群, 马来西亚=地区国家}	城市list
马来西亚适合情侣去玩儿的城市	{情侣=适宜人群, 马来西亚=地区国家}	城市list
英国适合情侣去玩儿的城市	{情侣=适宜人群, 英国=地区国家}	城市list
埃及适合动漫迷去玩儿的城市	{动漫迷=适宜人群, 埃及=地区国家}	城市list
越南适合亲子去玩儿的城市	{亲子=适宜人群, 越南=地区国家}	城市list
马来西亚适合亲子去玩儿的城市	{马来西亚=地区国家, 亲子=适宜人群}	城市list
泰国适合动漫迷去玩儿的城市	{泰国=地区国家, 动漫迷=适宜人群}	城市list
南非适合亲子去玩儿的城市	{亲子=适宜人群, 南非=地区国家}	城市list
缅甸适合动漫迷去玩儿的城市	{动漫迷=适宜人群, 缅甸=地区国家}	城市list
斐济适合情侣去玩儿的城市	{斐济=地区国家, 情侣=适宜人群}	城市list
埃及适合情侣去玩儿的城市	{情侣=适宜人群, 埃及=地区国家}	城市list
智利适合动漫迷去玩儿的城市	{动漫迷=适宜人群, 智利=地区国家}	城市list
芬兰适合动漫迷去玩儿的城市	{动漫迷=适宜人群, 芬兰=地区国家}	城市list
荷兰适合情侣去玩儿的城市	{情侣=适宜人群, 荷兰=地区国家}	城市list
阿根廷适合情侣去玩儿的城市	{情侣=适宜人群, 阿根廷=地区国家}	城市list
马尔代夫适合动漫迷去玩儿的城市	{动漫迷=适宜人群, 马尔代夫=地区国家}	城市list
阿联酋适合情侣去玩儿的城市	{阿联酋=地区国家, 情侣=适宜人群}	城市list
捷克适合亲子去玩儿的城市	{亲子=适宜人群, 捷克=地区国家}	城市list
哥伦比亚适合情侣去玩儿的城市	{情侣=适宜人群, 哥伦比亚=地区国家}	城市list
不丹适合情侣去玩儿的城市	{情侣=适宜人群, 不丹=地区国家}	城市list
意大利适合情侣去玩儿的城市	{情侣=适宜人群, 意大利=地区国家}	城市list
伊朗适合动漫迷去玩儿的城市	{动漫迷=适宜人群, 伊朗=地区国家}	城市list
澳大利亚适合情侣去玩儿的城市	{情侣=适宜人群, 澳大利亚=地区国家}	城市list
土耳其适合情侣去玩儿的城市	{情侣=适宜人群, 土耳其=地区国家}	城市list
菲律宾适合动漫迷去玩儿的城市	{动漫迷=适宜人群, 菲律宾=地区国家}	城市list
大溪地适合情侣去玩儿的城市	{大溪地=地区国家, 情侣=适宜人群}	城市list
越南适合动漫迷去玩儿的城市	{动漫迷=适宜人群, 越南=地区国家}	城市list
比利时适合情侣去玩儿的城市	{情侣=适宜人群, 比利时=地区国家}	城市list
捷克适合动漫迷去玩儿的城市	{动漫迷=适宜人群, 捷克=地区国家}	城市list
塞舌尔适合亲子去玩儿的城市	{亲子=适宜人群, 塞舌尔=地区国家}	城市list
巴西适合情侣去玩儿的城市	{巴西=地区国家, 情侣=适宜人群}	城市list
西班牙适合亲子去玩儿的城市	{亲子=适宜人群, 西班牙=地区国家}	城市list
马尔代夫适合亲子去玩儿的城市	{马尔代夫=地区国家, 亲子=适宜人群}	城市list
秘鲁适合情侣去玩儿的城市	{情侣=适宜人群, 秘鲁=地区国家}	城市list
南美适合情侣去玩儿的城市	{情侣=适宜人群, 南美=地区国家}	城市list
捷克适合情侣去玩儿的城市	{情侣=适宜人群, 捷克=地区国家}	城市list
库克群岛适合亲子去玩儿的城市	{库克群岛=地区国家, 亲子=适宜人群}	城市list
斯里兰卡适合情侣去玩儿的城市	{情侣=适宜人群, 斯里兰卡=地区国家}	城市list
西班牙适合情侣去玩儿的城市	{情侣=适宜人群, 西班牙=地区国家}	城市list
肯尼亚适合动漫迷去玩儿的城市	{动漫迷=适宜人群, 肯尼亚=地区国家}	城市list
孟加拉国适合亲子去玩儿的城市	{亲子=适宜人群, 孟加拉国=地区国家}	城市list
南美适合动漫迷去玩儿的城市	{动漫迷=适宜人群, 南美=地区国家}	城市list
希腊适合情侣去玩儿的城市	{情侣=适宜人群, 希腊=地区国家}	城市list
不丹适合亲子去玩儿的城市	{不丹=地区国家, 亲子=适宜人群}	城市list
丹麦适合情侣去玩儿的城市	{情侣=适宜人群, 丹麦=地区国家}	城市list
芬兰适合亲子去玩儿的城市	{芬兰=地区国家, 亲子=适宜人群}	城市list
不丹适合动漫迷去玩儿的城市	{动漫迷=适宜人群, 不丹=地区国家}	城市list
老挝适合情侣去玩儿的城市	{情侣=适宜人群, 老挝=地区国家}	城市list
法国适合动漫迷去玩儿的城市	{动漫迷=适宜人群, 法国=地区国家}	城市list
芬兰适合情侣去玩儿的城市	{情侣=适宜人群, 芬兰=地区国家}	城市list
伊拉克适合情侣去玩儿的城市	{情侣=适宜人群, 伊拉克=地区国家}	城市list
巴哈马适合动漫迷去玩儿的城市	{动漫迷=适宜人群, 巴哈马=地区国家}	城市list
秘鲁适合动漫迷去玩儿的城市	{动漫迷=适宜人群, 秘鲁=地区国家}	城市list
以色列适合亲子去玩儿的城市	{以色列=地区国家, 亲子=适宜人群}	城市list
缅甸适合情侣去玩儿的城市	{情侣=适宜人群, 缅甸=地区国家}	城市list
冰岛适合动漫迷去玩儿的城市	{动漫迷=适宜人群, 冰岛=地区国家}	城市list
肯尼亚适合情侣去玩儿的城市	{情侣=适宜人群, 肯尼亚=地区国家}	城市list
冰岛适合亲子去玩儿的城市	{冰岛=地区国家, 亲子=适宜人群}	城市list
澳大利亚适合亲子去玩儿的城市	{亲子=适宜人群, 澳大利亚=地区国家}	城市list
日本适合亲子去玩儿的城市	{亲子=适宜人群, 日本=地区国家}	城市list
瑞典适合动漫迷去玩儿的城市	{动漫迷=适宜人群, 瑞典=地区国家}	城市list
智利适合情侣去玩儿的城市	{情侣=适宜人群, 智利=地区国家}	城市list
所罗门群岛适合亲子去玩儿的城市	{所罗门群岛=地区国家, 亲子=适宜人群}	城市list
南极洲适合动漫迷去玩儿的城市	{动漫迷=适宜人群, 南极洲=地区国家}	城市list
美国适合亲子去玩儿的城市	{美国=地区国家, 亲子=适宜人群}	城市list
巴西适合动漫迷去玩儿的城市	{巴西=地区国家, 动漫迷=适宜人群}	城市list
新加坡适合动漫迷去玩儿的城市	{动漫迷=适宜人群, 新加坡=地区国家}	城市list
新加坡适合亲子去玩儿的城市	{亲子=适宜人群, 新加坡=地区国家}	城市list
阿根廷适合动漫迷去玩儿的城市	{动漫迷=适宜人群, 阿根廷=地区国家}	城市list
伊拉克适合亲子去玩儿的城市	{亲子=适宜人群, 伊拉克=地区国家}	城市list
大溪地适合亲子去玩儿的城市	{大溪地=地区国家, 亲子=适宜人群}	城市list
埃及哪些城市适合亲子去玩儿	{亲子=适宜人群, 埃及=地区国家}	城市list
斯里兰卡哪些城市适合情侣去玩儿	{情侣=适宜人群, 斯里兰卡=地区国家}	城市list
缅甸哪些城市适合情侣去玩儿	{情侣=适宜人群, 缅甸=地区国家}	城市list
芬兰哪些城市适合情侣去玩儿	{情侣=适宜人群, 芬兰=地区国家}	城市list
沙特哪些城市适合动漫迷去玩儿	{动漫迷=适宜人群, 沙特=地区国家}	城市list
菲律宾哪些城市适合动漫迷去玩儿	{动漫迷=适宜人群, 菲律宾=地区国家}	城市list
爱尔兰哪些城市适合亲子去玩儿	{爱尔兰=地区国家, 亲子=适宜人群}	城市list
肯尼亚哪些城市适合情侣去玩儿	{情侣=适宜人群, 肯尼亚=地区国家}	城市list
瑞典哪些城市适合动漫迷去玩儿	{动漫迷=适宜人群, 瑞典=地区国家}	城市list
以色列哪些城市适合情侣去玩儿	{以色列=地区国家, 情侣=适宜人群}	城市list
新西兰哪些城市适合动漫迷去玩儿	{动漫迷=适宜人群, 新西兰=地区国家}	城市list
挪威哪些城市适合动漫迷去玩儿	{动漫迷=适宜人群, 挪威=地区国家}	城市list
土耳其哪些城市适合动漫迷去玩儿	{动漫迷=适宜人群, 土耳其=地区国家}	城市list
西班牙哪些城市适合动漫迷去玩儿	{动漫迷=适宜人群, 西班牙=地区国家}	城市list
斐济哪些城市适合动漫迷去玩儿	{动漫迷=适宜人群, 斐济=地区国家}	城市list
埃及哪些城市适合情侣去玩儿	{情侣=适宜人群, 埃及=地区国家}	城市list
希腊哪些城市适合亲子去玩儿	{希腊=地区国家, 亲子=适宜人群}	城市list
中国哪些城市适合亲子去玩儿	{亲子=适宜人群, 中国=地区国家}	城市list
卡塔尔哪些城市适合情侣去玩儿	{情侣=适宜人群, 卡塔尔=地区国家}	城市list
芬兰哪些城市适合动漫迷去玩儿	{动漫迷=适宜人群, 芬兰=地区国家}	城市list
越南哪些城市适合动漫迷去玩儿	{动漫迷=适宜人群, 越南=地区国家}	城市list
伊拉克哪些城市适合动漫迷去玩儿	{动漫迷=适宜人群, 伊拉克=地区国家}	城市list
塞舌尔哪些城市适合情侣去玩儿	{情侣=适宜人群, 塞舌尔=地区国家}	城市list
奥地利哪些城市适合动漫迷去玩儿	{动漫迷=适宜人群, 奥地利=地区国家}	城市list
智利哪些城市适合动漫迷去玩儿	{动漫迷=适宜人群, 智利=地区国家}	城市list
瑞典哪些城市适合亲子去玩儿	{瑞典=地区国家, 亲子=适宜人群}	城市list
南极洲哪些城市适合动漫迷去玩儿	{动漫迷=适宜人群, 南极洲=地区国家}	城市list
孟加拉国哪些城市适合动漫迷去玩儿	{动漫迷=适宜人群, 孟加拉国=地区国家}	城市list
以色列哪些城市适合动漫迷去玩儿	{动漫迷=适宜人群, 以色列=地区国家}	城市list
意大利哪些城市适合情侣去玩儿	{情侣=适宜人群, 意大利=地区国家}	城市list
伊朗哪些城市适合动漫迷去玩儿	{动漫迷=适宜人群, 伊朗=地区国家}	城市list
日本哪些城市适合情侣去玩儿	{情侣=适宜人群, 日本=地区国家}	城市list
匈牙利哪些城市适合动漫迷去玩儿	{动漫迷=适宜人群, 匈牙利=地区国家}	城市list
巴布亚新几内亚哪些城市适合亲子去玩儿	{亲子=适宜人群, 巴布亚新几内亚=地区国家}	城市list
尼泊尔哪些城市适合动漫迷去玩儿	{动漫迷=适宜人群, 尼泊尔=地区国家}	城市list
东南亚哪些城市适合亲子去玩儿	{东南亚=地区国家, 亲子=适宜人群}	城市list
南非哪些城市适合亲子去玩儿	{亲子=适宜人群, 南非=地区国家}	城市list
德国哪些城市适合情侣去玩儿	{情侣=适宜人群, 德国=地区国家}	城市list
智利哪些城市适合情侣去玩儿	{情侣=适宜人群, 智利=地区国家}	城市list
瑞士哪些城市适合动漫迷去玩儿	{动漫迷=适宜人群, 瑞士=地区国家}	城市list
斯里兰卡哪些城市适合亲子去玩儿	{亲子=适宜人群, 斯里兰卡=地区国家}	城市list
越南哪些城市适合情侣去玩儿	{情侣=适宜人群, 越南=地区国家}	城市list
卡塔尔哪些城市适合动漫迷去玩儿	{动漫迷=适宜人群, 卡塔尔=地区国家}	城市list
缅甸哪些城市适合动漫迷去玩儿	{动漫迷=适宜人群, 缅甸=地区国家}	城市list
中国哪些城市适合情侣去玩儿	{情侣=适宜人群, 中国=地区国家}	城市list
柬埔寨哪些城市适合亲子去玩儿	{柬埔寨=地区国家, 亲子=适宜人群}	城市list
巴基斯坦哪些城市适合亲子去玩儿	{巴基斯坦=地区国家, 亲子=适宜人群}	城市list
秘鲁哪些城市适合亲子去玩儿	{秘鲁=地区国家, 亲子=适宜人群}	城市list
巴基斯坦哪些城市适合动漫迷去玩儿	{动漫迷=适宜人群, 巴基斯坦=地区国家}	城市list
巴西哪些城市适合情侣去玩儿	{巴西=地区国家, 情侣=适宜人群}	城市list
土耳其哪些城市适合情侣去玩儿	{情侣=适宜人群, 土耳其=地区国家}	城市list
俄罗斯哪些城市适合动漫迷去玩儿	{动漫迷=适宜人群, 俄罗斯=地区国家}	城市list
澳大利亚哪些城市适合动漫迷去玩儿	{动漫迷=适宜人群, 澳大利亚=地区国家}	城市list
比利时哪些城市适合动漫迷去玩儿	{动漫迷=适宜人群, 比利时=地区国家}	城市list
挪威哪些城市适合亲子去玩儿	{亲子=适宜人群, 挪威=地区国家}	城市list
日本哪些城市适合亲子去玩儿	{亲子=适宜人群, 日本=地区国家}	城市list
葡萄牙哪些城市适合动漫迷去玩儿	{动漫迷=适宜人群, 葡萄牙=地区国家}	城市list
巴西哪些城市适合亲子去玩儿	{巴西=地区国家, 亲子=适宜人群}	城市list
巴哈马哪些城市适合亲子去玩儿	{巴哈马=地区国家, 亲子=适宜人群}	城市list
澳大利亚哪些城市适合情侣去玩儿	{情侣=适宜人群, 澳大利亚=地区国家}	城市list
以色列哪些城市适合亲子去玩儿	{以色列=地区国家, 亲子=适宜人群}	城市list
肯尼亚哪些城市适合动漫迷去玩儿	{动漫迷=适宜人群, 肯尼亚=地区国家}	城市list
东南亚哪些城市适合情侣去玩儿	{东南亚=地区国家, 情侣=适宜人群}	城市list
斯里兰卡哪些城市适合动漫迷去玩儿	{动漫迷=适宜人群, 斯里兰卡=地区国家}	城市list
美国哪些城市适合情侣去玩儿	{美国=地区国家, 情侣=适宜人群}	城市list
南美哪些城市适合亲子去玩儿	{亲子=适宜人群, 南美=地区国家}	城市list
阿根廷哪些城市适合情侣去玩儿	{情侣=适宜人群, 阿根廷=地区国家}	城市list
爱尔兰哪些城市适合动漫迷去玩儿	{动漫迷=适宜人群, 爱尔兰=地区国家}	城市list
伊拉克哪些城市适合情侣去玩儿	{情侣=适宜人群, 伊拉克=地区国家}	城市list
不丹哪些城市适合动漫迷去玩儿	{动漫迷=适宜人群, 不丹=地区国家}	城市list
意大利哪些城市适合亲子去玩儿	{意大利=地区国家, 亲子=适宜人群}	城市list
塞舌尔哪些城市适合动漫迷去玩儿	{动漫迷=适宜人群, 塞舌尔=地区国家}	城市list
法属波利尼西亚哪些城市适合亲子去玩儿	{亲子=适宜人群, 法属波利尼西亚=地区国家}	城市list
日本哪些城市适合动漫迷去玩儿	{动漫迷=适宜人群, 日本=地区国家}	城市list
阿根廷哪些城市适合动漫迷去玩儿	{动漫迷=适宜人群, 阿根廷=地区国家}	城市list
巴哈马哪些城市适合情侣去玩儿	{情侣=适宜人群, 巴哈马=地区国家}	城市list
马尔代夫哪些城市适合亲子去玩儿	{马尔代夫=地区国家, 亲子=适宜人群}	城市list
塞舌尔哪些城市适合亲子去玩儿	{亲子=适宜人群, 塞舌尔=地区国家}	城市list
所罗门群岛哪些城市适合动漫迷去玩儿	{动漫迷=适宜人群, 所罗门群岛=地区国家}	城市list
东南亚哪些城市适合动漫迷去玩儿	{东南亚=地区国家, 动漫迷=适宜人群}	城市list
巴布亚新几内亚哪些城市适合动漫迷去玩儿	{动漫迷=适宜人群, 巴布亚新几内亚=地区国家}	城市list
冰岛哪些城市适合动漫迷去玩儿	{动漫迷=适宜人群, 冰岛=地区国家}	城市list
库克群岛哪些城市适合亲子去玩儿	{库克群岛=地区国家, 亲子=适宜人群}	城市list
帕劳哪些城市适合亲子去玩儿	{帕劳=地区国家, 亲子=适宜人群}	城市list
荷兰哪些城市适合动漫迷去玩儿	{动漫迷=适宜人群, 荷兰=地区国家}	城市list
意大利哪些城市适合动漫迷去玩儿	{动漫迷=适宜人群, 意大利=地区国家}	城市list
芬兰哪些城市适合亲子去玩儿	{芬兰=地区国家, 亲子=适宜人群}	城市list
尼泊尔哪些城市适合亲子去玩儿	{尼泊尔=地区国家, 亲子=适宜人群}	城市list
英国哪些城市适合亲子去玩儿	{亲子=适宜人群, 英国=地区国家}	城市list
亚洲哪些城市适合情侣去玩儿	{亚洲=地区国家, 情侣=适宜人群}	城市list
大溪地哪些城市适合亲子去玩儿	{大溪地=地区国家, 亲子=适宜人群}	城市list
瑞士哪些城市适合情侣去玩儿	{情侣=适宜人群, 瑞士=地区国家}	城市list
南非哪些城市适合情侣去玩儿	{情侣=适宜人群, 南非=地区国家}	城市list
加拿大哪些城市适合情侣去玩儿	{情侣=适宜人群, 加拿大=地区国家}	城市list
法属波利尼西亚哪些城市适合情侣去玩儿	{情侣=适宜人群, 法属波利尼西亚=地区国家}	城市list
荷兰哪些城市适合亲子去玩儿	{亲子=适宜人群, 荷兰=地区国家}	城市list
巴基斯坦哪些城市适合情侣去玩儿	{巴基斯坦=地区国家, 情侣=适宜人群}	城市list
瑞典哪些城市适合情侣去玩儿	{情侣=适宜人群, 瑞典=地区国家}	城市list
荷兰哪些城市适合情侣去玩儿	{情侣=适宜人群, 荷兰=地区国家}	城市list
法属波利尼西亚哪些城市适合动漫迷去玩儿	{动漫迷=适宜人群, 法属波利尼西亚=地区国家}	城市list
哥伦比亚推荐适合情侣的城市	{情侣=适宜人群, 哥伦比亚=地区国家}	城市list
库克群岛推荐适合亲子的城市	{库克群岛=地区国家, 亲子=适宜人群}	城市list
爱尔兰推荐适合动漫迷的城市	{动漫迷=适宜人群, 爱尔兰=地区国家}	城市list
冰岛推荐适合动漫迷的城市	{动漫迷=适宜人群, 冰岛=地区国家}	城市list
孟加拉国推荐适合亲子的城市	{亲子=适宜人群, 孟加拉国=地区国家}	城市list
老挝推荐适合情侣的城市	{情侣=适宜人群, 老挝=地区国家}	城市list
毛里求斯推荐适合动漫迷的城市	{动漫迷=适宜人群, 毛里求斯=地区国家}	城市list
老挝推荐适合动漫迷的城市	{动漫迷=适宜人群, 老挝=地区国家}	城市list
帕劳推荐适合亲子的城市	{帕劳=地区国家, 亲子=适宜人群}	城市list
斯里兰卡推荐适合亲子的城市	{亲子=适宜人群, 斯里兰卡=地区国家}	城市list
巴西推荐适合动漫迷的城市	{巴西=地区国家, 动漫迷=适宜人群}	城市list
东南亚推荐适合亲子的城市	{东南亚=地区国家, 亲子=适宜人群}	城市list
东南亚推荐适合情侣的城市	{东南亚=地区国家, 情侣=适宜人群}	城市list
丹麦推荐适合情侣的城市	{情侣=适宜人群, 丹麦=地区国家}	城市list
斯里兰卡推荐适合情侣的城市	{情侣=适宜人群, 斯里兰卡=地区国家}	城市list
越南推荐适合情侣的城市	{情侣=适宜人群, 越南=地区国家}	城市list
阿联酋推荐适合情侣的城市	{阿联酋=地区国家, 情侣=适宜人群}	城市list
法属波利尼西亚推荐适合亲子的城市	{亲子=适宜人群, 法属波利尼西亚=地区国家}	城市list
新加坡推荐适合动漫迷的城市	{动漫迷=适宜人群, 新加坡=地区国家}	城市list
沙特推荐适合动漫迷的城市	{动漫迷=适宜人群, 沙特=地区国家}	城市list
挪威推荐适合情侣的城市	{情侣=适宜人群, 挪威=地区国家}	城市list
奥地利推荐适合情侣的城市	{情侣=适宜人群, 奥地利=地区国家}	城市list
巴布亚新几内亚推荐适合情侣的城市	{情侣=适宜人群, 巴布亚新几内亚=地区国家}	城市list
俄罗斯推荐适合情侣的城市	{情侣=适宜人群, 俄罗斯=地区国家}	城市list
丹麦推荐适合亲子的城市	{丹麦=地区国家, 亲子=适宜人群}	城市list
斐济推荐适合动漫迷的城市	{动漫迷=适宜人群, 斐济=地区国家}	城市list
南极洲推荐适合情侣的城市	{情侣=适宜人群, 南极洲=地区国家}	城市list
欧洲推荐适合动漫迷的城市	{动漫迷=适宜人群, 欧洲=地区国家}	城市list
阿根廷推荐适合动漫迷的城市	{动漫迷=适宜人群, 阿根廷=地区国家}	城市list
荷兰推荐适合动漫迷的城市	{动漫迷=适宜人群, 荷兰=地区国家}	城市list
南极洲推荐适合亲子的城市	{亲子=适宜人群, 南极洲=地区国家}	城市list
日本推荐适合动漫迷的城市	{动漫迷=适宜人群, 日本=地区国家}	城市list
新加坡推荐适合情侣的城市	{情侣=适宜人群, 新加坡=地区国家}	城市list
欧洲推荐适合亲子的城市	{欧洲=地区国家, 亲子=适宜人群}	城市list
挪威推荐适合动漫迷的城市	{动漫迷=适宜人群, 挪威=地区国家}	城市list
伊拉克推荐适合动漫迷的城市	{动漫迷=适宜人群, 伊拉克=地区国家}	城市list
俄罗斯推荐适合动漫迷的城市	{动漫迷=适宜人群, 俄罗斯=地区国家}	城市list
澳大利亚推荐适合亲子的城市	{亲子=适宜人群, 澳大利亚=地区国家}	城市list
巴哈马推荐适合情侣的城市	{情侣=适宜人群, 巴哈马=地区国家}	城市list
瑞士推荐适合情侣的城市	{情侣=适宜人群, 瑞士=地区国家}	城市list
新加坡推荐适合亲子的城市	{亲子=适宜人群, 新加坡=地区国家}	城市list
韩国推荐适合动漫迷的城市	{动漫迷=适宜人群, 韩国=地区国家}	城市list
瑞典推荐适合亲子的城市	{瑞典=地区国家, 亲子=适宜人群}	城市list
意大利推荐适合亲子的城市	{意大利=地区国家, 亲子=适宜人群}	城市list
土耳其推荐适合动漫迷的城市	{动漫迷=适宜人群, 土耳其=地区国家}	城市list
加拿大推荐适合动漫迷的城市	{动漫迷=适宜人群, 加拿大=地区国家}	城市list
菲律宾推荐适合亲子的城市	{亲子=适宜人群, 菲律宾=地区国家}	城市list
阿根廷推荐适合情侣的城市	{情侣=适宜人群, 阿根廷=地区国家}	城市list
卡塔尔推荐适合亲子的城市	{卡塔尔=地区国家, 亲子=适宜人群}	城市list
菲律宾推荐适合动漫迷的城市	{动漫迷=适宜人群, 菲律宾=地区国家}	城市list
中国推荐适合亲子的城市	{亲子=适宜人群, 中国=地区国家}	城市list
瑞士推荐适合亲子的城市	{瑞士=地区国家, 亲子=适宜人群}	城市list
以色列推荐适合情侣的城市	{以色列=地区国家, 情侣=适宜人群}	城市list
西班牙推荐适合动漫迷的城市	{动漫迷=适宜人群, 西班牙=地区国家}	城市list
比利时推荐适合动漫迷的城市	{动漫迷=适宜人群, 比利时=地区国家}	城市list
美国推荐适合亲子的城市	{美国=地区国家, 亲子=适宜人群}	城市list
智利推荐适合亲子的城市	{智利=地区国家, 亲子=适宜人群}	城市list
美国推荐适合情侣的城市	{美国=地区国家, 情侣=适宜人群}	城市list
加拿大推荐适合亲子的城市	{亲子=适宜人群, 加拿大=地区国家}	城市list
不丹推荐适合情侣的城市	{情侣=适宜人群, 不丹=地区国家}	城市list
新西兰推荐适合情侣的城市	{情侣=适宜人群, 新西兰=地区国家}	城市list
瑞典推荐适合情侣的城市	{情侣=适宜人群, 瑞典=地区国家}	城市list
库克群岛推荐适合动漫迷的城市	{动漫迷=适宜人群, 库克群岛=地区国家}	城市list
英国推荐适合动漫迷的城市	{动漫迷=适宜人群, 英国=地区国家}	城市list
卡塔尔推荐适合情侣的城市	{情侣=适宜人群, 卡塔尔=地区国家}	城市list
捷克推荐适合亲子的城市	{亲子=适宜人群, 捷克=地区国家}	城市list
法国推荐适合动漫迷的城市	{动漫迷=适宜人群, 法国=地区国家}	城市list
日本推荐适合亲子的城市	{亲子=适宜人群, 日本=地区国家}	城市list
澳大利亚推荐适合动漫迷的城市	{动漫迷=适宜人群, 澳大利亚=地区国家}	城市list
马来西亚推荐适合亲子的城市	{马来西亚=地区国家, 亲子=适宜人群}	城市list
埃及推荐适合亲子的城市	{亲子=适宜人群, 埃及=地区国家}	城市list
帕劳推荐适合情侣的城市	{情侣=适宜人群, 帕劳=地区国家}	城市list
菲律宾推荐适合情侣的城市	{情侣=适宜人群, 菲律宾=地区国家}	城市list
巴基斯坦推荐适合亲子的城市	{巴基斯坦=地区国家, 亲子=适宜人群}	城市list
巴布亚新几内亚推荐适合亲子的城市	{亲子=适宜人群, 巴布亚新几内亚=地区国家}	城市list
沙特推荐适合情侣的城市	{情侣=适宜人群, 沙特=地区国家}	城市list
大溪地推荐适合动漫迷的城市	{动漫迷=适宜人群, 大溪地=地区国家}	城市list
法属波利尼西亚推荐适合情侣的城市	{情侣=适宜人群, 法属波利尼西亚=地区国家}	城市list
南非推荐适合动漫迷的城市	{动漫迷=适宜人群, 南非=地区国家}	城市list
新西兰推荐适合亲子的城市	{亲子=适宜人群, 新西兰=地区国家}	城市list
所罗门群岛推荐适合亲子的城市	{所罗门群岛=地区国家, 亲子=适宜人群}	城市list
西班牙推荐适合亲子的城市	{亲子=适宜人群, 西班牙=地区国家}	城市list
俄罗斯推荐适合亲子的城市	{俄罗斯=地区国家, 亲子=适宜人群}	城市list
巴哈马推荐适合动漫迷的城市	{动漫迷=适宜人群, 巴哈马=地区国家}	城市list
芬兰推荐适合动漫迷的城市	{动漫迷=适宜人群, 芬兰=地区国家}	城市list
马尔代夫推荐适合情侣的城市	{情侣=适宜人群, 马尔代夫=地区国家}	城市list
芬兰推荐适合亲子的城市	{芬兰=地区国家, 亲子=适宜人群}	城市list
智利推荐适合情侣的城市	{情侣=适宜人群, 智利=地区国家}	城市list
库克群岛推荐适合情侣的城市	{库克群岛=地区国家, 情侣=适宜人群}	城市list
不丹推荐适合亲子的城市	{不丹=地区国家, 亲子=适宜人群}	城市list
以色列推荐适合亲子的城市	{以色列=地区国家, 亲子=适宜人群}	城市list
葡萄牙推荐适合情侣的城市	{情侣=适宜人群, 葡萄牙=地区国家}	城市list
瑞士推荐适合动漫迷的城市	{动漫迷=适宜人群, 瑞士=地区国家}	城市list
泰国推荐适合亲子的城市	{泰国=地区国家, 亲子=适宜人群}	城市list
奥地利推荐适合动漫迷的城市	{动漫迷=适宜人群, 奥地利=地区国家}	城市list
斐济推荐适合情侣的城市	{斐济=地区国家, 情侣=适宜人群}	城市list
南非推荐适合情侣的城市	{情侣=适宜人群, 南非=地区国家}	城市list
德国推荐适合亲子的城市	{亲子=适宜人群, 德国=地区国家}	城市list
德国推荐适合情侣的城市	{情侣=适宜人群, 德国=地区国家}	城市list
泰国推荐适合情侣的城市	{泰国=地区国家, 情侣=适宜人群}	城市list
西班牙有没有适合情侣的城市	{情侣=适宜人群, 西班牙=地区国家}	城市list
南非有没有适合动漫迷的城市	{动漫迷=适宜人群, 南非=地区国家}	城市list
荷兰有没有适合情侣的城市	{情侣=适宜人群, 荷兰=地区国家}	城市list
美国有没有适合亲子的城市	{美国=地区国家, 亲子=适宜人群}	城市list
南极洲有没有适合情侣的城市	{情侣=适宜人群, 南极洲=地区国家}	城市list
冰岛有没有适合动漫迷的城市	{动漫迷=适宜人群, 冰岛=地区国家}	城市list
亚洲有没有适合亲子的城市	{亚洲=地区国家, 亲子=适宜人群}	城市list
泰国有没有适合情侣的城市	{泰国=地区国家, 情侣=适宜人群}	城市list
埃及有没有适合情侣的城市	{情侣=适宜人群, 埃及=地区国家}	城市list
肯尼亚有没有适合情侣的城市	{情侣=适宜人群, 肯尼亚=地区国家}	城市list
比利时有没有适合情侣的城市	{情侣=适宜人群, 比利时=地区国家}	城市list
芬兰有没有适合动漫迷的城市	{动漫迷=适宜人群, 芬兰=地区国家}	城市list
东南亚有没有适合亲子的城市	{东南亚=地区国家, 亲子=适宜人群}	城市list
南美有没有适合动漫迷的城市	{动漫迷=适宜人群, 南美=地区国家}	城市list
新西兰有没有适合亲子的城市	{亲子=适宜人群, 新西兰=地区国家}	城市list
新西兰有没有适合情侣的城市	{情侣=适宜人群, 新西兰=地区国家}	城市list
挪威有没有适合动漫迷的城市	{动漫迷=适宜人群, 挪威=地区国家}	城市list
希腊有没有适合情侣的城市	{情侣=适宜人群, 希腊=地区国家}	城市list
巴布亚新几内亚有没有适合情侣的城市	{情侣=适宜人群, 巴布亚新几内亚=地区国家}	城市list
马尔代夫有没有适合亲子的城市	{马尔代夫=地区国家, 亲子=适宜人群}	城市list
新西兰有没有适合动漫迷的城市	{动漫迷=适宜人群, 新西兰=地区国家}	城市list
巴西有没有适合亲子的城市	{巴西=地区国家, 亲子=适宜人群}	城市list
智利有没有适合动漫迷的城市	{动漫迷=适宜人群, 智利=地区国家}	城市list
印度尼西亚有没有适合亲子的城市	{亲子=适宜人群, 印度尼西亚=地区国家}	城市list
芬兰有没有适合亲子的城市	{芬兰=地区国家, 亲子=适宜人群}	城市list
法属波利尼西亚有没有适合动漫迷的城市	{动漫迷=适宜人群, 法属波利尼西亚=地区国家}	城市list
越南有没有适合亲子的城市	{亲子=适宜人群, 越南=地区国家}	城市list
智利有没有适合亲子的城市	{智利=地区国家, 亲子=适宜人群}	城市list
伊拉克有没有适合动漫迷的城市	{动漫迷=适宜人群, 伊拉克=地区国家}	城市list
不丹有没有适合亲子的城市	{不丹=地区国家, 亲子=适宜人群}	城市list
巴基斯坦有没有适合动漫迷的城市	{动漫迷=适宜人群, 巴基斯坦=地区国家}	城市list
斐济有没有适合亲子的城市	{斐济=地区国家, 亲子=适宜人群}	城市list
爱尔兰有没有适合情侣的城市	{情侣=适宜人群, 爱尔兰=地区国家}	城市list
阿联酋有没有适合动漫迷的城市	{动漫迷=适宜人群, 阿联酋=地区国家}	城市list
澳大利亚有没有适合亲子的城市	{亲子=适宜人群, 澳大利亚=地区国家}	城市list
东南亚有没有适合情侣的城市	{东南亚=地区国家, 情侣=适宜人群}	城市list
泰国有没有适合亲子的城市	{泰国=地区国家, 亲子=适宜人群}	城市list
捷克有没有适合情侣的城市	{情侣=适宜人群, 捷克=地区国家}	城市list
法属波利尼西亚有没有适合亲子的城市	{亲子=适宜人群, 法属波利尼西亚=地区国家}	城市list
塞舌尔有没有适合情侣的城市	{情侣=适宜人群, 塞舌尔=地区国家}	城市list
南非有没有适合情侣的城市	{情侣=适宜人群, 南非=地区国家}	城市list
阿根廷有没有适合亲子的城市	{亲子=适宜人群, 阿根廷=地区国家}	城市list
老挝有没有适合亲子的城市	{老挝=地区国家, 亲子=适宜人群}	城市list
欧洲有没有适合情侣的城市	{情侣=适宜人群, 欧洲=地区国家}	城市list
南美有没有适合情侣的城市	{情侣=适宜人群, 南美=地区国家}	城市list
柬埔寨有没有适合动漫迷的城市	{动漫迷=适宜人群, 柬埔寨=地区国家}	城市list
德国有没有适合动漫迷的城市	{动漫迷=适宜人群, 德国=地区国家}	城市list
塞舌尔有没有适合亲子的城市	{亲子=适宜人群, 塞舌尔=地区国家}	城市list
加拿大有没有适合动漫迷的城市	{动漫迷=适宜人群, 加拿大=地区国家}	城市list
瑞士有没有适合动漫迷的城市	{动漫迷=适宜人群, 瑞士=地区国家}	城市list
英国有没有适合情侣的城市	{情侣=适宜人群, 英国=地区国家}	城市list
奥地利有没有适合亲子的城市	{奥地利=地区国家, 亲子=适宜人群}	城市list
马来西亚有没有适合情侣的城市	{情侣=适宜人群, 马来西亚=地区国家}	城市list
土耳其有没有适合情侣的城市	{情侣=适宜人群, 土耳其=地区国家}	城市list
越南有没有适合动漫迷的城市	{动漫迷=适宜人群, 越南=地区国家}	城市list
挪威有没有适合情侣的城市	{情侣=适宜人群, 挪威=地区国家}	城市list
以色列有没有适合情侣的城市	{以色列=地区国家, 情侣=适宜人群}	城市list
越南有没有适合情侣的城市	{情侣=适宜人群, 越南=地区国家}	城市list
比利时有没有适合亲子的城市	{亲子=适宜人群, 比利时=地区国家}	城市list
意大利有没有适合情侣的城市	{情侣=适宜人群, 意大利=地区国家}	城市list
大溪地有没有适合动漫迷的城市	{动漫迷=适宜人群, 大溪地=地区国家}	城市list
冰岛有没有适合亲子的城市	{冰岛=地区国家, 亲子=适宜人群}	城市list
孟加拉国有没有适合情侣的城市	{情侣=适宜人群, 孟加拉国=地区国家}	城市list
巴西有没有适合情侣的城市	{巴西=地区国家, 情侣=适宜人群}	城市list
英国有没有适合亲子的城市	{亲子=适宜人群, 英国=地区国家}	城市list
阿联酋有没有适合亲子的城市	{阿联酋=地区国家, 亲子=适宜人群}	城市list
肯尼亚有没有适合动漫迷的城市	{动漫迷=适宜人群, 肯尼亚=地区国家}	城市list
所罗门群岛有没有适合动漫迷的城市	{动漫迷=适宜人群, 所罗门群岛=地区国家}	城市list
奥地利有没有适合情侣的城市	{情侣=适宜人群, 奥地利=地区国家}	城市list
毛里求斯有没有适合情侣的城市	{情侣=适宜人群, 毛里求斯=地区国家}	城市list
美国有没有适合动漫迷的城市	{美国=地区国家, 动漫迷=适宜人群}	城市list
匈牙利有没有适合亲子的城市	{亲子=适宜人群, 匈牙利=地区国家}	城市list
库克群岛有没有适合情侣的城市	{库克群岛=地区国家, 情侣=适宜人群}	城市list
卡塔尔有没有适合情侣的城市	{情侣=适宜人群, 卡塔尔=地区国家}	城市list
巴哈马有没有适合动漫迷的城市	{动漫迷=适宜人群, 巴哈马=地区国家}	城市list
韩国有没有适合动漫迷的城市	{动漫迷=适宜人群, 韩国=地区国家}	城市list
阿根廷有没有适合动漫迷的城市	{动漫迷=适宜人群, 阿根廷=地区国家}	城市list
埃及有没有适合动漫迷的城市	{动漫迷=适宜人群, 埃及=地区国家}	城市list
缅甸有没有适合情侣的城市	{情侣=适宜人群, 缅甸=地区国家}	城市list
葡萄牙有没有适合亲子的城市	{葡萄牙=地区国家, 亲子=适宜人群}	城市list
菲律宾有没有适合动漫迷的城市	{动漫迷=适宜人群, 菲律宾=地区国家}	城市list
澳大利亚有没有适合动漫迷的城市	{动漫迷=适宜人群, 澳大利亚=地区国家}	城市list
巴布亚新几内亚有没有适合动漫迷的城市	{动漫迷=适宜人群, 巴布亚新几内亚=地区国家}	城市list
帕劳有没有适合动漫迷的城市	{动漫迷=适宜人群, 帕劳=地区国家}	城市list
马来西亚有没有适合动漫迷的城市	{动漫迷=适宜人群, 马来西亚=地区国家}	城市list
马尔代夫有没有适合动漫迷的城市	{动漫迷=适宜人群, 马尔代夫=地区国家}	城市list
印度尼西亚有没有适合动漫迷的城市	{动漫迷=适宜人群, 印度尼西亚=地区国家}	城市list
日本有没有适合情侣的城市	{情侣=适宜人群, 日本=地区国家}	城市list
大溪地有没有适合亲子的城市	{大溪地=地区国家, 亲子=适宜人群}	城市list
沙特有没有适合动漫迷的城市	{动漫迷=适宜人群, 沙特=地区国家}	城市list
中国有没有适合动漫迷的城市	{动漫迷=适宜人群, 中国=地区国家}	城市list
巴基斯坦有没有适合亲子的城市	{巴基斯坦=地区国家, 亲子=适宜人群}	城市list
伊朗有没有适合亲子的城市	{伊朗=地区国家, 亲子=适宜人群}	城市list
巴布亚新几内亚有没有适合亲子的城市	{亲子=适宜人群, 巴布亚新几内亚=地区国家}	城市list
哥伦比亚有没有适合亲子的城市	{亲子=适宜人群, 哥伦比亚=地区国家}	城市list
韩国有没有适合亲子的城市	{韩国=地区国家, 亲子=适宜人群}	城市list
欧洲有没有适合动漫迷的城市	{动漫迷=适宜人群, 欧洲=地区国家}	城市list
俄罗斯有没有适合情侣的城市	{情侣=适宜人群, 俄罗斯=地区国家}	城市list
肯尼亚有没有适合亲子的城市	{肯尼亚=地区国家, 亲子=适宜人群}	城市list
沙特有没有适合亲子的城市	{亲子=适宜人群, 沙特=地区国家}	城市list
马尔代夫有哪些适合情侣的城市	{情侣=适宜人群, 马尔代夫=地区国家}	城市list
西班牙有哪些适合情侣的城市	{情侣=适宜人群, 西班牙=地区国家}	城市list
巴哈马有哪些适合情侣的城市	{情侣=适宜人群, 巴哈马=地区国家}	城市list
塞舌尔有哪些适合动漫迷的城市	{动漫迷=适宜人群, 塞舌尔=地区国家}	城市list
斐济有哪些适合情侣的城市	{斐济=地区国家, 情侣=适宜人群}	城市list
阿联酋有哪些适合亲子的城市	{阿联酋=地区国家, 亲子=适宜人群}	城市list
埃及有哪些适合亲子的城市	{亲子=适宜人群, 埃及=地区国家}	城市list
秘鲁有哪些适合情侣的城市	{情侣=适宜人群, 秘鲁=地区国家}	城市list
尼泊尔有哪些适合情侣的城市	{尼泊尔=地区国家, 情侣=适宜人群}	城市list
加拿大有哪些适合亲子的城市	{亲子=适宜人群, 加拿大=地区国家}	城市list
卡塔尔有哪些适合动漫迷的城市	{动漫迷=适宜人群, 卡塔尔=地区国家}	城市list
芬兰有哪些适合亲子的城市	{芬兰=地区国家, 亲子=适宜人群}	城市list
塞舌尔有哪些适合情侣的城市	{情侣=适宜人群, 塞舌尔=地区国家}	城市list
巴布亚新几内亚有哪些适合亲子的城市	{亲子=适宜人群, 巴布亚新几内亚=地区国家}	城市list
比利时有哪些适合情侣的城市	{情侣=适宜人群, 比利时=地区国家}	城市list
捷克有哪些适合亲子的城市	{亲子=适宜人群, 捷克=地区国家}	城市list
捷克有哪些适合动漫迷的城市	{动漫迷=适宜人群, 捷克=地区国家}	城市list
奥地利有哪些适合情侣的城市	{情侣=适宜人群, 奥地利=地区国家}	城市list
阿根廷有哪些适合动漫迷的城市	{动漫迷=适宜人群, 阿根廷=地区国家}	城市list
瑞典有哪些适合情侣的城市	{情侣=适宜人群, 瑞典=地区国家}	城市list
葡萄牙有哪些适合动漫迷的城市	{动漫迷=适宜人群, 葡萄牙=地区国家}	城市list
马尔代夫有哪些适合亲子的城市	{马尔代夫=地区国家, 亲子=适宜人群}	城市list
匈牙利有哪些适合亲子的城市	{亲子=适宜人群, 匈牙利=地区国家}	城市list
秘鲁有哪些适合亲子的城市	{秘鲁=地区国家, 亲子=适宜人群}	城市list
意大利有哪些适合动漫迷的城市	{动漫迷=适宜人群, 意大利=地区国家}	城市list
丹麦有哪些适合动漫迷的城市	{动漫迷=适宜人群, 丹麦=地区国家}	城市list
南美有哪些适合情侣的城市	{情侣=适宜人群, 南美=地区国家}	城市list
斐济有哪些适合亲子的城市	{斐济=地区国家, 亲子=适宜人群}	城市list
智利有哪些适合动漫迷的城市	{动漫迷=适宜人群, 智利=地区国家}	城市list
帕劳有哪些适合情侣的城市	{情侣=适宜人群, 帕劳=地区国家}	城市list
以色列有哪些适合亲子的城市	{以色列=地区国家, 亲子=适宜人群}	城市list
马来西亚有哪些适合动漫迷的城市	{动漫迷=适宜人群, 马来西亚=地区国家}	城市list
加拿大有哪些适合动漫迷的城市	{动漫迷=适宜人群, 加拿大=地区国家}	城市list
马来西亚有哪些适合情侣的城市	{情侣=适宜人群, 马来西亚=地区国家}	城市list
马来西亚有哪些适合亲子的城市	{马来西亚=地区国家, 亲子=适宜人群}	城市list
以色列有哪些适合动漫迷的城市	{动漫迷=适宜人群, 以色列=地区国家}	城市list
英国有哪些适合动漫迷的城市	{动漫迷=适宜人群, 英国=地区国家}	城市list
爱尔兰有哪些适合情侣的城市	{情侣=适宜人群, 爱尔兰=地区国家}	城市list
不丹有哪些适合动漫迷的城市	{动漫迷=适宜人群, 不丹=地区国家}	城市list
瑞士有哪些适合亲子的城市	{瑞士=地区国家, 亲子=适宜人群}	城市list
希腊有哪些适合亲子的城市	{希腊=地区国家, 亲子=适宜人群}	城市list
菲律宾有哪些适合动漫迷的城市	{动漫迷=适宜人群, 菲律宾=地区国家}	城市list
埃及有哪些适合情侣的城市	{情侣=适宜人群, 埃及=地区国家}	城市list
哥伦比亚有哪些适合情侣的城市	{情侣=适宜人群, 哥伦比亚=地区国家}	城市list
中国有哪些适合动漫迷的城市	{动漫迷=适宜人群, 中国=地区国家}	城市list
孟加拉国有哪些适合亲子的城市	{亲子=适宜人群, 孟加拉国=地区国家}	城市list
巴布亚新几内亚有哪些适合情侣的城市	{情侣=适宜人群, 巴布亚新几内亚=地区国家}	城市list
阿根廷有哪些适合亲子的城市	{亲子=适宜人群, 阿根廷=地区国家}	城市list
斯里兰卡有哪些适合情侣的城市	{情侣=适宜人群, 斯里兰卡=地区国家}	城市list
越南有哪些适合亲子的城市	{亲子=适宜人群, 越南=地区国家}	城市list
俄罗斯有哪些适合亲子的城市	{俄罗斯=地区国家, 亲子=适宜人群}	城市list
沙特有哪些适合动漫迷的城市	{动漫迷=适宜人群, 沙特=地区国家}	城市list
老挝有哪些适合情侣的城市	{情侣=适宜人群, 老挝=地区国家}	城市list
瑞典有哪些适合亲子的城市	{瑞典=地区国家, 亲子=适宜人群}	城市list
瑞士有哪些适合动漫迷的城市	{动漫迷=适宜人群, 瑞士=地区国家}	城市list
澳大利亚有哪些适合动漫迷的城市	{动漫迷=适宜人群, 澳大利亚=地区国家}	城市list
美国有哪些适合情侣的城市	{美国=地区国家, 情侣=适宜人群}	城市list
巴西有哪些适合亲子的城市	{巴西=地区国家, 亲子=适宜人群}	城市list
泰国有哪些适合动漫迷的城市	{泰国=地区国家, 动漫迷=适宜人群}	城市list
葡萄牙有哪些适合情侣的城市	{情侣=适宜人群, 葡萄牙=地区国家}	城市list
所罗门群岛有哪些适合情侣的城市	{所罗门群岛=地区国家, 情侣=适宜人群}	城市list
老挝有哪些适合动漫迷的城市	{动漫迷=适宜人群, 老挝=地区国家}	城市list
意大利有哪些适合亲子的城市	{意大利=地区国家, 亲子=适宜人群}	城市list
尼泊尔有哪些适合动漫迷的城市	{动漫迷=适宜人群, 尼泊尔=地区国家}	城市list
柬埔寨有哪些适合动漫迷的城市	{动漫迷=适宜人群, 柬埔寨=地区国家}	城市list
日本有哪些适合动漫迷的城市	{动漫迷=适宜人群, 日本=地区国家}	城市list
比利时有哪些适合动漫迷的城市	{动漫迷=适宜人群, 比利时=地区国家}	城市list
冰岛有哪些适合动漫迷的城市	{动漫迷=适宜人群, 冰岛=地区国家}	城市list
亚洲有哪些适合亲子的城市	{亚洲=地区国家, 亲子=适宜人群}	城市list
土耳其有哪些适合动漫迷的城市	{动漫迷=适宜人群, 土耳其=地区国家}	城市list
亚洲有哪些适合动漫迷的城市	{动漫迷=适宜人群, 亚洲=地区国家}	城市list
意大利有哪些适合情侣的城市	{情侣=适宜人群, 意大利=地区国家}	城市list
印度尼西亚有哪些适合情侣的城市	{情侣=适宜人群, 印度尼西亚=地区国家}	城市list
巴布亚新几内亚有哪些适合动漫迷的城市	{动漫迷=适宜人群, 巴布亚新几内亚=地区国家}	城市list
肯尼亚有哪些适合动漫迷的城市	{动漫迷=适宜人群, 肯尼亚=地区国家}	城市list
老挝有哪些适合亲子的城市	{老挝=地区国家, 亲子=适宜人群}	城市list
南非有哪些适合动漫迷的城市	{动漫迷=适宜人群, 南非=地区国家}	城市list
韩国有哪些适合亲子的城市	{韩国=地区国家, 亲子=适宜人群}	城市list
泰国有哪些适合亲子的城市	{泰国=地区国家, 亲子=适宜人群}	城市list
卡塔尔有哪些适合亲子的城市	{卡塔尔=地区国家, 亲子=适宜人群}	城市list
挪威有哪些适合亲子的城市	{亲子=适宜人群, 挪威=地区国家}	城市list
丹麦有哪些适合亲子的城市	{丹麦=地区国家, 亲子=适宜人群}	城市list
智利有哪些适合情侣的城市	{情侣=适宜人群, 智利=地区国家}	城市list
新西兰有哪些适合情侣的城市	{情侣=适宜人群, 新西兰=地区国家}	城市list
美国有哪些适合动漫迷的城市	{美国=地区国家, 动漫迷=适宜人群}	城市list
澳大利亚有哪些适合情侣的城市	{情侣=适宜人群, 澳大利亚=地区国家}	城市list
缅甸有哪些适合情侣的城市	{情侣=适宜人群, 缅甸=地区国家}	城市list
秘鲁有哪些适合动漫迷的城市	{动漫迷=适宜人群, 秘鲁=地区国家}	城市list
奥地利有哪些适合亲子的城市	{奥地利=地区国家, 亲子=适宜人群}	城市list
马尔代夫有哪些适合动漫迷的城市	{动漫迷=适宜人群, 马尔代夫=地区国家}	城市list
巴西有哪些适合情侣的城市	{巴西=地区国家, 情侣=适宜人群}	城市list
瑞士有哪些适合情侣的城市	{情侣=适宜人群, 瑞士=地区国家}	城市list
毛里求斯有哪些适合亲子的城市	{毛里求斯=地区国家, 亲子=适宜人群}	城市list
荷兰有哪些适合动漫迷的城市	{动漫迷=适宜人群, 荷兰=地区国家}	城市list
西班牙有哪些适合亲子的城市	{亲子=适宜人群, 西班牙=地区国家}	城市list
葡萄牙有哪些适合亲子的城市	{葡萄牙=地区国家, 亲子=适宜人群}	城市list
不丹有哪些适合情侣的城市	{情侣=适宜人群, 不丹=地区国家}	城市list
伊拉克有哪些适合动漫迷的城市	{动漫迷=适宜人群, 伊拉克=地区国家}	城市list
印度尼西亚有哪些适合亲子的城市	{亲子=适宜人群, 印度尼西亚=地区国家}	城市list
泰国有哪些适合情侣的城市	{泰国=地区国家, 情侣=适宜人群}	城市list
库克群岛哪些城市适合亲子	{库克群岛=地区国家, 亲子=适宜人群}	城市list
埃及哪些城市适合情侣	{情侣=适宜人群, 埃及=地区国家}	城市list
菲律宾哪些城市适合情侣	{情侣=适宜人群, 菲律宾=地区国家}	城市list
缅甸哪些城市适合动漫迷	{动漫迷=适宜人群, 缅甸=地区国家}	城市list
秘鲁哪些城市适合亲子	{秘鲁=地区国家, 亲子=适宜人群}	城市list
智利哪些城市适合亲子	{智利=地区国家, 亲子=适宜人群}	城市list
韩国哪些城市适合亲子	{韩国=地区国家, 亲子=适宜人群}	城市list
南极洲哪些城市适合情侣	{情侣=适宜人群, 南极洲=地区国家}	城市list
新西兰哪些城市适合动漫迷	{动漫迷=适宜人群, 新西兰=地区国家}	城市list
斐济哪些城市适合动漫迷	{动漫迷=适宜人群, 斐济=地区国家}	城市list
阿根廷哪些城市适合亲子	{亲子=适宜人群, 阿根廷=地区国家}	城市list
斐济哪些城市适合亲子	{斐济=地区国家, 亲子=适宜人群}	城市list
捷克哪些城市适合亲子	{亲子=适宜人群, 捷克=地区国家}	城市list
奥地利哪些城市适合亲子	{奥地利=地区国家, 亲子=适宜人群}	城市list
智利哪些城市适合动漫迷	{动漫迷=适宜人群, 智利=地区国家}	城市list
哥伦比亚哪些城市适合情侣	{情侣=适宜人群, 哥伦比亚=地区国家}	城市list
爱尔兰哪些城市适合亲子	{爱尔兰=地区国家, 亲子=适宜人群}	城市list
秘鲁哪些城市适合动漫迷	{动漫迷=适宜人群, 秘鲁=地区国家}	城市list
意大利哪些城市适合亲子	{意大利=地区国家, 亲子=适宜人群}	城市list
荷兰哪些城市适合动漫迷	{动漫迷=适宜人群, 荷兰=地区国家}	城市list
加拿大哪些城市适合动漫迷	{动漫迷=适宜人群, 加拿大=地区国家}	城市list
帕劳哪些城市适合动漫迷	{动漫迷=适宜人群, 帕劳=地区国家}	城市list
希腊哪些城市适合情侣	{情侣=适宜人群, 希腊=地区国家}	城市list
英国哪些城市适合情侣	{情侣=适宜人群, 英国=地区国家}	城市list
德国哪些城市适合亲子	{亲子=适宜人群, 德国=地区国家}	城市list
库克群岛哪些城市适合动漫迷	{动漫迷=适宜人群, 库克群岛=地区国家}	城市list
挪威哪些城市适合亲子	{亲子=适宜人群, 挪威=地区国家}	城市list
葡萄牙哪些城市适合亲子	{葡萄牙=地区国家, 亲子=适宜人群}	城市list
东南亚哪些城市适合情侣	{东南亚=地区国家, 情侣=适宜人群}	城市list
老挝哪些城市适合动漫迷	{动漫迷=适宜人群, 老挝=地区国家}	城市list
巴布亚新几内亚哪些城市适合亲子	{亲子=适宜人群, 巴布亚新几内亚=地区国家}	城市list
巴哈马哪些城市适合情侣	{情侣=适宜人群, 巴哈马=地区国家}	城市list
法国哪些城市适合亲子	{法国=地区国家, 亲子=适宜人群}	城市list
土耳其哪些城市适合亲子	{土耳其=地区国家, 亲子=适宜人群}	城市list
卡塔尔哪些城市适合情侣	{情侣=适宜人群, 卡塔尔=地区国家}	城市list
斯里兰卡哪些城市适合亲子	{亲子=适宜人群, 斯里兰卡=地区国家}	城市list
毛里求斯哪些城市适合亲子	{毛里求斯=地区国家, 亲子=适宜人群}	城市list
比利时哪些城市适合亲子	{亲子=适宜人群, 比利时=地区国家}	城市list
沙特哪些城市适合动漫迷	{动漫迷=适宜人群, 沙特=地区国家}	城市list
新西兰哪些城市适合亲子	{亲子=适宜人群, 新西兰=地区国家}	城市list
伊朗哪些城市适合亲子	{伊朗=地区国家, 亲子=适宜人群}	城市list
伊朗哪些城市适合动漫迷	{动漫迷=适宜人群, 伊朗=地区国家}	城市list
马尔代夫哪些城市适合动漫迷	{动漫迷=适宜人群, 马尔代夫=地区国家}	城市list
南极洲哪些城市适合亲子	{亲子=适宜人群, 南极洲=地区国家}	城市list
土耳其哪些城市适合情侣	{情侣=适宜人群, 土耳其=地区国家}	城市list
日本哪些城市适合亲子	{亲子=适宜人群, 日本=地区国家}	城市list
阿联酋哪些城市适合动漫迷	{动漫迷=适宜人群, 阿联酋=地区国家}	城市list
希腊哪些城市适合动漫迷	{动漫迷=适宜人群, 希腊=地区国家}	城市list
尼泊尔哪些城市适合动漫迷	{动漫迷=适宜人群, 尼泊尔=地区国家}	城市list
英国哪些城市适合动漫迷	{动漫迷=适宜人群, 英国=地区国家}	城市list
捷克哪些城市适合动漫迷	{动漫迷=适宜人群, 捷克=地区国家}	城市list
柬埔寨哪些城市适合情侣	{柬埔寨=地区国家, 情侣=适宜人群}	城市list
柬埔寨哪些城市适合动漫迷	{动漫迷=适宜人群, 柬埔寨=地区国家}	城市list
中国哪些城市适合情侣	{情侣=适宜人群, 中国=地区国家}	城市list
秘鲁哪些城市适合情侣	{情侣=适宜人群, 秘鲁=地区国家}	城市list
冰岛哪些城市适合情侣	{冰岛=地区国家, 情侣=适宜人群}	城市list
以色列哪些城市适合动漫迷	{动漫迷=适宜人群, 以色列=地区国家}	城市list
巴哈马哪些城市适合动漫迷	{动漫迷=适宜人群, 巴哈马=地区国家}	城市list
美国哪些城市适合亲子	{美国=地区国家, 亲子=适宜人群}	城市list
不丹哪些城市适合动漫迷	{动漫迷=适宜人群, 不丹=地区国家}	城市list
越南哪些城市适合动漫迷	{动漫迷=适宜人群, 越南=地区国家}	城市list
巴哈马哪些城市适合亲子	{巴哈马=地区国家, 亲子=适宜人群}	城市list
塞舌尔哪些城市适合动漫迷	{动漫迷=适宜人群, 塞舌尔=地区国家}	城市list
匈牙利哪些城市适合情侣	{情侣=适宜人群, 匈牙利=地区国家}	城市list
瑞典哪些城市适合动漫迷	{动漫迷=适宜人群, 瑞典=地区国家}	城市list
加拿大哪些城市适合亲子	{亲子=适宜人群, 加拿大=地区国家}	城市list
南非哪些城市适合情侣	{情侣=适宜人群, 南非=地区国家}	城市list
巴西哪些城市适合情侣	{巴西=地区国家, 情侣=适宜人群}	城市list
南非哪些城市适合亲子	{亲子=适宜人群, 南非=地区国家}	城市list
意大利哪些城市适合情侣	{情侣=适宜人群, 意大利=地区国家}	城市list
阿联酋哪些城市适合亲子	{阿联酋=地区国家, 亲子=适宜人群}	城市list
阿根廷哪些城市适合情侣	{情侣=适宜人群, 阿根廷=地区国家}	城市list
沙特哪些城市适合情侣	{情侣=适宜人群, 沙特=地区国家}	城市list
比利时哪些城市适合情侣	{情侣=适宜人群, 比利时=地区国家}	城市list
俄罗斯哪些城市适合情侣	{情侣=适宜人群, 俄罗斯=地区国家}	城市list
肯尼亚哪些城市适合情侣	{情侣=适宜人群, 肯尼亚=地区国家}	城市list
巴西哪些城市适合亲子	{巴西=地区国家, 亲子=适宜人群}	城市list
捷克哪些城市适合情侣	{情侣=适宜人群, 捷克=地区国家}	城市list
南非哪些城市适合动漫迷	{动漫迷=适宜人群, 南非=地区国家}	城市list
哥伦比亚哪些城市适合亲子	{亲子=适宜人群, 哥伦比亚=地区国家}	城市list
瑞士哪些城市适合动漫迷	{动漫迷=适宜人群, 瑞士=地区国家}	城市list
匈牙利哪些城市适合动漫迷	{动漫迷=适宜人群, 匈牙利=地区国家}	城市list
荷兰哪些城市适合亲子	{亲子=适宜人群, 荷兰=地区国家}	城市list
西班牙哪些城市适合亲子	{亲子=适宜人群, 西班牙=地区国家}	城市list
菲律宾哪些城市适合亲子	{亲子=适宜人群, 菲律宾=地区国家}	城市list
欧洲哪些城市适合动漫迷	{动漫迷=适宜人群, 欧洲=地区国家}	城市list
韩国哪些城市适合动漫迷	{动漫迷=适宜人群, 韩国=地区国家}	城市list
尼泊尔哪些城市适合情侣	{尼泊尔=地区国家, 情侣=适宜人群}	城市list
俄罗斯哪些城市适合动漫迷	{动漫迷=适宜人群, 俄罗斯=地区国家}	城市list
越南哪些城市适合亲子	{亲子=适宜人群, 越南=地区国家}	城市list
法国哪些城市适合动漫迷	{动漫迷=适宜人群, 法国=地区国家}	城市list
印度尼西亚哪些城市适合动漫迷	{动漫迷=适宜人群, 印度尼西亚=地区国家}	城市list
沙特哪些城市适合亲子	{亲子=适宜人群, 沙特=地区国家}	城市list
马来西亚哪些城市适合情侣	{情侣=适宜人群, 马来西亚=地区国家}	城市list
马尔代夫哪些城市适合亲子	{马尔代夫=地区国家, 亲子=适宜人群}	城市list
以色列哪些城市适合情侣	{以色列=地区国家, 情侣=适宜人群}	城市list
芬兰哪些城市适合亲子	{芬兰=地区国家, 亲子=适宜人群}	城市list
缅甸哪些城市适合情侣	{情侣=适宜人群, 缅甸=地区国家}	城市list
欧洲哪些城市适合情侣	{情侣=适宜人群, 欧洲=地区国家}	城市list
南极洲哪些城市适合动漫迷	{动漫迷=适宜人群, 南极洲=地区国家}	城市list
美国什么城市适合亲子	{美国=地区国家, 亲子=适宜人群}	城市list
菲律宾什么城市适合亲子	{亲子=适宜人群, 菲律宾=地区国家}	城市list
菲律宾什么城市适合情侣	{情侣=适宜人群, 菲律宾=地区国家}	城市list
美国什么城市适合情侣	{美国=地区国家, 情侣=适宜人群}	城市list
阿根廷什么城市适合亲子	{亲子=适宜人群, 阿根廷=地区国家}	城市list
西班牙什么城市适合亲子	{亲子=适宜人群, 西班牙=地区国家}	城市list
埃及什么城市适合情侣	{情侣=适宜人群, 埃及=地区国家}	城市list
以色列什么城市适合亲子	{以色列=地区国家, 亲子=适宜人群}	城市list
智利什么城市适合动漫迷	{动漫迷=适宜人群, 智利=地区国家}	城市list
希腊什么城市适合动漫迷	{动漫迷=适宜人群, 希腊=地区国家}	城市list
尼泊尔什么城市适合情侣	{尼泊尔=地区国家, 情侣=适宜人群}	城市list
东南亚什么城市适合亲子	{东南亚=地区国家, 亲子=适宜人群}	城市list
帕劳什么城市适合动漫迷	{动漫迷=适宜人群, 帕劳=地区国家}	城市list
沙特什么城市适合动漫迷	{动漫迷=适宜人群, 沙特=地区国家}	城市list
伊朗什么城市适合动漫迷	{动漫迷=适宜人群, 伊朗=地区国家}	城市list
俄罗斯什么城市适合亲子	{俄罗斯=地区国家, 亲子=适宜人群}	城市list
卡塔尔什么城市适合情侣	{情侣=适宜人群, 卡塔尔=地区国家}	城市list
秘鲁什么城市适合情侣	{情侣=适宜人群, 秘鲁=地区国家}	城市list
匈牙利什么城市适合亲子	{亲子=适宜人群, 匈牙利=地区国家}	城市list
南极洲什么城市适合情侣	{情侣=适宜人群, 南极洲=地区国家}	城市list
瑞典什么城市适合亲子	{瑞典=地区国家, 亲子=适宜人群}	城市list
尼泊尔什么城市适合亲子	{尼泊尔=地区国家, 亲子=适宜人群}	城市list
越南什么城市适合亲子	{亲子=适宜人群, 越南=地区国家}	城市list
比利时什么城市适合情侣	{情侣=适宜人群, 比利时=地区国家}	城市list
马来西亚什么城市适合动漫迷	{动漫迷=适宜人群, 马来西亚=地区国家}	城市list
中国什么城市适合动漫迷	{动漫迷=适宜人群, 中国=地区国家}	城市list
大溪地什么城市适合动漫迷	{动漫迷=适宜人群, 大溪地=地区国家}	城市list
缅甸什么城市适合情侣	{情侣=适宜人群, 缅甸=地区国家}	城市list
老挝什么城市适合亲子	{老挝=地区国家, 亲子=适宜人群}	城市list
韩国什么城市适合动漫迷	{动漫迷=适宜人群, 韩国=地区国家}	城市list
土耳其什么城市适合情侣	{情侣=适宜人群, 土耳其=地区国家}	城市list
智利什么城市适合情侣	{情侣=适宜人群, 智利=地区国家}	城市list
丹麦什么城市适合亲子	{丹麦=地区国家, 亲子=适宜人群}	城市list
德国什么城市适合情侣	{情侣=适宜人群, 德国=地区国家}	城市list
泰国什么城市适合情侣	{泰国=地区国家, 情侣=适宜人群}	城市list
毛里求斯什么城市适合亲子	{毛里求斯=地区国家, 亲子=适宜人群}	城市list
马来西亚什么城市适合情侣	{情侣=适宜人群, 马来西亚=地区国家}	城市list
哥伦比亚什么城市适合亲子	{亲子=适宜人群, 哥伦比亚=地区国家}	城市list
芬兰什么城市适合情侣	{情侣=适宜人群, 芬兰=地区国家}	城市list
德国什么城市适合亲子	{亲子=适宜人群, 德国=地区国家}	城市list
阿根廷什么城市适合动漫迷	{动漫迷=适宜人群, 阿根廷=地区国家}	城市list
肯尼亚什么城市适合动漫迷	{动漫迷=适宜人群, 肯尼亚=地区国家}	城市list
印度尼西亚什么城市适合亲子	{亲子=适宜人群, 印度尼西亚=地区国家}	城市list
肯尼亚什么城市适合情侣	{情侣=适宜人群, 肯尼亚=地区国家}	城市list
土耳其什么城市适合动漫迷	{动漫迷=适宜人群, 土耳其=地区国家}	城市list
智利什么城市适合亲子	{智利=地区国家, 亲子=适宜人群}	城市list
柬埔寨什么城市适合亲子	{柬埔寨=地区国家, 亲子=适宜人群}	城市list
法国什么城市适合动漫迷	{动漫迷=适宜人群, 法国=地区国家}	城市list
英国什么城市适合动漫迷	{动漫迷=适宜人群, 英国=地区国家}	城市list
马尔代夫什么城市适合亲子	{马尔代夫=地区国家, 亲子=适宜人群}	城市list
亚洲什么城市适合动漫迷	{动漫迷=适宜人群, 亚洲=地区国家}	城市list
所罗门群岛什么城市适合动漫迷	{动漫迷=适宜人群, 所罗门群岛=地区国家}	城市list
爱尔兰什么城市适合动漫迷	{动漫迷=适宜人群, 爱尔兰=地区国家}	城市list
瑞士什么城市适合情侣	{情侣=适宜人群, 瑞士=地区国家}	城市list
南美什么城市适合情侣	{情侣=适宜人群, 南美=地区国家}	城市list
泰国什么城市适合动漫迷	{泰国=地区国家, 动漫迷=适宜人群}	城市list
瑞典什么城市适合动漫迷	{动漫迷=适宜人群, 瑞典=地区国家}	城市list
丹麦什么城市适合情侣	{情侣=适宜人群, 丹麦=地区国家}	城市list
塞舌尔什么城市适合动漫迷	{动漫迷=适宜人群, 塞舌尔=地区国家}	城市list
意大利什么城市适合亲子	{意大利=地区国家, 亲子=适宜人群}	城市list
老挝什么城市适合动漫迷	{动漫迷=适宜人群, 老挝=地区国家}	城市list
肯尼亚什么城市适合亲子	{肯尼亚=地区国家, 亲子=适宜人群}	城市list
奥地利什么城市适合亲子	{奥地利=地区国家, 亲子=适宜人群}	城市list
埃及什么城市适合动漫迷	{动漫迷=适宜人群, 埃及=地区国家}	城市list
不丹什么城市适合情侣	{情侣=适宜人群, 不丹=地区国家}	城市list
巴基斯坦什么城市适合动漫迷	{动漫迷=适宜人群, 巴基斯坦=地区国家}	城市list
南非什么城市适合动漫迷	{动漫迷=适宜人群, 南非=地区国家}	城市list
中国什么城市适合亲子	{亲子=适宜人群, 中国=地区国家}	城市list
菲律宾什么城市适合动漫迷	{动漫迷=适宜人群, 菲律宾=地区国家}	城市list
匈牙利什么城市适合情侣	{情侣=适宜人群, 匈牙利=地区国家}	城市list
澳大利亚什么城市适合亲子	{亲子=适宜人群, 澳大利亚=地区国家}	城市list
东南亚什么城市适合动漫迷	{东南亚=地区国家, 动漫迷=适宜人群}	城市list
巴西什么城市适合情侣	{巴西=地区国家, 情侣=适宜人群}	城市list
阿根廷什么城市适合情侣	{情侣=适宜人群, 阿根廷=地区国家}	城市list
南美什么城市适合亲子	{亲子=适宜人群, 南美=地区国家}	城市list
加拿大什么城市适合亲子	{亲子=适宜人群, 加拿大=地区国家}	城市list
马尔代夫什么城市适合情侣	{情侣=适宜人群, 马尔代夫=地区国家}	城市list
帕劳什么城市适合亲子	{帕劳=地区国家, 亲子=适宜人群}	城市list
卡塔尔什么城市适合动漫迷	{动漫迷=适宜人群, 卡塔尔=地区国家}	城市list
德国什么城市适合动漫迷	{动漫迷=适宜人群, 德国=地区国家}	城市list
韩国什么城市适合亲子	{韩国=地区国家, 亲子=适宜人群}	城市list
巴西什么城市适合亲子	{巴西=地区国家, 亲子=适宜人群}	城市list
伊拉克什么城市适合亲子	{亲子=适宜人群, 伊拉克=地区国家}	城市list
不丹什么城市适合动漫迷	{动漫迷=适宜人群, 不丹=地区国家}	城市list
大溪地什么城市适合亲子	{大溪地=地区国家, 亲子=适宜人群}	城市list
塞舌尔什么城市适合情侣	{情侣=适宜人群, 塞舌尔=地区国家}	城市list
新西兰什么城市适合亲子	{亲子=适宜人群, 新西兰=地区国家}	城市list
新西兰什么城市适合情侣	{情侣=适宜人群, 新西兰=地区国家}	城市list
捷克什么城市适合动漫迷	{动漫迷=适宜人群, 捷克=地区国家}	城市list
巴布亚新几内亚什么城市适合亲子	{亲子=适宜人群, 巴布亚新几内亚=地区国家}	城市list
加拿大什么城市适合情侣	{情侣=适宜人群, 加拿大=地区国家}	城市list
荷兰什么城市适合亲子	{亲子=适宜人群, 荷兰=地区国家}	城市list
秘鲁什么城市适合动漫迷	{动漫迷=适宜人群, 秘鲁=地区国家}	城市list
英国什么城市适合亲子	{亲子=适宜人群, 英国=地区国家}	城市list
毛里求斯什么城市适合情侣	{情侣=适宜人群, 毛里求斯=地区国家}	城市list
欧洲什么城市适合动漫迷	{动漫迷=适宜人群, 欧洲=地区国家}	城市list
希腊什么城市适合情侣	{情侣=适宜人群, 希腊=地区国家}	城市list
缅甸什么城市适合动漫迷	{动漫迷=适宜人群, 缅甸=地区国家}	城市list
加拿大什么城市适合动漫迷	{动漫迷=适宜人群, 加拿大=地区国家}	城市list
希腊什么城市适合亲子	{希腊=地区国家, 亲子=适宜人群}	城市list
法属波利尼西亚适合亲子的城市	{亲子=适宜人群, 法属波利尼西亚=地区国家}	城市list
秘鲁适合情侣的城市	{情侣=适宜人群, 秘鲁=地区国家}	城市list
日本适合情侣的城市	{情侣=适宜人群, 日本=地区国家}	城市list
伊朗适合情侣的城市	{情侣=适宜人群, 伊朗=地区国家}	城市list
阿联酋适合亲子的城市	{阿联酋=地区国家, 亲子=适宜人群}	城市list
不丹适合情侣的城市	{情侣=适宜人群, 不丹=地区国家}	城市list
南极洲适合情侣的城市	{情侣=适宜人群, 南极洲=地区国家}	城市list
巴布亚新几内亚适合亲子的城市	{亲子=适宜人群, 巴布亚新几内亚=地区国家}	城市list
俄罗斯适合亲子的城市	{俄罗斯=地区国家, 亲子=适宜人群}	城市list
葡萄牙适合情侣的城市	{情侣=适宜人群, 葡萄牙=地区国家}	城市list
新加坡适合动漫迷的城市	{动漫迷=适宜人群, 新加坡=地区国家}	城市list
智利适合亲子的城市	{智利=地区国家, 亲子=适宜人群}	城市list
马尔代夫适合亲子的城市	{马尔代夫=地区国家, 亲子=适宜人群}	城市list
美国适合情侣的城市	{美国=地区国家, 情侣=适宜人群}	城市list
欧洲适合情侣的城市	{情侣=适宜人群, 欧洲=地区国家}	城市list
以色列适合亲子的城市	{以色列=地区国家, 亲子=适宜人群}	城市list
库克群岛适合情侣的城市	{库克群岛=地区国家, 情侣=适宜人群}	城市list
肯尼亚适合亲子的城市	{肯尼亚=地区国家, 亲子=适宜人群}	城市list
泰国适合亲子的城市	{泰国=地区国家, 亲子=适宜人群}	城市list
沙特适合情侣的城市	{情侣=适宜人群, 沙特=地区国家}	城市list
匈牙利适合情侣的城市	{情侣=适宜人群, 匈牙利=地区国家}	城市list
沙特适合动漫迷的城市	{动漫迷=适宜人群, 沙特=地区国家}	城市list
阿根廷适合动漫迷的城市	{动漫迷=适宜人群, 阿根廷=地区国家}	城市list
巴哈马适合亲子的城市	{巴哈马=地区国家, 亲子=适宜人群}	城市list
荷兰适合情侣的城市	{情侣=适宜人群, 荷兰=地区国家}	城市list
中国适合亲子的城市	{亲子=适宜人群, 中国=地区国家}	城市list
所罗门群岛适合动漫迷的城市	{动漫迷=适宜人群, 所罗门群岛=地区国家}	城市list
阿联酋适合动漫迷的城市	{动漫迷=适宜人群, 阿联酋=地区国家}	城市list
大溪地适合亲子的城市	{大溪地=地区国家, 亲子=适宜人群}	城市list
以色列适合情侣的城市	{以色列=地区国家, 情侣=适宜人群}	城市list
新加坡适合亲子的城市	{亲子=适宜人群, 新加坡=地区国家}	城市list
英国适合动漫迷的城市	{动漫迷=适宜人群, 英国=地区国家}	城市list
土耳其适合亲子的城市	{土耳其=地区国家, 亲子=适宜人群}	城市list
奥地利适合情侣的城市	{情侣=适宜人群, 奥地利=地区国家}	城市list
马来西亚适合亲子的城市	{马来西亚=地区国家, 亲子=适宜人群}	城市list
澳大利亚适合情侣的城市	{情侣=适宜人群, 澳大利亚=地区国家}	城市list
埃及适合动漫迷的城市	{动漫迷=适宜人群, 埃及=地区国家}	城市list
泰国适合情侣的城市	{泰国=地区国家, 情侣=适宜人群}	城市list
库克群岛适合动漫迷的城市	{动漫迷=适宜人群, 库克群岛=地区国家}	城市list
瑞士适合动漫迷的城市	{动漫迷=适宜人群, 瑞士=地区国家}	城市list
意大利适合情侣的城市	{情侣=适宜人群, 意大利=地区国家}	城市list
巴布亚新几内亚适合情侣的城市	{情侣=适宜人群, 巴布亚新几内亚=地区国家}	城市list
南非适合动漫迷的城市	{动漫迷=适宜人群, 南非=地区国家}	城市list
所罗门群岛适合亲子的城市	{所罗门群岛=地区国家, 亲子=适宜人群}	城市list
智利适合情侣的城市	{情侣=适宜人群, 智利=地区国家}	城市list
沙特适合亲子的城市	{亲子=适宜人群, 沙特=地区国家}	城市list
伊朗适合动漫迷的城市	{动漫迷=适宜人群, 伊朗=地区国家}	城市list
孟加拉国适合情侣的城市	{情侣=适宜人群, 孟加拉国=地区国家}	城市list
法国适合动漫迷的城市	{动漫迷=适宜人群, 法国=地区国家}	城市list
韩国适合情侣的城市	{情侣=适宜人群, 韩国=地区国家}	城市list
菲律宾适合动漫迷的城市	{动漫迷=适宜人群, 菲律宾=地区国家}	城市list
大溪地适合动漫迷的城市	{动漫迷=适宜人群, 大溪地=地区国家}	城市list
新加坡适合情侣的城市	{情侣=适宜人群, 新加坡=地区国家}	城市list
泰国适合动漫迷的城市	{泰国=地区国家, 动漫迷=适宜人群}	城市list
巴基斯坦适合情侣的城市	{巴基斯坦=地区国家, 情侣=适宜人群}	城市list
秘鲁适合动漫迷的城市	{动漫迷=适宜人群, 秘鲁=地区国家}	城市list
澳大利亚适合动漫迷的城市	{动漫迷=适宜人群, 澳大利亚=地区国家}	城市list
毛里求斯适合动漫迷的城市	{动漫迷=适宜人群, 毛里求斯=地区国家}	城市list
欧洲适合动漫迷的城市	{动漫迷=适宜人群, 欧洲=地区国家}	城市list
日本适合亲子的城市	{亲子=适宜人群, 日本=地区国家}	城市list
马来西亚适合情侣的城市	{情侣=适宜人群, 马来西亚=地区国家}	城市list
新西兰适合亲子的城市	{亲子=适宜人群, 新西兰=地区国家}	城市list
澳大利亚适合亲子的城市	{亲子=适宜人群, 澳大利亚=地区国家}	城市list
埃及适合亲子的城市	{亲子=适宜人群, 埃及=地区国家}	城市list
印度尼西亚适合动漫迷的城市	{动漫迷=适宜人群, 印度尼西亚=地区国家}	城市list
哥伦比亚适合亲子的城市	{亲子=适宜人群, 哥伦比亚=地区国家}	城市list
日本适合动漫迷的城市	{动漫迷=适宜人群, 日本=地区国家}	城市list
捷克适合动漫迷的城市	{动漫迷=适宜人群, 捷克=地区国家}	城市list
俄罗斯适合情侣的城市	{情侣=适宜人群, 俄罗斯=地区国家}	城市list
俄罗斯适合动漫迷的城市	{动漫迷=适宜人群, 俄罗斯=地区国家}	城市list
英国适合亲子的城市	{亲子=适宜人群, 英国=地区国家}	城市list
毛里求斯适合情侣的城市	{情侣=适宜人群, 毛里求斯=地区国家}	城市list
马尔代夫适合动漫迷的城市	{动漫迷=适宜人群, 马尔代夫=地区国家}	城市list
比利时适合亲子的城市	{亲子=适宜人群, 比利时=地区国家}	城市list
土耳其适合情侣的城市	{情侣=适宜人群, 土耳其=地区国家}	城市list
南非适合亲子的城市	{亲子=适宜人群, 南非=地区国家}	城市list
南美适合亲子的城市	{亲子=适宜人群, 南美=地区国家}	城市list
冰岛适合情侣的城市	{冰岛=地区国家, 情侣=适宜人群}	城市list
越南适合亲子的城市	{亲子=适宜人群, 越南=地区国家}	城市list
哥伦比亚适合情侣的城市	{情侣=适宜人群, 哥伦比亚=地区国家}	城市list
韩国适合动漫迷的城市	{动漫迷=适宜人群, 韩国=地区国家}	城市list
斯里兰卡适合情侣的城市	{情侣=适宜人群, 斯里兰卡=地区国家}	城市list
亚洲适合动漫迷的城市	{动漫迷=适宜人群, 亚洲=地区国家}	城市list
爱尔兰适合动漫迷的城市	{动漫迷=适宜人群, 爱尔兰=地区国家}	城市list
菲律宾适合亲子的城市	{亲子=适宜人群, 菲律宾=地区国家}	城市list
德国适合动漫迷的城市	{动漫迷=适宜人群, 德国=地区国家}	城市list
芬兰适合情侣的城市	{情侣=适宜人群, 芬兰=地区国家}	城市list
巴基斯坦适合亲子的城市	{巴基斯坦=地区国家, 亲子=适宜人群}	城市list
不丹适合动漫迷的城市	{动漫迷=适宜人群, 不丹=地区国家}	城市list
比利时适合情侣的城市	{情侣=适宜人群, 比利时=地区国家}	城市list
秘鲁适合亲子的城市	{秘鲁=地区国家, 亲子=适宜人群}	城市list
土耳其适合动漫迷的城市	{动漫迷=适宜人群, 土耳其=地区国家}	城市list
西班牙适合亲子的城市	{亲子=适宜人群, 西班牙=地区国家}	城市list
阿根廷适合亲子的城市	{亲子=适宜人群, 阿根廷=地区国家}	城市list
芬兰适合动漫迷的城市	{动漫迷=适宜人群, 芬兰=地区国家}	城市list
柬埔寨适合亲子的城市	{柬埔寨=地区国家, 亲子=适宜人群}	城市list
西班牙适合动漫迷的城市	{动漫迷=适宜人群, 西班牙=地区国家}	城市list
孟加拉国适合亲子的城市	{亲子=适宜人群, 孟加拉国=地区国家}	城市list
法属波利尼西亚适合动漫迷的城市	{动漫迷=适宜人群, 法属波利尼西亚=地区国家}	城市list
美国适合动漫迷的城市	{美国=地区国家, 动漫迷=适宜人群}	城市list
匈牙利有什么适合情侣去玩的城市	{情侣=适宜人群, 匈牙利=地区国家}	城市list
以色列有什么适合情侣去玩的城市	{以色列=地区国家, 情侣=适宜人群}	城市list
所罗门群岛有什么适合动漫迷去玩的城市	{动漫迷=适宜人群, 所罗门群岛=地区国家}	城市list
秘鲁有什么适合亲子去玩的城市	{秘鲁=地区国家, 亲子=适宜人群}	城市list
塞舌尔有什么适合动漫迷去玩的城市	{动漫迷=适宜人群, 塞舌尔=地区国家}	城市list
法国有什么适合亲子去玩的城市	{法国=地区国家, 亲子=适宜人群}	城市list
挪威有什么适合动漫迷去玩的城市	{动漫迷=适宜人群, 挪威=地区国家}	城市list
南非有什么适合情侣去玩的城市	{情侣=适宜人群, 南非=地区国家}	城市list
巴基斯坦有什么适合亲子去玩的城市	{巴基斯坦=地区国家, 亲子=适宜人群}	城市list
土耳其有什么适合亲子去玩的城市	{土耳其=地区国家, 亲子=适宜人群}	城市list
以色列有什么适合动漫迷去玩的城市	{动漫迷=适宜人群, 以色列=地区国家}	城市list
库克群岛有什么适合情侣去玩的城市	{库克群岛=地区国家, 情侣=适宜人群}	城市list
帕劳有什么适合情侣去玩的城市	{情侣=适宜人群, 帕劳=地区国家}	城市list
丹麦有什么适合情侣去玩的城市	{情侣=适宜人群, 丹麦=地区国家}	城市list
塞舌尔有什么适合亲子去玩的城市	{亲子=适宜人群, 塞舌尔=地区国家}	城市list
巴基斯坦有什么适合情侣去玩的城市	{巴基斯坦=地区国家, 情侣=适宜人群}	城市list
法属波利尼西亚有什么适合情侣去玩的城市	{情侣=适宜人群, 法属波利尼西亚=地区国家}	城市list
南极洲有什么适合动漫迷去玩的城市	{动漫迷=适宜人群, 南极洲=地区国家}	城市list
英国有什么适合动漫迷去玩的城市	{动漫迷=适宜人群, 英国=地区国家}	城市list
哥伦比亚有什么适合动漫迷去玩的城市	{动漫迷=适宜人群, 哥伦比亚=地区国家}	城市list
阿联酋有什么适合动漫迷去玩的城市	{动漫迷=适宜人群, 阿联酋=地区国家}	城市list
泰国有什么适合亲子去玩的城市	{泰国=地区国家, 亲子=适宜人群}	城市list
帕劳有什么适合动漫迷去玩的城市	{动漫迷=适宜人群, 帕劳=地区国家}	城市list
法国有什么适合情侣去玩的城市	{情侣=适宜人群, 法国=地区国家}	城市list
希腊有什么适合动漫迷去玩的城市	{动漫迷=适宜人群, 希腊=地区国家}	城市list
不丹有什么适合亲子去玩的城市	{不丹=地区国家, 亲子=适宜人群}	城市list
韩国有什么适合亲子去玩的城市	{韩国=地区国家, 亲子=适宜人群}	城市list
哥伦比亚有什么适合亲子去玩的城市	{亲子=适宜人群, 哥伦比亚=地区国家}	城市list
尼泊尔有什么适合亲子去玩的城市	{尼泊尔=地区国家, 亲子=适宜人群}	城市list
伊拉克有什么适合亲子去玩的城市	{亲子=适宜人群, 伊拉克=地区国家}	城市list
斯里兰卡有什么适合亲子去玩的城市	{亲子=适宜人群, 斯里兰卡=地区国家}	城市list
埃及有什么适合亲子去玩的城市	{亲子=适宜人群, 埃及=地区国家}	城市list
南非有什么适合动漫迷去玩的城市	{动漫迷=适宜人群, 南非=地区国家}	城市list
斯里兰卡有什么适合动漫迷去玩的城市	{动漫迷=适宜人群, 斯里兰卡=地区国家}	城市list
老挝有什么适合亲子去玩的城市	{老挝=地区国家, 亲子=适宜人群}	城市list
葡萄牙有什么适合情侣去玩的城市	{情侣=适宜人群, 葡萄牙=地区国家}	城市list
印度尼西亚有什么适合情侣去玩的城市	{情侣=适宜人群, 印度尼西亚=地区国家}	城市list
东南亚有什么适合情侣去玩的城市	{东南亚=地区国家, 情侣=适宜人群}	城市list
卡塔尔有什么适合动漫迷去玩的城市	{动漫迷=适宜人群, 卡塔尔=地区国家}	城市list
新西兰有什么适合亲子去玩的城市	{亲子=适宜人群, 新西兰=地区国家}	城市list
沙特有什么适合亲子去玩的城市	{亲子=适宜人群, 沙特=地区国家}	城市list
芬兰有什么适合情侣去玩的城市	{情侣=适宜人群, 芬兰=地区国家}	城市list
中国有什么适合亲子去玩的城市	{亲子=适宜人群, 中国=地区国家}	城市list
马来西亚有什么适合情侣去玩的城市	{情侣=适宜人群, 马来西亚=地区国家}	城市list
南美有什么适合情侣去玩的城市	{情侣=适宜人群, 南美=地区国家}	城市list
挪威有什么适合亲子去玩的城市	{亲子=适宜人群, 挪威=地区国家}	城市list
欧洲有什么适合亲子去玩的城市	{欧洲=地区国家, 亲子=适宜人群}	城市list
巴布亚新几内亚有什么适合情侣去玩的城市	{情侣=适宜人群, 巴布亚新几内亚=地区国家}	城市list
泰国有什么适合情侣去玩的城市	{泰国=地区国家, 情侣=适宜人群}	城市list
秘鲁有什么适合情侣去玩的城市	{情侣=适宜人群, 秘鲁=地区国家}	城市list
所罗门群岛有什么适合亲子去玩的城市	{所罗门群岛=地区国家, 亲子=适宜人群}	城市list
埃及有什么适合情侣去玩的城市	{情侣=适宜人群, 埃及=地区国家}	城市list
越南有什么适合情侣去玩的城市	{情侣=适宜人群, 越南=地区国家}	城市list
马来西亚有什么适合动漫迷去玩的城市	{动漫迷=适宜人群, 马来西亚=地区国家}	城市list
俄罗斯有什么适合动漫迷去玩的城市	{动漫迷=适宜人群, 俄罗斯=地区国家}	城市list
巴布亚新几内亚有什么适合亲子去玩的城市	{亲子=适宜人群, 巴布亚新几内亚=地区国家}	城市list
缅甸有什么适合动漫迷去玩的城市	{动漫迷=适宜人群, 缅甸=地区国家}	城市list
埃及有什么适合动漫迷去玩的城市	{动漫迷=适宜人群, 埃及=地区国家}	城市list
马尔代夫有什么适合情侣去玩的城市	{情侣=适宜人群, 马尔代夫=地区国家}	城市list
韩国有什么适合情侣去玩的城市	{情侣=适宜人群, 韩国=地区国家}	城市list
意大利有什么适合情侣去玩的城市	{情侣=适宜人群, 意大利=地区国家}	城市list
荷兰有什么适合动漫迷去玩的城市	{动漫迷=适宜人群, 荷兰=地区国家}	城市list
阿根廷有什么适合亲子去玩的城市	{亲子=适宜人群, 阿根廷=地区国家}	城市list
意大利有什么适合亲子去玩的城市	{意大利=地区国家, 亲子=适宜人群}	城市list
葡萄牙有什么适合动漫迷去玩的城市	{动漫迷=适宜人群, 葡萄牙=地区国家}	城市list
丹麦有什么适合亲子去玩的城市	{丹麦=地区国家, 亲子=适宜人群}	城市list
日本有什么适合情侣去玩的城市	{情侣=适宜人群, 日本=地区国家}	城市list
西班牙有什么适合动漫迷去玩的城市	{动漫迷=适宜人群, 西班牙=地区国家}	城市list
冰岛有什么适合动漫迷去玩的城市	{动漫迷=适宜人群, 冰岛=地区国家}	城市list
南美有什么适合亲子去玩的城市	{亲子=适宜人群, 南美=地区国家}	城市list
智利有什么适合动漫迷去玩的城市	{动漫迷=适宜人群, 智利=地区国家}	城市list
孟加拉国有什么适合亲子去玩的城市	{亲子=适宜人群, 孟加拉国=地区国家}	城市list
日本有什么适合动漫迷去玩的城市	{动漫迷=适宜人群, 日本=地区国家}	城市list
库克群岛有什么适合亲子去玩的城市	{库克群岛=地区国家, 亲子=适宜人群}	城市list
澳大利亚有什么适合动漫迷去玩的城市	{动漫迷=适宜人群, 澳大利亚=地区国家}	城市list
瑞士有什么适合亲子去玩的城市	{瑞士=地区国家, 亲子=适宜人群}	城市list
爱尔兰有什么适合动漫迷去玩的城市	{动漫迷=适宜人群, 爱尔兰=地区国家}	城市list
南非有什么适合亲子去玩的城市	{亲子=适宜人群, 南非=地区国家}	城市list
菲律宾有什么适合动漫迷去玩的城市	{动漫迷=适宜人群, 菲律宾=地区国家}	城市list
新加坡有什么适合动漫迷去玩的城市	{动漫迷=适宜人群, 新加坡=地区国家}	城市list
肯尼亚有什么适合情侣去玩的城市	{情侣=适宜人群, 肯尼亚=地区国家}	城市list
捷克有什么适合动漫迷去玩的城市	{动漫迷=适宜人群, 捷克=地区国家}	城市list
智利有什么适合亲子去玩的城市	{智利=地区国家, 亲子=适宜人群}	城市list
捷克有什么适合亲子去玩的城市	{亲子=适宜人群, 捷克=地区国家}	城市list
马尔代夫有什么适合动漫迷去玩的城市	{动漫迷=适宜人群, 马尔代夫=地区国家}	城市list
俄罗斯有什么适合情侣去玩的城市	{情侣=适宜人群, 俄罗斯=地区国家}	城市list
瑞典有什么适合动漫迷去玩的城市	{动漫迷=适宜人群, 瑞典=地区国家}	城市list
芬兰有什么适合亲子去玩的城市	{芬兰=地区国家, 亲子=适宜人群}	城市list
东南亚有什么适合亲子去玩的城市	{东南亚=地区国家, 亲子=适宜人群}	城市list
毛里求斯有什么适合情侣去玩的城市	{情侣=适宜人群, 毛里求斯=地区国家}	城市list
柬埔寨有什么适合亲子去玩的城市	{柬埔寨=地区国家, 亲子=适宜人群}	城市list
希腊有什么适合亲子去玩的城市	{希腊=地区国家, 亲子=适宜人群}	城市list
中国有什么适合情侣去玩的城市	{情侣=适宜人群, 中国=地区国家}	城市list
巴基斯坦有什么适合动漫迷去玩的城市	{动漫迷=适宜人群, 巴基斯坦=地区国家}	城市list
加拿大有什么适合情侣去玩的城市	{情侣=适宜人群, 加拿大=地区国家}	城市list
瑞士有什么适合情侣去玩的城市	{情侣=适宜人群, 瑞士=地区国家}	城市list
巴哈马有什么适合情侣去玩的城市	{情侣=适宜人群, 巴哈马=地区国家}	城市list
印度尼西亚有什么适合动漫迷去玩的城市	{动漫迷=适宜人群, 印度尼西亚=地区国家}	城市list
秘鲁有什么适合动漫迷去玩的城市	{动漫迷=适宜人群, 秘鲁=地区国家}	城市list
菲律宾有什么适合亲子去玩的城市	{亲子=适宜人群, 菲律宾=地区国家}	城市list
伊拉克适合带孩子去玩的城市	{带孩子=适宜人群相关, 伊拉克=地区国家}	城市list
印度尼西亚适合带孩子去玩的城市	{带孩子=适宜人群相关, 印度尼西亚=地区国家}	城市list
大溪地适合带孩子去玩的城市	{大溪地=地区国家, 带孩子=适宜人群相关}	城市list
日本适合带孩子去玩的城市	{带孩子=适宜人群相关, 日本=地区国家}	城市list
德国适合带孩子去玩的城市	{带孩子=适宜人群相关, 德国=地区国家}	城市list
葡萄牙适合带孩子去玩的城市	{带孩子=适宜人群相关, 葡萄牙=地区国家}	城市list
芬兰适合带孩子去玩的城市	{带孩子=适宜人群相关, 芬兰=地区国家}	城市list
智利适合带孩子去玩的城市	{带孩子=适宜人群相关, 智利=地区国家}	城市list
南美适合带孩子去玩的城市	{带孩子=适宜人群相关, 南美=地区国家}	城市list
亚洲适合带孩子去玩的城市	{亚洲=地区国家, 带孩子=适宜人群相关}	城市list
挪威适合带孩子去玩的城市	{带孩子=适宜人群相关, 挪威=地区国家}	城市list
希腊适合带孩子去玩的城市	{带孩子=适宜人群相关, 希腊=地区国家}	城市list
中国适合带孩子去玩的城市	{带孩子=适宜人群相关, 中国=地区国家}	城市list
新加坡适合带孩子去玩的城市	{带孩子=适宜人群相关, 新加坡=地区国家}	城市list
伊朗适合带孩子去玩的城市	{带孩子=适宜人群相关, 伊朗=地区国家}	城市list
斐济适合带孩子去玩的城市	{带孩子=适宜人群相关, 斐济=地区国家}	城市list
阿根廷适合带孩子去玩的城市	{带孩子=适宜人群相关, 阿根廷=地区国家}	城市list
库克群岛适合带孩子去玩的城市	{库克群岛=地区国家, 带孩子=适宜人群相关}	城市list
俄罗斯适合带孩子去玩的城市	{带孩子=适宜人群相关, 俄罗斯=地区国家}	城市list
塞舌尔适合带孩子去玩的城市	{带孩子=适宜人群相关, 塞舌尔=地区国家}	城市list
以色列适合带孩子去玩的城市	{带孩子=适宜人群相关, 以色列=地区国家}	城市list
埃及适合带孩子去玩的城市	{带孩子=适宜人群相关, 埃及=地区国家}	城市list
巴基斯坦适合带孩子去玩的城市	{巴基斯坦=地区国家, 带孩子=适宜人群相关}	城市list
南非适合带孩子去玩的城市	{带孩子=适宜人群相关, 南非=地区国家}	城市list
美国适合带孩子去玩的城市	{美国=地区国家, 带孩子=适宜人群相关}	城市list
菲律宾适合带孩子去玩的城市	{带孩子=适宜人群相关, 菲律宾=地区国家}	城市list
不丹适合带孩子去玩的城市	{带孩子=适宜人群相关, 不丹=地区国家}	城市list
巴布亚新几内亚适合带孩子去玩的城市	{带孩子=适宜人群相关, 巴布亚新几内亚=地区国家}	城市list
法属波利尼西亚适合带孩子去玩的城市	{带孩子=适宜人群相关, 法属波利尼西亚=地区国家}	城市list
柬埔寨适合带孩子去玩的城市	{柬埔寨=地区国家, 带孩子=适宜人群相关}	城市list
泰国适合带孩子去玩的城市	{泰国=地区国家, 带孩子=适宜人群相关}	城市list
加拿大适合带孩子去玩的城市	{带孩子=适宜人群相关, 加拿大=地区国家}	城市list
法国适合带孩子去玩的城市	{带孩子=适宜人群相关, 法国=地区国家}	城市list
爱尔兰适合带孩子去玩的城市	{带孩子=适宜人群相关, 爱尔兰=地区国家}	城市list
东南亚适合带孩子去玩的城市	{东南亚=地区国家, 带孩子=适宜人群相关}	城市list
肯尼亚适合带孩子去玩的城市	{带孩子=适宜人群相关, 肯尼亚=地区国家}	城市list
沙特适合带孩子去玩的城市	{带孩子=适宜人群相关, 沙特=地区国家}	城市list
意大利适合带孩子去玩的城市	{带孩子=适宜人群相关, 意大利=地区国家}	城市list
匈牙利适合带孩子去玩的城市	{带孩子=适宜人群相关, 匈牙利=地区国家}	城市list
所罗门群岛适合带孩子去玩的城市	{带孩子=适宜人群相关, 所罗门群岛=地区国家}	城市list
阿联酋适合带孩子去玩的城市	{带孩子=适宜人群相关, 阿联酋=地区国家}	城市list
秘鲁适合带孩子去玩的城市	{带孩子=适宜人群相关, 秘鲁=地区国家}	城市list
瑞士适合带孩子去玩的城市	{带孩子=适宜人群相关, 瑞士=地区国家}	城市list
哥伦比亚适合带孩子去玩的城市	{带孩子=适宜人群相关, 哥伦比亚=地区国家}	城市list
马来西亚适合带孩子去玩的城市	{带孩子=适宜人群相关, 马来西亚=地区国家}	城市list
缅甸适合带孩子去玩的城市	{带孩子=适宜人群相关, 缅甸=地区国家}	城市list
奥地利适合带孩子去玩的城市	{带孩子=适宜人群相关, 奥地利=地区国家}	城市list
冰岛适合带孩子去玩的城市	{冰岛=地区国家, 带孩子=适宜人群相关}	城市list
西班牙适合带孩子去玩的城市	{带孩子=适宜人群相关, 西班牙=地区国家}	城市list
库克群岛最热门的3个城市	{库克群岛=地区国家, 3个=head}	热门/城市list
阿根廷最热门的五个城市	{阿根廷=地区国家, 五个=head}	热门/城市list
瑞典最热门的5个城市	{瑞典=地区国家, 5个=head}	热门/城市list
新加坡最热门的3个城市	{3个=head, 新加坡=地区国家}	热门/城市list
肯尼亚最热门的三个城市	{肯尼亚=地区国家, 三个=head}	热门/城市list
秘鲁最热门的五个城市	{秘鲁=地区国家, 五个=head}	热门/城市list
以色列最热门的10个城市	{以色列=地区国家, 10个=head}	热门/城市list
瑞典最热门的十个城市	{十个=head, 瑞典=地区国家}	热门/城市list
肯尼亚最热门的十个城市	{肯尼亚=地区国家, 十个=head}	热门/城市list
巴布亚新几内亚最热门的3个城市	{3个=head, 巴布亚新几内亚=地区国家}	热门/城市list
希腊最热门的五个城市	{希腊=地区国家, 五个=head}	热门/城市list
马尔代夫最热门的5个城市	{马尔代夫=地区国家, 5个=head}	热门/城市list
荷兰最热门的十个城市	{十个=head, 荷兰=地区国家}	热门/城市list
马尔代夫最热门的五个城市	{马尔代夫=地区国家, 五个=head}	热门/城市list
马尔代夫最热门的十个城市	{十个=head, 马尔代夫=地区国家}	热门/城市list
尼泊尔最热门的10个城市	{尼泊尔=地区国家, 10个=head}	热门/城市list
越南最热门的十个城市	{十个=head, 越南=地区国家}	热门/城市list
斯里兰卡最热门的十个城市	{十个=head, 斯里兰卡=地区国家}	热门/城市list
德国最热门的三个城市	{三个=head, 德国=地区国家}	热门/城市list
葡萄牙最热门的3个城市	{葡萄牙=地区国家, 3个=head}	热门/城市list
阿联酋最热门的5个城市	{阿联酋=地区国家, 5个=head}	热门/城市list
日本最热门的5个城市	{5个=head, 日本=地区国家}	热门/城市list
印度尼西亚最热门的10个城市	{10个=head, 印度尼西亚=地区国家}	热门/城市list
荷兰最热门的5个城市	{5个=head, 荷兰=地区国家}	热门/城市list
日本最热门的五个城市	{日本=地区国家, 五个=head}	热门/城市list
土耳其最热门的十个城市	{十个=head, 土耳其=地区国家}	热门/城市list
帕劳最热门的十个城市	{十个=head, 帕劳=地区国家}	热门/城市list
缅甸最热门的五个城市	{缅甸=地区国家, 五个=head}	热门/城市list
冰岛最热门的五个城市	{冰岛=地区国家, 五个=head}	热门/城市list
挪威最热门的五个城市	{挪威=地区国家, 五个=head}	热门/城市list
哥伦比亚最热门的十个城市	{十个=head, 哥伦比亚=地区国家}	热门/城市list
荷兰最热门的五个城市	{荷兰=地区国家, 五个=head}	热门/城市list
芬兰最热门的五个城市	{芬兰=地区国家, 五个=head}	热门/城市list
捷克最热门的五个城市	{捷克=地区国家, 五个=head}	热门/城市list
欧洲最热门的五个城市	{欧洲=地区国家, 五个=head}	热门/城市list
日本最热门的10个城市	{10个=head, 日本=地区国家}	热门/城市list
帕劳最热门的三个城市	{帕劳=地区国家, 三个=head}	热门/城市list
斐济最热门的10个城市	{斐济=地区国家, 10个=head}	热门/城市list
匈牙利最热门的10个城市	{10个=head, 匈牙利=地区国家}	热门/城市list
埃及最热门的十个城市	{十个=head, 埃及=地区国家}	热门/城市list
智利最热门的三个城市	{智利=地区国家, 三个=head}	热门/城市list
美国最热门的5个城市	{美国=地区国家, 5个=head}	热门/城市list
越南最热门的三个城市	{三个=head, 越南=地区国家}	热门/城市list
尼泊尔最热门的三个城市	{尼泊尔=地区国家, 三个=head}	热门/城市list
菲律宾最热门的10个城市	{10个=head, 菲律宾=地区国家}	热门/城市list
马尔代夫最热门的三个城市	{马尔代夫=地区国家, 三个=head}	热门/城市list
南极洲最热门的三个城市	{三个=head, 南极洲=地区国家}	热门/城市list
孟加拉国最热门的10个城市	{10个=head, 孟加拉国=地区国家}	热门/城市list
丹麦最热门的三个城市	{丹麦=地区国家, 三个=head}	热门/城市list
孟加拉国最热门的3个城市	{3个=head, 孟加拉国=地区国家}	热门/城市list
马来西亚最热门的3个城市	{马来西亚=地区国家, 3个=head}	热门/城市list
斐济最热门的十个城市	{斐济=地区国家, 十个=head}	热门/城市list
不丹最热门的5个城市	{不丹=地区国家, 5个=head}	热门/城市list
斐济最热门的5个城市	{斐济=地区国家, 5个=head}	热门/城市list
捷克最热门的10个城市	{捷克=地区国家, 10个=head}	热门/城市list
老挝最热门的三个城市	{老挝=地区国家, 三个=head}	热门/城市list
澳大利亚最热门的五个城市	{澳大利亚=地区国家, 五个=head}	热门/城市list
爱尔兰最热门的3个城市	{爱尔兰=地区国家, 3个=head}	热门/城市list
毛里求斯最热门的三个城市	{毛里求斯=地区国家, 三个=head}	热门/城市list
帕劳最热门的五个城市	{帕劳=地区国家, 五个=head}	热门/城市list
西班牙最热门的三个城市	{三个=head, 西班牙=地区国家}	热门/城市list
瑞典最热门的三个城市	{瑞典=地区国家, 三个=head}	热门/城市list
匈牙利最热门的三个城市	{三个=head, 匈牙利=地区国家}	热门/城市list
希腊最热门的5个城市	{希腊=地区国家, 5个=head}	热门/城市list
斯里兰卡最热门的五个城市	{斯里兰卡=地区国家, 五个=head}	热门/城市list
阿根廷最热门的3个城市	{3个=head, 阿根廷=地区国家}	热门/城市list
孟加拉国最热门的五个城市	{孟加拉国=地区国家, 五个=head}	热门/城市list
东南亚最热门的十个城市	{东南亚=地区国家, 十个=head}	热门/城市list
马来西亚最热门的五个城市	{马来西亚=地区国家, 五个=head}	热门/城市list
爱尔兰最热门的五个城市	{爱尔兰=地区国家, 五个=head}	热门/城市list
菲律宾最热门的五个城市	{菲律宾=地区国家, 五个=head}	热门/城市list
爱尔兰最热门的5个城市	{爱尔兰=地区国家, 5个=head}	热门/城市list
匈牙利最热门的五个城市	{匈牙利=地区国家, 五个=head}	热门/城市list
新加坡最热门的10个城市	{新加坡=地区国家, 10个=head}	热门/城市list
巴哈马最热门的10个城市	{巴哈马=地区国家, 10个=head}	热门/城市list
卡塔尔最热门的10个城市	{卡塔尔=地区国家, 10个=head}	热门/城市list
法属波利尼西亚最热门的5个城市	{5个=head, 法属波利尼西亚=地区国家}	热门/城市list
法属波利尼西亚最热门的五个城市	{法属波利尼西亚=地区国家, 五个=head}	热门/城市list
澳大利亚最热门的5个城市	{5个=head, 澳大利亚=地区国家}	热门/城市list
菲律宾最热门的十个城市	{十个=head, 菲律宾=地区国家}	热门/城市list
法属波利尼西亚最热门的3个城市	{3个=head, 法属波利尼西亚=地区国家}	热门/城市list
美国最热门的五个城市	{美国=地区国家, 五个=head}	热门/城市list
大溪地最热门的3个城市	{大溪地=地区国家, 3个=head}	热门/城市list
帕劳最热门的3个城市	{帕劳=地区国家, 3个=head}	热门/城市list
希腊最热门的十个城市	{十个=head, 希腊=地区国家}	热门/城市list
希腊最热门的10个城市	{希腊=地区国家, 10个=head}	热门/城市list
所罗门群岛最热门的五个城市	{所罗门群岛=地区国家, 五个=head}	热门/城市list
塞舌尔最热门的10个城市	{10个=head, 塞舌尔=地区国家}	热门/城市list
土耳其最热门的10个城市	{土耳其=地区国家, 10个=head}	热门/城市list
巴基斯坦最热门的5个城市	{巴基斯坦=地区国家, 5个=head}	热门/城市list
冰岛最热门的十个城市	{冰岛=地区国家, 十个=head}	热门/城市list
德国最热门的五个城市	{德国=地区国家, 五个=head}	热门/城市list
库克群岛最热门的十个城市	{库克群岛=地区国家, 十个=head}	热门/城市list
加拿大最热门的十个城市	{十个=head, 加拿大=地区国家}	热门/城市list
马来西亚最热门的十个城市	{马来西亚=地区国家, 十个=head}	热门/城市list
印度尼西亚最热门的三个城市	{三个=head, 印度尼西亚=地区国家}	热门/城市list
智利最热门的3个城市	{智利=地区国家, 3个=head}	热门/城市list
匈牙利最热门的5个城市	{5个=head, 匈牙利=地区国家}	热门/城市list
法国最热门的3个城市	{法国=地区国家, 3个=head}	热门/城市list
沙特最热门的5个城市	{5个=head, 沙特=地区国家}	热门/城市list
挪威3个比较热门的城市	{3个=head, 挪威=地区国家}	热门/城市list
马来西亚三个比较热门的城市	{马来西亚=地区国家, 三个=head}	热门/城市list
巴基斯坦三个比较热门的城市	{巴基斯坦=地区国家, 三个=head}	热门/城市list
德国三个比较热门的城市	{三个=head, 德国=地区国家}	热门/城市list
匈牙利三个比较热门的城市	{三个=head, 匈牙利=地区国家}	热门/城市list
不丹十个比较热门的城市	{十个=head, 不丹=地区国家}	热门/城市list
菲律宾十个比较热门的城市	{十个=head, 菲律宾=地区国家}	热门/城市list
哥伦比亚3个比较热门的城市	{3个=head, 哥伦比亚=地区国家}	热门/城市list
哥伦比亚十个比较热门的城市	{十个=head, 哥伦比亚=地区国家}	热门/城市list
法国10个比较热门的城市	{法国=地区国家, 10个=head}	热门/城市list
埃及十个比较热门的城市	{十个=head, 埃及=地区国家}	热门/城市list
埃及三个比较热门的城市	{三个=head, 埃及=地区国家}	热门/城市list
阿根廷十个比较热门的城市	{十个=head, 阿根廷=地区国家}	热门/城市list
沙特五个比较热门的城市	{沙特=地区国家, 五个=head}	热门/城市list
新西兰5个比较热门的城市	{5个=head, 新西兰=地区国家}	热门/城市list
所罗门群岛五个比较热门的城市	{所罗门群岛=地区国家, 五个=head}	热门/城市list
尼泊尔5个比较热门的城市	{尼泊尔=地区国家, 5个=head}	热门/城市list
斐济5个比较热门的城市	{斐济=地区国家, 5个=head}	热门/城市list
阿联酋3个比较热门的城市	{阿联酋=地区国家, 3个=head}	热门/城市list
中国五个比较热门的城市	{中国=地区国家, 五个=head}	热门/城市list
意大利十个比较热门的城市	{十个=head, 意大利=地区国家}	热门/城市list
瑞典10个比较热门的城市	{瑞典=地区国家, 10个=head}	热门/城市list
捷克10个比较热门的城市	{捷克=地区国家, 10个=head}	热门/城市list
阿根廷10个比较热门的城市	{10个=head, 阿根廷=地区国家}	热门/城市list
日本5个比较热门的城市	{5个=head, 日本=地区国家}	热门/城市list
葡萄牙5个比较热门的城市	{5个=head, 葡萄牙=地区国家}	热门/城市list
阿根廷五个比较热门的城市	{阿根廷=地区国家, 五个=head}	热门/城市list
马尔代夫5个比较热门的城市	{马尔代夫=地区国家, 5个=head}	热门/城市list
奥地利三个比较热门的城市	{奥地利=地区国家, 三个=head}	热门/城市list
智利三个比较热门的城市	{智利=地区国家, 三个=head}	热门/城市list
卡塔尔10个比较热门的城市	{卡塔尔=地区国家, 10个=head}	热门/城市list
比利时十个比较热门的城市	{十个=head, 比利时=地区国家}	热门/城市list
韩国10个比较热门的城市	{韩国=地区国家, 10个=head}	热门/城市list
德国十个比较热门的城市	{十个=head, 德国=地区国家}	热门/城市list
斐济十个比较热门的城市	{斐济=地区国家, 十个=head}	热门/城市list
沙特5个比较热门的城市	{5个=head, 沙特=地区国家}	热门/城市list
所罗门群岛三个比较热门的城市	{所罗门群岛=地区国家, 三个=head}	热门/城市list
冰岛10个比较热门的城市	{冰岛=地区国家, 10个=head}	热门/城市list
意大利10个比较热门的城市	{意大利=地区国家, 10个=head}	热门/城市list
瑞士十个比较热门的城市	{瑞士=地区国家, 十个=head}	热门/城市list
西班牙五个比较热门的城市	{西班牙=地区国家, 五个=head}	热门/城市list
芬兰十个比较热门的城市	{十个=head, 芬兰=地区国家}	热门/城市list
孟加拉国5个比较热门的城市	{5个=head, 孟加拉国=地区国家}	热门/城市list
菲律宾3个比较热门的城市	{3个=head, 菲律宾=地区国家}	热门/城市list
冰岛3个比较热门的城市	{冰岛=地区国家, 3个=head}	热门/城市list
爱尔兰10个比较热门的城市	{爱尔兰=地区国家, 10个=head}	热门/城市list
日本三个比较热门的城市	{三个=head, 日本=地区国家}	热门/城市list
沙特10个比较热门的城市	{10个=head, 沙特=地区国家}	热门/城市list
缅甸3个比较热门的城市	{3个=head, 缅甸=地区国家}	热门/城市list
阿联酋5个比较热门的城市	{阿联酋=地区国家, 5个=head}	热门/城市list
法国三个比较热门的城市	{法国=地区国家, 三个=head}	热门/城市list
欧洲3个比较热门的城市	{欧洲=地区国家, 3个=head}	热门/城市list
冰岛三个比较热门的城市	{冰岛=地区国家, 三个=head}	热门/城市list
以色列三个比较热门的城市	{以色列=地区国家, 三个=head}	热门/城市list
英国十个比较热门的城市	{十个=head, 英国=地区国家}	热门/城市list
新加坡3个比较热门的城市	{3个=head, 新加坡=地区国家}	热门/城市list
奥地利10个比较热门的城市	{奥地利=地区国家, 10个=head}	热门/城市list
德国5个比较热门的城市	{5个=head, 德国=地区国家}	热门/城市list
缅甸五个比较热门的城市	{缅甸=地区国家, 五个=head}	热门/城市list
奥地利3个比较热门的城市	{奥地利=地区国家, 3个=head}	热门/城市list
挪威五个比较热门的城市	{挪威=地区国家, 五个=head}	热门/城市list
土耳其10个比较热门的城市	{土耳其=地区国家, 10个=head}	热门/城市list
柬埔寨10个比较热门的城市	{柬埔寨=地区国家, 10个=head}	热门/城市list
美国五个比较热门的城市	{美国=地区国家, 五个=head}	热门/城市list
葡萄牙五个比较热门的城市	{葡萄牙=地区国家, 五个=head}	热门/城市list
毛里求斯五个比较热门的城市	{毛里求斯=地区国家, 五个=head}	热门/城市list
希腊3个比较热门的城市	{希腊=地区国家, 3个=head}	热门/城市list
芬兰10个比较热门的城市	{芬兰=地区国家, 10个=head}	热门/城市list
英国10个比较热门的城市	{10个=head, 英国=地区国家}	热门/城市list
哥伦比亚5个比较热门的城市	{5个=head, 哥伦比亚=地区国家}	热门/城市list
瑞典5个比较热门的城市	{瑞典=地区国家, 5个=head}	热门/城市list
南美十个比较热门的城市	{十个=head, 南美=地区国家}	热门/城市list
南美五个比较热门的城市	{南美=地区国家, 五个=head}	热门/城市list
柬埔寨5个比较热门的城市	{柬埔寨=地区国家, 5个=head}	热门/城市list
俄罗斯5个比较热门的城市	{5个=head, 俄罗斯=地区国家}	热门/城市list
荷兰十个比较热门的城市	{十个=head, 荷兰=地区国家}	热门/城市list
伊拉克5个比较热门的城市	{5个=head, 伊拉克=地区国家}	热门/城市list
以色列五个比较热门的城市	{以色列=地区国家, 五个=head}	热门/城市list
荷兰10个比较热门的城市	{荷兰=地区国家, 10个=head}	热门/城市list
德国3个比较热门的城市	{3个=head, 德国=地区国家}	热门/城市list
哥伦比亚10个比较热门的城市	{哥伦比亚=地区国家, 10个=head}	热门/城市list
不丹5个比较热门的城市	{不丹=地区国家, 5个=head}	热门/城市list
中国三个比较热门的城市	{三个=head, 中国=地区国家}	热门/城市list
马尔代夫3个比较热门的城市	{马尔代夫=地区国家, 3个=head}	热门/城市list
希腊五个比较热门的城市	{希腊=地区国家, 五个=head}	热门/城市list
缅甸5个比较热门的城市	{5个=head, 缅甸=地区国家}	热门/城市list
伊拉克三个比较热门的城市	{伊拉克=地区国家, 三个=head}	热门/城市list
卡塔尔三个比较热门的城市	{卡塔尔=地区国家, 三个=head}	热门/城市list
巴基斯坦5个比较热门的城市	{巴基斯坦=地区国家, 5个=head}	热门/城市list
老挝三个比较热门的城市	{老挝=地区国家, 三个=head}	热门/城市list
西班牙十个比较热门的城市	{十个=head, 西班牙=地区国家}	热门/城市list
比利时5个比较热门的城市	{5个=head, 比利时=地区国家}	热门/城市list
缅甸十个比较热门的城市	{十个=head, 缅甸=地区国家}	热门/城市list
泰国十个比较热门的城市	{泰国=地区国家, 十个=head}	热门/城市list
葡萄牙3个比较热门的城市	{葡萄牙=地区国家, 3个=head}	热门/城市list
美国三个比较热门的城市	{美国=地区国家, 三个=head}	热门/城市list
肯尼亚3个比较热门的城市	{肯尼亚=地区国家, 3个=head}	热门/城市list
法国3个比较热门的城市	{法国=地区国家, 3个=head}	热门/城市list
冰岛十个比较热门的城市	{冰岛=地区国家, 十个=head}	热门/城市list
缅甸10个比较热门的城市	{10个=head, 缅甸=地区国家}	热门/城市list
十个比较热门的芬兰城市	{十个=head, 芬兰=地区国家}	热门/城市list
5个比较热门的缅甸城市	{5个=head, 缅甸=地区国家}	热门/城市list
五个比较热门的瑞典城市	{瑞典=地区国家, 五个=head}	热门/城市list
3个比较热门的东南亚城市	{东南亚=地区国家, 3个=head}	热门/城市list
3个比较热门的加拿大城市	{3个=head, 加拿大=地区国家}	热门/城市list
十个比较热门的捷克城市	{十个=head, 捷克=地区国家}	热门/城市list
10个比较热门的南美城市	{10个=head, 南美=地区国家}	热门/城市list
10个比较热门的匈牙利城市	{10个=head, 匈牙利=地区国家}	热门/城市list
3个比较热门的希腊城市	{希腊=地区国家, 3个=head}	热门/城市list
十个比较热门的沙特城市	{十个=head, 沙特=地区国家}	热门/城市list
5个比较热门的葡萄牙城市	{5个=head, 葡萄牙=地区国家}	热门/城市list
五个比较热门的以色列城市	{以色列=地区国家, 五个=head}	热门/城市list
十个比较热门的瑞士城市	{十个=head, 瑞士=地区国家}	热门/城市list
五个比较热门的澳大利亚城市	{澳大利亚=地区国家, 五个=head}	热门/城市list
5个比较热门的伊朗城市	{伊朗=地区国家, 5个=head}	热门/城市list
五个比较热门的马来西亚城市	{马来西亚=地区国家, 五个=head}	热门/城市list
5个比较热门的加拿大城市	{5个=head, 加拿大=地区国家}	热门/城市list
5个比较热门的芬兰城市	{芬兰=地区国家, 5个=head}	热门/城市list
五个比较热门的南非城市	{南非=地区国家, 五个=head}	热门/城市list
三个比较热门的尼泊尔城市	{尼泊尔=地区国家, 三个=head}	热门/城市list
10个比较热门的瑞典城市	{瑞典=地区国家, 10个=head}	热门/城市list
三个比较热门的冰岛城市	{冰岛=地区国家, 三个=head}	热门/城市list
十个比较热门的伊拉克城市	{十个=head, 伊拉克=地区国家}	热门/城市list
十个比较热门的南极洲城市	{十个=head, 南极洲=地区国家}	热门/城市list
十个比较热门的南美城市	{十个=head, 南美=地区国家}	热门/城市list
五个比较热门的土耳其城市	{土耳其=地区国家, 五个=head}	热门/城市list
五个比较热门的新加坡城市	{新加坡=地区国家, 五个=head}	热门/城市list
10个比较热门的肯尼亚城市	{肯尼亚=地区国家, 10个=head}	热门/城市list
5个比较热门的丹麦城市	{5个=head, 丹麦=地区国家}	热门/城市list
10个比较热门的欧洲城市	{欧洲=地区国家, 10个=head}	热门/城市list
三个比较热门的瑞士城市	{瑞士=地区国家, 三个=head}	热门/城市list
3个比较热门的缅甸城市	{3个=head, 缅甸=地区国家}	热门/城市list
三个比较热门的哥伦比亚城市	{三个=head, 哥伦比亚=地区国家}	热门/城市list
3个比较热门的俄罗斯城市	{3个=head, 俄罗斯=地区国家}	热门/城市list
十个比较热门的冰岛城市	{冰岛=地区国家, 十个=head}	热门/城市list
三个比较热门的库克群岛城市	{库克群岛=地区国家, 三个=head}	热门/城市list
五个比较热门的毛里求斯城市	{毛里求斯=地区国家, 五个=head}	热门/城市list
10个比较热门的俄罗斯城市	{俄罗斯=地区国家, 10个=head}	热门/城市list
5个比较热门的毛里求斯城市	{5个=head, 毛里求斯=地区国家}	热门/城市list
3个比较热门的秘鲁城市	{秘鲁=地区国家, 3个=head}	热门/城市list
五个比较热门的南美城市	{南美=地区国家, 五个=head}	热门/城市list
三个比较热门的智利城市	{智利=地区国家, 三个=head}	热门/城市list
10个比较热门的以色列城市	{以色列=地区国家, 10个=head}	热门/城市list
十个比较热门的俄罗斯城市	{十个=head, 俄罗斯=地区国家}	热门/城市list
十个比较热门的比利时城市	{十个=head, 比利时=地区国家}	热门/城市list
5个比较热门的哥伦比亚城市	{5个=head, 哥伦比亚=地区国家}	热门/城市list
三个比较热门的老挝城市	{老挝=地区国家, 三个=head}	热门/城市list
十个比较热门的意大利城市	{十个=head, 意大利=地区国家}	热门/城市list
十个比较热门的土耳其城市	{十个=head, 土耳其=地区国家}	热门/城市list
十个比较热门的卡塔尔城市	{十个=head, 卡塔尔=地区国家}	热门/城市list
5个比较热门的法国城市	{5个=head, 法国=地区国家}	热门/城市list
十个比较热门的新加坡城市	{十个=head, 新加坡=地区国家}	热门/城市list
5个比较热门的挪威城市	{5个=head, 挪威=地区国家}	热门/城市list
十个比较热门的印度尼西亚城市	{十个=head, 印度尼西亚=地区国家}	热门/城市list
十个比较热门的巴基斯坦城市	{巴基斯坦=地区国家, 十个=head}	热门/城市list
3个比较热门的大溪地城市	{大溪地=地区国家, 3个=head}	热门/城市list
十个比较热门的爱尔兰城市	{十个=head, 爱尔兰=地区国家}	热门/城市list
10个比较热门的孟加拉国城市	{10个=head, 孟加拉国=地区国家}	热门/城市list
五个比较热门的秘鲁城市	{秘鲁=地区国家, 五个=head}	热门/城市list
十个比较热门的瑞典城市	{十个=head, 瑞典=地区国家}	热门/城市list
十个比较热门的柬埔寨城市	{柬埔寨=地区国家, 十个=head}	热门/城市list
10个比较热门的伊朗城市	{伊朗=地区国家, 10个=head}	热门/城市list
10个比较热门的爱尔兰城市	{爱尔兰=地区国家, 10个=head}	热门/城市list
五个比较热门的新西兰城市	{五个=head, 新西兰=地区国家}	热门/城市list
五个比较热门的哥伦比亚城市	{哥伦比亚=地区国家, 五个=head}	热门/城市list
3个比较热门的亚洲城市	{亚洲=地区国家, 3个=head}	热门/城市list
3个比较热门的南极洲城市	{3个=head, 南极洲=地区国家}	热门/城市list
五个比较热门的印度尼西亚城市	{印度尼西亚=地区国家, 五个=head}	热门/城市list
五个比较热门的匈牙利城市	{匈牙利=地区国家, 五个=head}	热门/城市list
3个比较热门的越南城市	{3个=head, 越南=地区国家}	热门/城市list
五个比较热门的大溪地城市	{大溪地=地区国家, 五个=head}	热门/城市list
三个比较热门的秘鲁城市	{秘鲁=地区国家, 三个=head}	热门/城市list
5个比较热门的东南亚城市	{东南亚=地区国家, 5个=head}	热门/城市list
10个比较热门的意大利城市	{意大利=地区国家, 10个=head}	热门/城市list
5个比较热门的印度尼西亚城市	{5个=head, 印度尼西亚=地区国家}	热门/城市list
5个比较热门的土耳其城市	{土耳其=地区国家, 5个=head}	热门/城市list
五个比较热门的葡萄牙城市	{葡萄牙=地区国家, 五个=head}	热门/城市list
三个比较热门的阿根廷城市	{三个=head, 阿根廷=地区国家}	热门/城市list
3个比较热门的伊拉克城市	{3个=head, 伊拉克=地区国家}	热门/城市list
10个比较热门的法属波利尼西亚城市	{法属波利尼西亚=地区国家, 10个=head}	热门/城市list
五个比较热门的斐济城市	{斐济=地区国家, 五个=head}	热门/城市list
五个比较热门的南极洲城市	{南极洲=地区国家, 五个=head}	热门/城市list
5个比较热门的斯里兰卡城市	{5个=head, 斯里兰卡=地区国家}	热门/城市list
10个比较热门的老挝城市	{老挝=地区国家, 10个=head}	热门/城市list
十个比较热门的泰国城市	{泰国=地区国家, 十个=head}	热门/城市list
5个比较热门的瑞士城市	{瑞士=地区国家, 5个=head}	热门/城市list
五个比较热门的捷克城市	{捷克=地区国家, 五个=head}	热门/城市list
三个比较热门的俄罗斯城市	{俄罗斯=地区国家, 三个=head}	热门/城市list
3个比较热门的泰国城市	{泰国=地区国家, 3个=head}	热门/城市list
3个比较热门的马尔代夫城市	{马尔代夫=地区国家, 3个=head}	热门/城市list
十个比较热门的匈牙利城市	{十个=head, 匈牙利=地区国家}	热门/城市list
3个比较热门的比利时城市	{3个=head, 比利时=地区国家}	热门/城市list
3个比较热门的瑞典城市	{瑞典=地区国家, 3个=head}	热门/城市list
五个比较热门的马尔代夫城市	{马尔代夫=地区国家, 五个=head}	热门/城市list
五个比较热门的所罗门群岛城市	{所罗门群岛=地区国家, 五个=head}	热门/城市list
五个比较热门的东南亚城市	{东南亚=地区国家, 五个=head}	热门/城市list
十个比较热门的肯尼亚城市	{十个=head, 肯尼亚=地区国家}	热门/城市list
3个比较热门的芬兰城市	{芬兰=地区国家, 3个=head}	热门/城市list
10个比较热门的芬兰城市	{芬兰=地区国家, 10个=head}	热门/城市list
五个比较热门的缅甸城市	{缅甸=地区国家, 五个=head}	热门/城市list
给我列出三个热门的奥地利城市	{奥地利=地区国家, 三个=head}	热门/城市list
给我列出三个热门的瑞典城市	{瑞典=地区国家, 三个=head}	热门/城市list
给我列出10个热门的葡萄牙城市	{葡萄牙=地区国家, 10个=head}	热门/城市list
给我列出十个热门的塞舌尔城市	{十个=head, 塞舌尔=地区国家}	热门/城市list
给我列出十个热门的尼泊尔城市	{尼泊尔=地区国家, 十个=head}	热门/城市list
给我列出3个热门的以色列城市	{以色列=地区国家, 3个=head}	热门/城市list
给我列出5个热门的韩国城市	{5个=head, 韩国=地区国家}	热门/城市list
给我列出十个热门的丹麦城市	{十个=head, 丹麦=地区国家}	热门/城市list
给我列出五个热门的缅甸城市	{缅甸=地区国家, 五个=head}	热门/城市list
给我列出三个热门的南极洲城市	{三个=head, 南极洲=地区国家}	热门/城市list
给我列出5个热门的所罗门群岛城市	{所罗门群岛=地区国家, 5个=head}	热门/城市list
给我列出三个热门的东南亚城市	{东南亚=地区国家, 三个=head}	热门/城市list
给我列出10个热门的塞舌尔城市	{10个=head, 塞舌尔=地区国家}	热门/城市list
给我列出十个热门的中国城市	{十个=head, 中国=地区国家}	热门/城市list
给我列出三个热门的澳大利亚城市	{三个=head, 澳大利亚=地区国家}	热门/城市list
给我列出五个热门的希腊城市	{希腊=地区国家, 五个=head}	热门/城市list
给我列出十个热门的巴哈马城市	{十个=head, 巴哈马=地区国家}	热门/城市list
给我列出十个热门的哥伦比亚城市	{十个=head, 哥伦比亚=地区国家}	热门/城市list
给我列出3个热门的秘鲁城市	{秘鲁=地区国家, 3个=head}	热门/城市list
给我列出五个热门的巴西城市	{巴西=地区国家, 五个=head}	热门/城市list
给我列出5个热门的亚洲城市	{亚洲=地区国家, 5个=head}	热门/城市list
给我列出10个热门的马尔代夫城市	{马尔代夫=地区国家, 10个=head}	热门/城市list
给我列出10个热门的东南亚城市	{东南亚=地区国家, 10个=head}	热门/城市list
给我列出三个热门的意大利城市	{意大利=地区国家, 三个=head}	热门/城市list
给我列出10个热门的英国城市	{10个=head, 英国=地区国家}	热门/城市list
给我列出三个热门的丹麦城市	{丹麦=地区国家, 三个=head}	热门/城市list
给我列出十个热门的卡塔尔城市	{十个=head, 卡塔尔=地区国家}	热门/城市list
给我列出三个热门的越南城市	{三个=head, 越南=地区国家}	热门/城市list
给我列出十个热门的澳大利亚城市	{十个=head, 澳大利亚=地区国家}	热门/城市list
给我列出五个热门的日本城市	{日本=地区国家, 五个=head}	热门/城市list
给我列出10个热门的孟加拉国城市	{10个=head, 孟加拉国=地区国家}	热门/城市list
给我列出5个热门的瑞士城市	{瑞士=地区国家, 5个=head}	热门/城市list
给我列出三个热门的柬埔寨城市	{柬埔寨=地区国家, 三个=head}	热门/城市list
给我列出10个热门的新加坡城市	{新加坡=地区国家, 10个=head}	热门/城市list
给我列出五个热门的丹麦城市	{丹麦=地区国家, 五个=head}	热门/城市list
给我列出10个热门的亚洲城市	{亚洲=地区国家, 10个=head}	热门/城市list
给我列出三个热门的肯尼亚城市	{肯尼亚=地区国家, 三个=head}	热门/城市list
给我列出十个热门的挪威城市	{十个=head, 挪威=地区国家}	热门/城市list
给我列出5个热门的冰岛城市	{冰岛=地区国家, 5个=head}	热门/城市list
给我列出10个热门的挪威城市	{10个=head, 挪威=地区国家}	热门/城市list
给我列出3个热门的比利时城市	{3个=head, 比利时=地区国家}	热门/城市list
给我列出5个热门的巴基斯坦城市	{巴基斯坦=地区国家, 5个=head}	热门/城市list
给我列出3个热门的柬埔寨城市	{柬埔寨=地区国家, 3个=head}	热门/城市list
给我列出五个热门的比利时城市	{比利时=地区国家, 五个=head}	热门/城市list
给我列出五个热门的不丹城市	{不丹=地区国家, 五个=head}	热门/城市list
给我列出10个热门的帕劳城市	{帕劳=地区国家, 10个=head}	热门/城市list
给我列出3个热门的美国城市	{美国=地区国家, 3个=head}	热门/城市list
给我列出五个热门的加拿大城市	{加拿大=地区国家, 五个=head}	热门/城市list
给我列出五个热门的中国城市	{中国=地区国家, 五个=head}	热门/城市list
给我列出10个热门的韩国城市	{韩国=地区国家, 10个=head}	热门/城市list
给我列出五个热门的葡萄牙城市	{葡萄牙=地区国家, 五个=head}	热门/城市list
给我列出十个热门的奥地利城市	{十个=head, 奥地利=地区国家}	热门/城市list
给我列出十个热门的瑞士城市	{十个=head, 瑞士=地区国家}	热门/城市list
给我列出五个热门的巴基斯坦城市	{巴基斯坦=地区国家, 五个=head}	热门/城市list
给我列出5个热门的柬埔寨城市	{柬埔寨=地区国家, 5个=head}	热门/城市list
给我列出10个热门的巴布亚新几内亚城市	{10个=head, 巴布亚新几内亚=地区国家}	热门/城市list
给我列出十个热门的巴西城市	{巴西=地区国家, 十个=head}	热门/城市list
给我列出10个热门的斯里兰卡城市	{斯里兰卡=地区国家, 10个=head}	热门/城市list
给我列出五个热门的越南城市	{越南=地区国家, 五个=head}	热门/城市list
给我列出3个热门的斐济城市	{斐济=地区国家, 3个=head}	热门/城市list
给我列出10个热门的库克群岛城市	{库克群岛=地区国家, 10个=head}	热门/城市list
给我列出三个热门的韩国城市	{韩国=地区国家, 三个=head}	热门/城市list
给我列出五个热门的芬兰城市	{芬兰=地区国家, 五个=head}	热门/城市list
给我列出五个热门的意大利城市	{意大利=地区国家, 五个=head}	热门/城市list
给我列出3个热门的所罗门群岛城市	{所罗门群岛=地区国家, 3个=head}	热门/城市list
给我列出五个热门的尼泊尔城市	{尼泊尔=地区国家, 五个=head}	热门/城市list
给我列出五个热门的伊朗城市	{伊朗=地区国家, 五个=head}	热门/城市list
给我列出3个热门的帕劳城市	{帕劳=地区国家, 3个=head}	热门/城市list
给我列出3个热门的东南亚城市	{东南亚=地区国家, 3个=head}	热门/城市list
给我列出5个热门的阿根廷城市	{5个=head, 阿根廷=地区国家}	热门/城市list
给我列出5个热门的挪威城市	{5个=head, 挪威=地区国家}	热门/城市list
给我列出十个热门的孟加拉国城市	{十个=head, 孟加拉国=地区国家}	热门/城市list
给我列出十个热门的巴基斯坦城市	{巴基斯坦=地区国家, 十个=head}	热门/城市list
给我列出五个热门的瑞典城市	{瑞典=地区国家, 五个=head}	热门/城市list
给我列出十个热门的阿根廷城市	{十个=head, 阿根廷=地区国家}	热门/城市list
给我列出十个热门的加拿大城市	{十个=head, 加拿大=地区国家}	热门/城市list
给我列出10个热门的爱尔兰城市	{爱尔兰=地区国家, 10个=head}	热门/城市list
给我列出3个热门的土耳其城市	{土耳其=地区国家, 3个=head}	热门/城市list
给我列出三个热门的新西兰城市	{三个=head, 新西兰=地区国家}	热门/城市list
给我列出3个热门的芬兰城市	{芬兰=地区国家, 3个=head}	热门/城市list
给我列出5个热门的越南城市	{5个=head, 越南=地区国家}	热门/城市list
给我列出5个热门的秘鲁城市	{5个=head, 秘鲁=地区国家}	热门/城市list
给我列出三个热门的新加坡城市	{三个=head, 新加坡=地区国家}	热门/城市list
给我列出10个热门的以色列城市	{以色列=地区国家, 10个=head}	热门/城市list
给我列出三个热门的老挝城市	{老挝=地区国家, 三个=head}	热门/城市list
给我列出5个热门的卡塔尔城市	{5个=head, 卡塔尔=地区国家}	热门/城市list
给我列出十个热门的南极洲城市	{十个=head, 南极洲=地区国家}	热门/城市list
给我列出三个热门的哥伦比亚城市	{三个=head, 哥伦比亚=地区国家}	热门/城市list
给我列出三个热门的帕劳城市	{帕劳=地区国家, 三个=head}	热门/城市list
给我列出十个热门的东南亚城市	{东南亚=地区国家, 十个=head}	热门/城市list
给我列出五个热门的柬埔寨城市	{柬埔寨=地区国家, 五个=head}	热门/城市list
给我列出十个热门的伊朗城市	{十个=head, 伊朗=地区国家}	热门/城市list
给我列出5个热门的缅甸城市	{5个=head, 缅甸=地区国家}	热门/城市list
给我列出10个热门的比利时城市	{10个=head, 比利时=地区国家}	热门/城市list
给我列出三个热门的卡塔尔城市	{卡塔尔=地区国家, 三个=head}	热门/城市list
给我列出十个热门的伊拉克城市	{十个=head, 伊拉克=地区国家}	热门/城市list
给我列出五个热门的肯尼亚城市	{肯尼亚=地区国家, 五个=head}	热门/城市list
给我列出3个热门的老挝城市	{老挝=地区国家, 3个=head}	热门/城市list
给我列出十个热门的冰岛城市	{冰岛=地区国家, 十个=head}	热门/城市list
给我列出5个热门的阿联酋城市	{阿联酋=地区国家, 5个=head}	热门/城市list
比较热门的城市	{}	热门/城市list
比较热门的爱尔兰城市	{爱尔兰=地区国家}	热门/城市list
比较热门的捷克城市	{捷克=地区国家}	热门/城市list
比较热门的亚洲城市	{亚洲=地区国家}	热门/城市list
比较热门的印度尼西亚城市	{印度尼西亚=地区国家}	热门/城市list
比较热门的越南城市	{越南=地区国家}	热门/城市list
比较热门的中国城市	{中国=地区国家}	热门/城市list
比较热门的斯里兰卡城市	{斯里兰卡=地区国家}	热门/城市list
比较热门的欧洲城市	{欧洲=地区国家}	热门/城市list
比较热门的美国城市	{美国=地区国家}	热门/城市list
比较热门的老挝城市	{老挝=地区国家}	热门/城市list
比较热门的荷兰城市	{荷兰=地区国家}	热门/城市list
比较热门的塞舌尔城市	{塞舌尔=地区国家}	热门/城市list
比较热门的新加坡城市	{新加坡=地区国家}	热门/城市list
比较热门的比利时城市	{比利时=地区国家}	热门/城市list
比较热门的帕劳城市	{帕劳=地区国家}	热门/城市list
比较热门的意大利城市	{意大利=地区国家}	热门/城市list
比较热门的东南亚城市	{东南亚=地区国家}	热门/城市list
比较热门的以色列城市	{以色列=地区国家}	热门/城市list
比较热门的不丹城市	{不丹=地区国家}	热门/城市list
比较热门的德国城市	{德国=地区国家}	热门/城市list
比较热门的英国城市	{英国=地区国家}	热门/城市list
比较热门的丹麦城市	{丹麦=地区国家}	热门/城市list
比较热门的南极洲城市	{南极洲=地区国家}	热门/城市list
比较热门的埃及城市	{埃及=地区国家}	热门/城市list
比较热门的伊拉克城市	{伊拉克=地区国家}	热门/城市list
比较热门的韩国城市	{韩国=地区国家}	热门/城市list
比较热门的秘鲁城市	{秘鲁=地区国家}	热门/城市list
比较热门的伊朗城市	{伊朗=地区国家}	热门/城市list
比较热门的哥伦比亚城市	{哥伦比亚=地区国家}	热门/城市list
比较热门的所罗门群岛城市	{所罗门群岛=地区国家}	热门/城市list
比较热门的阿联酋城市	{阿联酋=地区国家}	热门/城市list
比较热门的俄罗斯城市	{俄罗斯=地区国家}	热门/城市list
比较热门的奥地利城市	{奥地利=地区国家}	热门/城市list
比较热门的葡萄牙城市	{葡萄牙=地区国家}	热门/城市list
比较热门的智利城市	{智利=地区国家}	热门/城市list
比较热门的日本城市	{日本=地区国家}	热门/城市list
比较热门的冰岛城市	{冰岛=地区国家}	热门/城市list
比较热门的新西兰城市	{新西兰=地区国家}	热门/城市list
比较热门的菲律宾城市	{菲律宾=地区国家}	热门/城市list
比较热门的库克群岛城市	{库克群岛=地区国家}	热门/城市list
比较热门的毛里求斯城市	{毛里求斯=地区国家}	热门/城市list
比较热门的西班牙城市	{西班牙=地区国家}	热门/城市list
比较热门的南美城市	{南美=地区国家}	热门/城市list
比较热门的法属波利尼西亚城市	{法属波利尼西亚=地区国家}	热门/城市list
5个比较热门的城市	{5个=head}	热门/城市list
10个比较热门的城市	{10个=head}	热门/城市list
三个比较热门的城市	{三个=head}	热门/城市list
五个比较热门的城市	{五个=head}	热门/城市list
3个比较热门的城市	{3个=head}	热门/城市list
10个比较热门的加拿大城市	{10个=head, 加拿大=地区国家}	热门/城市list
三个比较热门的欧洲城市	{欧洲=地区国家, 三个=head}	热门/城市list
十个比较热门的葡萄牙城市	{十个=head, 葡萄牙=地区国家}	热门/城市list
五个比较热门的瑞士城市	{瑞士=地区国家, 五个=head}	热门/城市list
三个比较热门的冰岛城市	{冰岛=地区国家, 三个=head}	热门/城市list
10个比较热门的美国城市	{美国=地区国家, 10个=head}	热门/城市list
十个比较热门的德国城市	{十个=head, 德国=地区国家}	热门/城市list
3个比较热门的冰岛城市	{冰岛=地区国家, 3个=head}	热门/城市list
十个比较热门的智利城市	{十个=head, 智利=地区国家}	热门/城市list
5个比较热门的韩国城市	{5个=head, 韩国=地区国家}	热门/城市list
十个比较热门的斐济城市	{斐济=地区国家, 十个=head}	热门/城市list
三个比较热门的斐济城市	{斐济=地区国家, 三个=head}	热门/城市list
五个比较热门的南极洲城市	{南极洲=地区国家, 五个=head}	热门/城市list
五个比较热门的阿联酋城市	{阿联酋=地区国家, 五个=head}	热门/城市list
十个比较热门的丹麦城市	{十个=head, 丹麦=地区国家}	热门/城市list
10个比较热门的土耳其城市	{土耳其=地区国家, 10个=head}	热门/城市list
3个比较热门的卡塔尔城市	{卡塔尔=地区国家, 3个=head}	热门/城市list
5个比较热门的帕劳城市	{5个=head, 帕劳=地区国家}	热门/城市list
3个比较热门的挪威城市	{3个=head, 挪威=地区国家}	热门/城市list
五个比较热门的南非城市	{南非=地区国家, 五个=head}	热门/城市list
5个比较热门的马来西亚城市	{马来西亚=地区国家, 5个=head}	热门/城市list
五个比较热门的孟加拉国城市	{孟加拉国=地区国家, 五个=head}	热门/城市list
十个比较热门的肯尼亚城市	{十个=head, 肯尼亚=地区国家}	热门/城市list
十个比较热门的南非城市	{十个=head, 南非=地区国家}	热门/城市list
三个比较热门的塞舌尔城市	{三个=head, 塞舌尔=地区国家}	热门/城市list
10个比较热门的塞舌尔城市	{10个=head, 塞舌尔=地区国家}	热门/城市list
3个比较热门的南非城市	{3个=head, 南非=地区国家}	热门/城市list
10个比较热门的挪威城市	{10个=head, 挪威=地区国家}	热门/城市list
三个比较热门的巴布亚新几内亚城市	{三个=head, 巴布亚新几内亚=地区国家}	热门/城市list
三个比较热门的东南亚城市	{东南亚=地区国家, 三个=head}	热门/城市list
三个比较热门的西班牙城市	{三个=head, 西班牙=地区国家}	热门/城市list
3个比较热门的丹麦城市	{3个=head, 丹麦=地区国家}	热门/城市list
10个比较热门的法国城市	{法国=地区国家, 10个=head}	热门/城市list
10个比较热门的荷兰城市	{荷兰=地区国家, 10个=head}	热门/城市list
10个比较热门的欧洲城市	{欧洲=地区国家, 10个=head}	热门/城市list
5个比较热门的泰国城市	{泰国=地区国家, 5个=head}	热门/城市list
五个比较热门的土耳其城市	{土耳其=地区国家, 五个=head}	热门/城市list
十个比较热门的巴哈马城市	{十个=head, 巴哈马=地区国家}	热门/城市list
5个比较热门的丹麦城市	{5个=head, 丹麦=地区国家}	热门/城市list
5个比较热门的土耳其城市	{土耳其=地区国家, 5个=head}	热门/城市list
十个比较热门的伊朗城市	{十个=head, 伊朗=地区国家}	热门/城市list
三个比较热门的柬埔寨城市	{柬埔寨=地区国家, 三个=head}	热门/城市list
五个比较热门的埃及城市	{埃及=地区国家, 五个=head}	热门/城市list
五个比较热门的斐济城市	{斐济=地区国家, 五个=head}	热门/城市list
3个比较热门的巴西城市	{巴西=地区国家, 3个=head}	热门/城市list
3个比较热门的巴布亚新几内亚城市	{3个=head, 巴布亚新几内亚=地区国家}	热门/城市list
三个比较热门的韩国城市	{韩国=地区国家, 三个=head}	热门/城市list
5个比较热门的阿根廷城市	{5个=head, 阿根廷=地区国家}	热门/城市list
十个比较热门的捷克城市	{十个=head, 捷克=地区国家}	热门/城市list
五个比较热门的马尔代夫城市	{马尔代夫=地区国家, 五个=head}	热门/城市list
5个比较热门的缅甸城市	{5个=head, 缅甸=地区国家}	热门/城市list
10个比较热门的意大利城市	{意大利=地区国家, 10个=head}	热门/城市list
十个比较热门的南极洲城市	{十个=head, 南极洲=地区国家}	热门/城市list
10个比较热门的菲律宾城市	{10个=head, 菲律宾=地区国家}	热门/城市list
10个比较热门的爱尔兰城市	{爱尔兰=地区国家, 10个=head}	热门/城市list
十个比较热门的俄罗斯城市	{十个=head, 俄罗斯=地区国家}	热门/城市list
10个比较热门的巴布亚新几内亚城市	{10个=head, 巴布亚新几内亚=地区国家}	热门/城市list
3个比较热门的阿联酋城市	{阿联酋=地区国家, 3个=head}	热门/城市list
3个比较热门的俄罗斯城市	{3个=head, 俄罗斯=地区国家}	热门/城市list
十个比较热门的巴布亚新几内亚城市	{十个=head, 巴布亚新几内亚=地区国家}	热门/城市list
5个比较热门的日本城市	{5个=head, 日本=地区国家}	热门/城市list
十个比较热门的芬兰城市	{十个=head, 芬兰=地区国家}	热门/城市list
五个比较热门的希腊城市	{希腊=地区国家, 五个=head}	热门/城市list
5个比较热门的尼泊尔城市	{尼泊尔=地区国家, 5个=head}	热门/城市list
10个比较热门的南极洲城市	{10个=head, 南极洲=地区国家}	热门/城市list
五个比较热门的冰岛城市	{冰岛=地区国家, 五个=head}	热门/城市list
十个比较热门的瑞士城市	{十个=head, 瑞士=地区国家}	热门/城市list
十个比较热门的库克群岛城市	{库克群岛=地区国家, 十个=head}	热门/城市list
3个比较热门的斐济城市	{斐济=地区国家, 3个=head}	热门/城市list
三个比较热门的法属波利尼西亚城市	{三个=head, 法属波利尼西亚=地区国家}	热门/城市list
3个比较热门的匈牙利城市	{3个=head, 匈牙利=地区国家}	热门/城市list
10个比较热门的俄罗斯城市	{俄罗斯=地区国家, 10个=head}	热门/城市list
3个比较热门的沙特城市	{3个=head, 沙特=地区国家}	热门/城市list
三个比较热门的瑞士城市	{瑞士=地区国家, 三个=head}	热门/城市list
三个比较热门的秘鲁城市	{秘鲁=地区国家, 三个=head}	热门/城市list
五个比较热门的毛里求斯城市	{毛里求斯=地区国家, 五个=head}	热门/城市list
五个比较热门的法国城市	{法国=地区国家, 五个=head}	热门/城市list
3个比较热门的尼泊尔城市	{尼泊尔=地区国家, 3个=head}	热门/城市list
5个比较热门的西班牙城市	{5个=head, 西班牙=地区国家}	热门/城市list
五个比较热门的荷兰城市	{荷兰=地区国家, 五个=head}	热门/城市list
3个比较热门的德国城市	{3个=head, 德国=地区国家}	热门/城市list
十个比较热门的新西兰城市	{十个=head, 新西兰=地区国家}	热门/城市list
10个比较热门的德国城市	{10个=head, 德国=地区国家}	热门/城市list
十个比较热门的以色列城市	{以色列=地区国家, 十个=head}	热门/城市list
5个比较热门的奥地利城市	{奥地利=地区国家, 5个=head}	热门/城市list
三个比较热门的德国城市	{三个=head, 德国=地区国家}	热门/城市list
3个比较热门的奥地利城市	{奥地利=地区国家, 3个=head}	热门/城市list
10个比较热门的芬兰城市	{芬兰=地区国家, 10个=head}	热门/城市list
3个比较热门的马尔代夫城市	{马尔代夫=地区国家, 3个=head}	热门/城市list
五个比较热门的不丹城市	{不丹=地区国家, 五个=head}	热门/城市list
5个比较热门的匈牙利城市	{5个=head, 匈牙利=地区国家}	热门/城市list
十个比较热门的菲律宾城市	{十个=head, 菲律宾=地区国家}	热门/城市list
5个比较热门的老挝城市	{老挝=地区国家, 5个=head}	热门/城市list
五个比较热门的葡萄牙城市	{葡萄牙=地区国家, 五个=head}	热门/城市list
5个比较热门的伊拉克城市	{5个=head, 伊拉克=地区国家}	热门/城市list
3个比较热门的印度尼西亚城市	{3个=head, 印度尼西亚=地区国家}	热门/城市list
十个比较热门的阿联酋城市	{阿联酋=地区国家, 十个=head}	热门/城市list
10个比较热门的库克群岛城市	{库克群岛=地区国家, 10个=head}	热门/城市list
十个比较热门的韩国城市	{十个=head, 韩国=地区国家}	热门/城市list
五个比较热门的柬埔寨城市	{柬埔寨=地区国家, 五个=head}	热门/城市list
缅甸比较热门的城市	{缅甸=地区国家}	热门/城市list
爱尔兰比较热门的城市	{爱尔兰=地区国家}	热门/城市list
俄罗斯比较热门的城市	{俄罗斯=地区国家}	热门/城市list
欧洲比较热门的城市	{欧洲=地区国家}	热门/城市list
马尔代夫比较热门的城市	{马尔代夫=地区国家}	热门/城市list
秘鲁比较热门的城市	{秘鲁=地区国家}	热门/城市list
印度尼西亚比较热门的城市	{印度尼西亚=地区国家}	热门/城市list
芬兰比较热门的城市	{芬兰=地区国家}	热门/城市list
挪威比较热门的城市	{挪威=地区国家}	热门/城市list
卡塔尔比较热门的城市	{卡塔尔=地区国家}	热门/城市list
土耳其比较热门的城市	{土耳其=地区国家}	热门/城市list
柬埔寨比较热门的城市	{柬埔寨=地区国家}	热门/城市list
荷兰比较热门的城市	{荷兰=地区国家}	热门/城市list
德国比较热门的城市	{德国=地区国家}	热门/城市list
东南亚比较热门的城市	{东南亚=地区国家}	热门/城市list
库克群岛比较热门的城市	{库克群岛=地区国家}	热门/城市list
韩国比较热门的城市	{韩国=地区国家}	热门/城市list
埃及比较热门的城市	{埃及=地区国家}	热门/城市list
阿联酋比较热门的城市	{阿联酋=地区国家}	热门/城市list
比利时比较热门的城市	{比利时=地区国家}	热门/城市list
加拿大比较热门的城市	{加拿大=地区国家}	热门/城市list
南美比较热门的城市	{南美=地区国家}	热门/城市list
法属波利尼西亚比较热门的城市	{法属波利尼西亚=地区国家}	热门/城市list
巴西比较热门的城市	{巴西=地区国家}	热门/城市list
澳大利亚比较热门的城市	{澳大利亚=地区国家}	热门/城市list
所罗门群岛比较热门的城市	{所罗门群岛=地区国家}	热门/城市list
南极洲比较热门的城市	{南极洲=地区国家}	热门/城市list
肯尼亚比较热门的城市	{肯尼亚=地区国家}	热门/城市list
新加坡比较热门的城市	{新加坡=地区国家}	热门/城市list
帕劳比较热门的城市	{帕劳=地区国家}	热门/城市list
不丹比较热门的城市	{不丹=地区国家}	热门/城市list
新西兰比较热门的城市	{新西兰=地区国家}	热门/城市list
葡萄牙比较热门的城市	{葡萄牙=地区国家}	热门/城市list
丹麦比较热门的城市	{丹麦=地区国家}	热门/城市list
法国比较热门的城市	{法国=地区国家}	热门/城市list
奥地利比较热门的城市	{奥地利=地区国家}	热门/城市list
智利比较热门的城市	{智利=地区国家}	热门/城市list
中国比较热门的城市	{中国=地区国家}	热门/城市list
沙特比较热门的城市	{沙特=地区国家}	热门/城市list
毛里求斯比较热门的城市	{毛里求斯=地区国家}	热门/城市list
亚洲比较热门的城市	{亚洲=地区国家}	热门/城市list
英国比较热门的城市	{英国=地区国家}	热门/城市list
希腊比较热门的城市	{希腊=地区国家}	热门/城市list
巴基斯坦比较热门的城市	{巴基斯坦=地区国家}	热门/城市list
匈牙利比较热门的城市	{匈牙利=地区国家}	热门/城市list
伊朗比较热门的城市	{伊朗=地区国家}	热门/城市list
日本比较热门的城市	{日本=地区国家}	热门/城市list
热门城市推荐	{}	热门/城市list
有哪些热门城市	{}	热门/城市list
帕劳有哪些热门城市	{帕劳=地区国家}	热门/城市list
法国有哪些热门城市	{法国=地区国家}	热门/城市list
柬埔寨有哪些热门城市	{柬埔寨=地区国家}	热门/城市list
印度尼西亚有哪些热门城市	{印度尼西亚=地区国家}	热门/城市list
智利有哪些热门城市	{智利=地区国家}	热门/城市list
匈牙利有哪些热门城市	{匈牙利=地区国家}	热门/城市list
阿联酋有哪些热门城市	{阿联酋=地区国家}	热门/城市list
西班牙有哪些热门城市	{西班牙=地区国家}	热门/城市list
巴基斯坦有哪些热门城市	{巴基斯坦=地区国家}	热门/城市list
马尔代夫有哪些热门城市	{马尔代夫=地区国家}	热门/城市list
缅甸有哪些热门城市	{缅甸=地区国家}	热门/城市list
南非有哪些热门城市	{南非=地区国家}	热门/城市list
哥伦比亚有哪些热门城市	{哥伦比亚=地区国家}	热门/城市list
沙特有哪些热门城市	{沙特=地区国家}	热门/城市list
孟加拉国有哪些热门城市	{孟加拉国=地区国家}	热门/城市list
秘鲁有哪些热门城市	{秘鲁=地区国家}	热门/城市list
新加坡有哪些热门城市	{新加坡=地区国家}	热门/城市list
意大利有哪些热门城市	{意大利=地区国家}	热门/城市list
不丹有哪些热门城市	{不丹=地区国家}	热门/城市list
法属波利尼西亚有哪些热门城市	{法属波利尼西亚=地区国家}	热门/城市list
巴布亚新几内亚有哪些热门城市	{巴布亚新几内亚=地区国家}	热门/城市list
葡萄牙有哪些热门城市	{葡萄牙=地区国家}	热门/城市list
阿根廷有哪些热门城市	{阿根廷=地区国家}	热门/城市list
挪威有哪些热门城市	{挪威=地区国家}	热门/城市list
俄罗斯有哪些热门城市	{俄罗斯=地区国家}	热门/城市list
泰国有哪些热门城市	{泰国=地区国家}	热门/城市list
卡塔尔有哪些热门城市	{卡塔尔=地区国家}	热门/城市list
瑞士有哪些热门城市	{瑞士=地区国家}	热门/城市list
日本有哪些热门城市	{日本=地区国家}	热门/城市list
大溪地有哪些热门城市	{大溪地=地区国家}	热门/城市list
巴西有哪些热门城市	{巴西=地区国家}	热门/城市list
美国有哪些热门城市	{美国=地区国家}	热门/城市list
南美有哪些热门城市	{南美=地区国家}	热门/城市list
所罗门群岛有哪些热门城市	{所罗门群岛=地区国家}	热门/城市list
伊拉克有哪些热门城市	{伊拉克=地区国家}	热门/城市list
肯尼亚有哪些热门城市	{肯尼亚=地区国家}	热门/城市list
荷兰有哪些热门城市	{荷兰=地区国家}	热门/城市list
澳大利亚有哪些热门城市	{澳大利亚=地区国家}	热门/城市list
欧洲有哪些热门城市	{欧洲=地区国家}	热门/城市list
芬兰有哪些热门城市	{芬兰=地区国家}	热门/城市list
奥地利有哪些热门城市	{奥地利=地区国家}	热门/城市list
巴哈马有哪些热门城市	{巴哈马=地区国家}	热门/城市list
老挝有哪些热门城市	{老挝=地区国家}	热门/城市list
南极洲有哪些热门城市	{南极洲=地区国家}	热门/城市list
尼泊尔有哪些热门城市	{尼泊尔=地区国家}	热门/城市list
斐济有哪些热门城市	{斐济=地区国家}	热门/城市list
阿根廷的哪些城市比较热门	{阿根廷=地区国家}	热门/城市list
瑞士的哪些城市比较热门	{瑞士=地区国家}	热门/城市list
不丹的哪些城市比较热门	{不丹=地区国家}	热门/城市list
东南亚的哪些城市比较热门	{东南亚=地区国家}	热门/城市list
斯里兰卡的哪些城市比较热门	{斯里兰卡=地区国家}	热门/城市list
南极洲的哪些城市比较热门	{南极洲=地区国家}	热门/城市list
捷克的哪些城市比较热门	{捷克=地区国家}	热门/城市list
希腊的哪些城市比较热门	{希腊=地区国家}	热门/城市list
智利的哪些城市比较热门	{智利=地区国家}	热门/城市list
伊拉克的哪些城市比较热门	{伊拉克=地区国家}	热门/城市list
英国的哪些城市比较热门	{英国=地区国家}	热门/城市list
伊朗的哪些城市比较热门	{伊朗=地区国家}	热门/城市list
大溪地的哪些城市比较热门	{大溪地=地区国家}	热门/城市list
肯尼亚的哪些城市比较热门	{肯尼亚=地区国家}	热门/城市list
比利时的哪些城市比较热门	{比利时=地区国家}	热门/城市list
土耳其的哪些城市比较热门	{土耳其=地区国家}	热门/城市list
巴哈马的哪些城市比较热门	{巴哈马=地区国家}	热门/城市list
荷兰的哪些城市比较热门	{荷兰=地区国家}	热门/城市list
南美的哪些城市比较热门	{南美=地区国家}	热门/城市list
缅甸的哪些城市比较热门	{缅甸=地区国家}	热门/城市list
马来西亚的哪些城市比较热门	{马来西亚=地区国家}	热门/城市list
匈牙利的哪些城市比较热门	{匈牙利=地区国家}	热门/城市list
埃及的哪些城市比较热门	{埃及=地区国家}	热门/城市list
挪威的哪些城市比较热门	{挪威=地区国家}	热门/城市list
所罗门群岛的哪些城市比较热门	{所罗门群岛=地区国家}	热门/城市list
美国的哪些城市比较热门	{美国=地区国家}	热门/城市list
冰岛的哪些城市比较热门	{冰岛=地区国家}	热门/城市list
毛里求斯的哪些城市比较热门	{毛里求斯=地区国家}	热门/城市list
爱尔兰的哪些城市比较热门	{爱尔兰=地区国家}	热门/城市list
意大利的哪些城市比较热门	{意大利=地区国家}	热门/城市list
巴西的哪些城市比较热门	{巴西=地区国家}	热门/城市list
土耳其的热门城市	{土耳其=地区国家}	热门/城市list
葡萄牙的热门城市	{葡萄牙=地区国家}	热门/城市list
德国的热门城市	{德国=地区国家}	热门/城市list
尼泊尔的热门城市	{尼泊尔=地区国家}	热门/城市list
不丹的热门城市	{不丹=地区国家}	热门/城市list
瑞士的热门城市	{瑞士=地区国家}	热门/城市list
意大利的热门城市	{意大利=地区国家}	热门/城市list
法国的热门城市	{法国=地区国家}	热门/城市list
南极洲的热门城市	{南极洲=地区国家}	热门/城市list
大溪地的热门城市	{大溪地=地区国家}	热门/城市list
荷兰的热门城市	{荷兰=地区国家}	热门/城市list
东南亚的热门城市	{东南亚=地区国家}	热门/城市list
澳大利亚的热门城市	{澳大利亚=地区国家}	热门/城市list
日本的热门城市	{日本=地区国家}	热门/城市list
新加坡的热门城市	{新加坡=地区国家}	热门/城市list
冰岛的热门城市	{冰岛=地区国家}	热门/城市list
希腊的热门城市	{希腊=地区国家}	热门/城市list
爱尔兰的热门城市	{爱尔兰=地区国家}	热门/城市list
南美的热门城市	{南美=地区国家}	热门/城市list
阿根廷的热门城市	{阿根廷=地区国家}	热门/城市list
俄罗斯的热门城市	{俄罗斯=地区国家}	热门/城市list
芬兰的热门城市	{芬兰=地区国家}	热门/城市list
印度尼西亚的热门城市	{印度尼西亚=地区国家}	热门/城市list
孟加拉国的热门城市	{孟加拉国=地区国家}	热门/城市list
西班牙的热门城市	{西班牙=地区国家}	热门/城市list
匈牙利的热门城市	{匈牙利=地区国家}	热门/城市list
巴基斯坦的热门城市	{巴基斯坦=地区国家}	热门/城市list
越南的热门城市	{越南=地区国家}	热门/城市list
沙特的热门城市	{沙特=地区国家}	热门/城市list
肯尼亚的热门城市	{肯尼亚=地区国家}	热门/城市list
缅甸的热门城市	{缅甸=地区国家}	热门/城市list
老挝的热门城市	{老挝=地区国家}	热门/城市list
比利时的热门城市	{比利时=地区国家}	热门/城市list
捷克的热门城市	{捷克=地区国家}	热门/城市list
瑞典的热门城市	{瑞典=地区国家}	热门/城市list
巴布亚新几内亚的热门城市	{巴布亚新几内亚=地区国家}	热门/城市list
欧洲的热门城市	{欧洲=地区国家}	热门/城市list
柬埔寨的热门城市	{柬埔寨=地区国家}	热门/城市list
斐济的热门城市	{斐济=地区国家}	热门/城市list
美国的热门城市	{美国=地区国家}	热门/城市list
以色列的热门城市	{以色列=地区国家}	热门/城市list
韩国的热门城市	{韩国=地区国家}	热门/城市list
库克群岛的热门城市	{库克群岛=地区国家}	热门/城市list
奥地利的热门城市	{奥地利=地区国家}	热门/城市list
智利的热门城市	{智利=地区国家}	热门/城市list
中国的热门城市	{中国=地区国家}	热门/城市list
斯里兰卡的热门城市	{斯里兰卡=地区国家}	热门/城市list
伊拉克的热门城市	{伊拉克=地区国家}	热门/城市list
挪威的热门城市	{挪威=地区国家}	热门/城市list
讲阿拉伯语的国家	{阿拉伯语=语言}	国家list
讲日语的国家	{日语=语言}	国家list
讲德语的国家	{德语=语言}	国家list
讲越南语的国家	{越南语=语言}	国家list
讲法语的国家	{法语=语言}	国家list
讲泰米尔语的国家	{泰米尔语=语言}	国家list
讲俄语的国家	{俄语=语言}	国家list
讲意大利语的国家	{意大利语=语言}	国家list
讲汉语的国家	{汉语=语言}	国家list
讲斯瓦希里语的国家	{斯瓦希里语=语言}	国家list
讲韩语的国家	{韩语=语言}	国家list
说韩语英语的都有哪些国家	{韩语=语言}	国家list
说泰米尔语英语的都有哪些国家	{泰米尔语=语言}	国家list
说汉语英语的都有哪些国家	{汉语=语言}	国家list
说英语英语的都有哪些国家	{英语=语言}	国家list
说意大利语英语的都有哪些国家	{意大利语=语言}	国家list
说朝鲜语英语的都有哪些国家	{朝鲜语=语言}	国家list
说德语英语的都有哪些国家	{德语=语言}	国家list
说斯瓦希里语英语的都有哪些国家	{斯瓦希里语=语言}	国家list
说西班牙语英语的都有哪些国家	{西班牙语=语言}	国家list
说阿拉伯语英语的都有哪些国家	{阿拉伯语=语言}	国家list
说越南语英语的都有哪些国家	{越南语=语言}	国家list
说俄语英语的都有哪些国家	{俄语=语言}	国家list
说日语英语的都有哪些国家	{日语=语言}	国家list
讲英语的国家有哪些	{英语=语言}	国家list
讲阿拉伯语的国家有哪些	{阿拉伯语=语言}	国家list
讲意大利语的国家有哪些	{意大利语=语言}	国家list
讲法语的国家有哪些	{法语=语言}	国家list
讲日语的国家有哪些	{日语=语言}	国家list
讲泰米尔语的国家有哪些	{泰米尔语=语言}	国家list
讲汉语的国家有哪些	{汉语=语言}	国家list
讲德语的国家有哪些	{德语=语言}	国家list
讲朝鲜语的国家有哪些	{朝鲜语=语言}	国家list
哪些国家讲汉语	{汉语=语言}	国家list
哪些国家讲俄语	{俄语=语言}	国家list
哪些国家讲斯瓦希里语	{斯瓦希里语=语言}	国家list
哪些国家讲日语	{日语=语言}	国家list
哪些国家讲越南语	{越南语=语言}	国家list
哪些国家讲英语	{英语=语言}	国家list
哪些国家讲意大利语	{意大利语=语言}	国家list
哪些国家讲法语	{法语=语言}	国家list
哪些国家讲韩语	{韩语=语言}	国家list
哪些国家讲西班牙语	{西班牙语=语言}	国家list
哪些国家讲德语	{德语=语言}	国家list
哪些国家讲朝鲜语	{朝鲜语=语言}	国家list
哪些国家讲泰米尔语	{泰米尔语=语言}	国家list
哪些国家讲阿拉伯语	{阿拉伯语=语言}	国家list
有哪些国家讲德语	{德语=语言}	国家list
有哪些国家讲泰米尔语	{泰米尔语=语言}	国家list
有哪些国家讲汉语	{汉语=语言}	国家list
有哪些国家讲意大利语	{意大利语=语言}	国家list
有哪些国家讲韩语	{韩语=语言}	国家list
有哪些国家讲俄语	{俄语=语言}	国家list
有哪些国家讲阿拉伯语	{阿拉伯语=语言}	国家list
有哪些国家讲法语	{法语=语言}	国家list
有哪些国家讲英语	{英语=语言}	国家list
有哪些国家讲朝鲜语	{朝鲜语=语言}	国家list
有哪些国家讲西班牙语	{西班牙语=语言}	国家list
有哪些国家讲日语	{日语=语言}	国家list
有哪些国家讲越南语	{越南语=语言}	国家list
都有哪些国家讲朝鲜语	{朝鲜语=语言}	国家list
都有哪些国家讲汉语	{汉语=语言}	国家list
都有哪些国家讲俄语	{俄语=语言}	国家list
都有哪些国家讲德语	{德语=语言}	国家list
都有哪些国家讲阿拉伯语	{阿拉伯语=语言}	国家list
都有哪些国家讲日语	{日语=语言}	国家list
都有哪些国家讲泰米尔语	{泰米尔语=语言}	国家list
都有哪些国家讲英语	{英语=语言}	国家list
都有哪些国家讲韩语	{韩语=语言}	国家list
东南亚讲日语的国家	{东南亚=地区, 日语=语言}	国家list
南美讲阿拉伯语的国家	{阿拉伯语=语言, 南美=地区}	国家list
亚洲讲越南语的国家	{亚洲=地区, 越南语=语言}	国家list
东南亚讲法语的国家	{东南亚=地区, 法语=语言}	国家list
亚洲讲泰米尔语的国家	{亚洲=地区, 泰米尔语=语言}	国家list
南美讲意大利语的国家	{意大利语=语言, 南美=地区}	国家list
东南亚讲阿拉伯语的国家	{东南亚=地区, 阿拉伯语=语言}	国家list
东南亚讲俄语的国家	{东南亚=地区, 俄语=语言}	国家list
亚洲讲德语的国家	{亚洲=地区, 德语=语言}	国家list
欧洲讲德语的国家	{欧洲=地区, 德语=语言}	国家list
欧洲讲朝鲜语的国家	{欧洲=地区, 朝鲜语=语言}	国家list
欧洲讲斯瓦希里语的国家	{欧洲=地区, 斯瓦希里语=语言}	国家list
亚洲讲日语的国家	{亚洲=地区, 日语=语言}	国家list
亚洲讲英语的国家	{亚洲=地区, 英语=语言}	国家list
南美讲日语的国家	{日语=语言, 南美=地区}	国家list
亚洲讲俄语的国家	{亚洲=地区, 俄语=语言}	国家list
欧洲讲俄语的国家	{俄语=语言, 欧洲=地区}	国家list
欧洲讲韩语的国家	{欧洲=地区, 韩语=语言}	国家list
东南亚讲泰米尔语的国家	{东南亚=地区, 泰米尔语=语言}	国家list
南美讲泰米尔语的国家	{泰米尔语=语言, 南美=地区}	国家list
东南亚讲韩语的国家	{东南亚=地区, 韩语=语言}	国家list
亚洲讲韩语的国家	{亚洲=地区, 韩语=语言}	国家list
欧洲讲汉语的国家	{欧洲=地区, 汉语=语言}	国家list
南美讲汉语的国家	{汉语=语言, 南美=地区}	国家list
欧洲讲意大利语的国家	{欧洲=地区, 意大利语=语言}	国家list
欧洲讲日语的国家	{日语=语言, 欧洲=地区}	国家list
欧洲讲英语的国家	{欧洲=地区, 英语=语言}	国家list
南美讲英语的国家	{英语=语言, 南美=地区}	国家list
欧洲讲法语的国家	{法语=语言, 欧洲=地区}	国家list
南美讲朝鲜语的国家	{朝鲜语=语言, 南美=地区}	国家list
南美讲西班牙语的国家	{西班牙语=语言, 南美=地区}	国家list
南美讲俄语的国家	{俄语=语言, 南美=地区}	国家list
亚洲讲法语的国家	{亚洲=地区, 法语=语言}	国家list
南美讲法语的国家	{法语=语言, 南美=地区}	国家list
欧洲讲阿拉伯语的国家	{阿拉伯语=语言, 欧洲=地区}	国家list
南美讲德语的国家	{德语=语言, 南美=地区}	国家list
东南亚讲汉语的国家	{东南亚=地区, 汉语=语言}	国家list
亚洲讲西班牙语的国家	{西班牙语=语言, 亚洲=地区}	国家list
南美讲斯瓦希里语的国家	{斯瓦希里语=语言, 南美=地区}	国家list
东南亚讲西班牙语的国家	{东南亚=地区, 西班牙语=语言}	国家list
亚洲说朝鲜语英语的都有哪些国家	{亚洲=地区, 朝鲜语=语言}	国家list
亚洲说日语英语的都有哪些国家	{亚洲=地区, 日语=语言}	国家list
欧洲说韩语英语的都有哪些国家	{欧洲=地区, 韩语=语言}	国家list
东南亚说俄语英语的都有哪些国家	{东南亚=地区, 俄语=语言}	国家list
南美说阿拉伯语英语的都有哪些国家	{阿拉伯语=语言, 南美=地区}	国家list
南美说越南语英语的都有哪些国家	{南美=地区, 越南语=语言}	国家list
东南亚说越南语英语的都有哪些国家	{东南亚=地区, 越南语=语言}	国家list
南美说意大利语英语的都有哪些国家	{意大利语=语言, 南美=地区}	国家list
亚洲说德语英语的都有哪些国家	{亚洲=地区, 德语=语言}	国家list
亚洲说泰米尔语英语的都有哪些国家	{亚洲=地区, 泰米尔语=语言}	国家list
南美说韩语英语的都有哪些国家	{韩语=语言, 南美=地区}	国家list
亚洲说英语英语的都有哪些国家	{亚洲=地区, 英语=语言}	国家list
亚洲说意大利语英语的都有哪些国家	{亚洲=地区, 意大利语=语言}	国家list
欧洲说阿拉伯语英语的都有哪些国家	{阿拉伯语=语言, 欧洲=地区}	国家list
欧洲说汉语英语的都有哪些国家	{欧洲=地区, 汉语=语言}	国家list
南美说西班牙语英语的都有哪些国家	{西班牙语=语言, 南美=地区}	国家list
南美说英语英语的都有哪些国家	{英语=语言, 南美=地区}	国家list
东南亚说英语英语的都有哪些国家	{东南亚=地区, 英语=语言}	国家list
亚洲说越南语英语的都有哪些国家	{亚洲=地区, 越南语=语言}	国家list
亚洲说阿拉伯语英语的都有哪些国家	{亚洲=地区, 阿拉伯语=语言}	国家list
东南亚说意大利语英语的都有哪些国家	{东南亚=地区, 意大利语=语言}	国家list
东南亚说西班牙语英语的都有哪些国家	{东南亚=地区, 西班牙语=语言}	国家list
东南亚说斯瓦希里语英语的都有哪些国家	{东南亚=地区, 斯瓦希里语=语言}	国家list
东南亚说德语英语的都有哪些国家	{东南亚=地区, 德语=语言}	国家list
欧洲说俄语英语的都有哪些国家	{俄语=语言, 欧洲=地区}	国家list
亚洲说法语英语的都有哪些国家	{亚洲=地区, 法语=语言}	国家list
欧洲说日语英语的都有哪些国家	{日语=语言, 欧洲=地区}	国家list
欧洲说德语英语的都有哪些国家	{欧洲=地区, 德语=语言}	国家list
欧洲说英语英语的都有哪些国家	{欧洲=地区, 英语=语言}	国家list
南美说汉语英语的都有哪些国家	{汉语=语言, 南美=地区}	国家list
欧洲说法语英语的都有哪些国家	{法语=语言, 欧洲=地区}	国家list
东南亚说阿拉伯语英语的都有哪些国家	{东南亚=地区, 阿拉伯语=语言}	国家list
欧洲说西班牙语英语的都有哪些国家	{西班牙语=语言, 欧洲=地区}	国家list
欧洲说泰米尔语英语的都有哪些国家	{欧洲=地区, 泰米尔语=语言}	国家list
亚洲说汉语英语的都有哪些国家	{亚洲=地区, 汉语=语言}	国家list
欧洲讲越南语的国家有哪些	{欧洲=地区, 越南语=语言}	国家list
亚洲讲意大利语的国家有哪些	{亚洲=地区, 意大利语=语言}	国家list
东南亚讲汉语的国家有哪些	{东南亚=地区, 汉语=语言}	国家list
南美讲西班牙语的国家有哪些	{西班牙语=语言, 南美=地区}	国家list
欧洲讲法语的国家有哪些	{法语=语言, 欧洲=地区}	国家list
南美讲斯瓦希里语的国家有哪些	{斯瓦希里语=语言, 南美=地区}	国家list
欧洲讲日语的国家有哪些	{日语=语言, 欧洲=地区}	国家list
欧洲讲德语的国家有哪些	{欧洲=地区, 德语=语言}	国家list
东南亚讲法语的国家有哪些	{东南亚=地区, 法语=语言}	国家list
欧洲讲泰米尔语的国家有哪些	{欧洲=地区, 泰米尔语=语言}	国家list
南美讲德语的国家有哪些	{德语=语言, 南美=地区}	国家list
东南亚讲泰米尔语的国家有哪些	{东南亚=地区, 泰米尔语=语言}	国家list
欧洲讲阿拉伯语的国家有哪些	{阿拉伯语=语言, 欧洲=地区}	国家list
亚洲讲韩语的国家有哪些	{亚洲=地区, 韩语=语言}	国家list
东南亚讲西班牙语的国家有哪些	{东南亚=地区, 西班牙语=语言}	国家list
东南亚讲德语的国家有哪些	{东南亚=地区, 德语=语言}	国家list
东南亚讲韩语的国家有哪些	{东南亚=地区, 韩语=语言}	国家list
南美讲法语的国家有哪些	{法语=语言, 南美=地区}	国家list
亚洲讲西班牙语的国家有哪些	{西班牙语=语言, 亚洲=地区}	国家list
东南亚讲日语的国家有哪些	{东南亚=地区, 日语=语言}	国家list
亚洲讲汉语的国家有哪些	{亚洲=地区, 汉语=语言}	国家list
欧洲讲俄语的国家有哪些	{俄语=语言, 欧洲=地区}	国家list
欧洲讲英语的国家有哪些	{欧洲=地区, 英语=语言}	国家list
南美讲泰米尔语的国家有哪些	{泰米尔语=语言, 南美=地区}	国家list
亚洲讲泰米尔语的国家有哪些	{亚洲=地区, 泰米尔语=语言}	国家list
东南亚讲越南语的国家有哪些	{东南亚=地区, 越南语=语言}	国家list
欧洲讲汉语的国家有哪些	{欧洲=地区, 汉语=语言}	国家list
南美讲俄语的国家有哪些	{俄语=语言, 南美=地区}	国家list
南美讲越南语的国家有哪些	{南美=地区, 越南语=语言}	国家list
亚洲讲阿拉伯语的国家有哪些	{亚洲=地区, 阿拉伯语=语言}	国家list
欧洲讲意大利语的国家有哪些	{欧洲=地区, 意大利语=语言}	国家list
亚洲讲日语的国家有哪些	{亚洲=地区, 日语=语言}	国家list
亚洲讲法语的国家有哪些	{亚洲=地区, 法语=语言}	国家list
南美讲汉语的国家有哪些	{汉语=语言, 南美=地区}	国家list
南美讲英语的国家有哪些	{英语=语言, 南美=地区}	国家list
东南亚讲阿拉伯语的国家有哪些	{东南亚=地区, 阿拉伯语=语言}	国家list
东南亚讲朝鲜语的国家有哪些	{东南亚=地区, 朝鲜语=语言}	国家list
南美讲日语的国家有哪些	{日语=语言, 南美=地区}	国家list
东南亚哪些国家讲越南语	{东南亚=地区, 越南语=语言}	国家list
亚洲哪些国家讲阿拉伯语	{亚洲=地区, 阿拉伯语=语言}	国家list
东南亚哪些国家讲朝鲜语	{东南亚=地区, 朝鲜语=语言}	国家list
亚洲哪些国家讲法语	{亚洲=地区, 法语=语言}	国家list
欧洲哪些国家讲意大利语	{欧洲=地区, 意大利语=语言}	国家list
南美哪些国家讲泰米尔语	{泰米尔语=语言, 南美=地区}	国家list
亚洲哪些国家讲意大利语	{亚洲=地区, 意大利语=语言}	国家list
东南亚哪些国家讲日语	{东南亚=地区, 日语=语言}	国家list
欧洲哪些国家讲韩语	{欧洲=地区, 韩语=语言}	国家list
东南亚哪些国家讲法语	{东南亚=地区, 法语=语言}	国家list
东南亚哪些国家讲斯瓦希里语	{东南亚=地区, 斯瓦希里语=语言}	国家list
亚洲哪些国家讲俄语	{亚洲=地区, 俄语=语言}	国家list
南美哪些国家讲德语	{德语=语言, 南美=地区}	国家list
东南亚哪些国家讲意大利语	{东南亚=地区, 意大利语=语言}	国家list
欧洲哪些国家讲英语	{欧洲=地区, 英语=语言}	国家list
东南亚哪些国家讲俄语	{东南亚=地区, 俄语=语言}	国家list
欧洲哪些国家讲阿拉伯语	{阿拉伯语=语言, 欧洲=地区}	国家list
亚洲哪些国家讲越南语	{亚洲=地区, 越南语=语言}	国家list
南美哪些国家讲法语	{法语=语言, 南美=地区}	国家list
欧洲哪些国家讲法语	{法语=语言, 欧洲=地区}	国家list
东南亚哪些国家讲阿拉伯语	{东南亚=地区, 阿拉伯语=语言}	国家list
亚洲哪些国家讲德语	{亚洲=地区, 德语=语言}	国家list
欧洲哪些国家讲斯瓦希里语	{欧洲=地区, 斯瓦希里语=语言}	国家list
南美哪些国家讲西班牙语	{西班牙语=语言, 南美=地区}	国家list
亚洲哪些国家讲汉语	{亚洲=地区, 汉语=语言}	国家list
南美哪些国家讲阿拉伯语	{阿拉伯语=语言, 南美=地区}	国家list
亚洲哪些国家讲斯瓦希里语	{亚洲=地区, 斯瓦希里语=语言}	国家list
欧洲哪些国家讲俄语	{俄语=语言, 欧洲=地区}	国家list
欧洲哪些国家讲朝鲜语	{欧洲=地区, 朝鲜语=语言}	国家list
东南亚哪些国家讲英语	{东南亚=地区, 英语=语言}	国家list
亚洲哪些国家讲韩语	{亚洲=地区, 韩语=语言}	国家list
东南亚哪些国家讲韩语	{东南亚=地区, 韩语=语言}	国家list
南美哪些国家讲意大利语	{意大利语=语言, 南美=地区}	国家list
欧洲哪些国家讲汉语	{欧洲=地区, 汉语=语言}	国家list
欧洲哪些国家讲越南语	{欧洲=地区, 越南语=语言}	国家list
南美哪些国家讲汉语	{汉语=语言, 南美=地区}	国家list
亚洲哪些国家讲泰米尔语	{亚洲=地区, 泰米尔语=语言}	国家list
欧洲哪些国家讲泰米尔语	{欧洲=地区, 泰米尔语=语言}	国家list
南美哪些国家讲日语	{日语=语言, 南美=地区}	国家list
南美哪些国家讲越南语	{南美=地区, 越南语=语言}	国家list
欧洲哪些国家讲日语	{日语=语言, 欧洲=地区}	国家list
欧洲哪些国家讲德语	{欧洲=地区, 德语=语言}	国家list
欧洲有哪些国家讲德语	{欧洲=地区, 德语=语言}	国家list
欧洲有哪些国家讲英语	{欧洲=地区, 英语=语言}	国家list
东南亚有哪些国家讲德语	{东南亚=地区, 德语=语言}	国家list
欧洲有哪些国家讲越南语	{欧洲=地区, 越南语=语言}	国家list
南美有哪些国家讲法语	{法语=语言, 南美=地区}	国家list
南美有哪些国家讲斯瓦希里语	{斯瓦希里语=语言, 南美=地区}	国家list
东南亚有哪些国家讲法语	{东南亚=地区, 法语=语言}	国家list
东南亚有哪些国家讲俄语	{东南亚=地区, 俄语=语言}	国家list
南美有哪些国家讲意大利语	{意大利语=语言, 南美=地区}	国家list
欧洲有哪些国家讲斯瓦希里语	{欧洲=地区, 斯瓦希里语=语言}	国家list
亚洲有哪些国家讲西班牙语	{西班牙语=语言, 亚洲=地区}	国家list
南美有哪些国家讲英语	{英语=语言, 南美=地区}	国家list
南美有哪些国家讲西班牙语	{西班牙语=语言, 南美=地区}	国家list
南美有哪些国家讲汉语	{汉语=语言, 南美=地区}	国家list
南美有哪些国家讲俄语	{俄语=语言, 南美=地区}	国家list
亚洲有哪些国家讲俄语	{亚洲=地区, 俄语=语言}	国家list
欧洲有哪些国家讲法语	{法语=语言, 欧洲=地区}	国家list
亚洲有哪些国家讲斯瓦希里语	{亚洲=地区, 斯瓦希里语=语言}	国家list
南美有哪些国家讲德语	{德语=语言, 南美=地区}	国家list
东南亚有哪些国家讲汉语	{东南亚=地区, 汉语=语言}	国家list
亚洲有哪些国家讲越南语	{亚洲=地区, 越南语=语言}	国家list
欧洲有哪些国家讲俄语	{俄语=语言, 欧洲=地区}	国家list
亚洲有哪些国家讲泰米尔语	{亚洲=地区, 泰米尔语=语言}	国家list
东南亚有哪些国家讲西班牙语	{东南亚=地区, 西班牙语=语言}	国家list
亚洲有哪些国家讲英语	{亚洲=地区, 英语=语言}	国家list
欧洲有哪些国家讲阿拉伯语	{阿拉伯语=语言, 欧洲=地区}	国家list
亚洲有哪些国家讲汉语	{亚洲=地区, 汉语=语言}	国家list
亚洲有哪些国家讲阿拉伯语	{亚洲=地区, 阿拉伯语=语言}	国家list
南美有哪些国家讲韩语	{韩语=语言, 南美=地区}	国家list
亚洲有哪些国家讲日语	{亚洲=地区, 日语=语言}	国家list
东南亚有哪些国家讲泰米尔语	{东南亚=地区, 泰米尔语=语言}	国家list
东南亚有哪些国家讲阿拉伯语	{东南亚=地区, 阿拉伯语=语言}	国家list
欧洲有哪些国家讲日语	{日语=语言, 欧洲=地区}	国家list
南美有哪些国家讲朝鲜语	{朝鲜语=语言, 南美=地区}	国家list
亚洲有哪些国家讲法语	{亚洲=地区, 法语=语言}	国家list
欧洲有哪些国家讲西班牙语	{西班牙语=语言, 欧洲=地区}	国家list
南美有哪些国家讲日语	{日语=语言, 南美=地区}	国家list
东南亚有哪些国家讲日语	{东南亚=地区, 日语=语言}	国家list
东南亚有哪些国家讲越南语	{东南亚=地区, 越南语=语言}	国家list
亚洲有哪些国家讲韩语	{亚洲=地区, 韩语=语言}	国家list
南美有哪些国家讲阿拉伯语	{阿拉伯语=语言, 南美=地区}	国家list
南美有哪些国家讲泰米尔语	{泰米尔语=语言, 南美=地区}	国家list
亚洲有哪些国家讲朝鲜语	{亚洲=地区, 朝鲜语=语言}	国家list
东南亚有哪些国家讲英语	{东南亚=地区, 英语=语言}	国家list
南美都有哪些国家讲法语	{法语=语言, 南美=地区}	国家list
亚洲都有哪些国家讲阿拉伯语	{亚洲=地区, 阿拉伯语=语言}	国家list
南美都有哪些国家讲越南语	{南美=地区, 越南语=语言}	国家list
东南亚都有哪些国家讲阿拉伯语	{东南亚=地区, 阿拉伯语=语言}	国家list
欧洲都有哪些国家讲阿拉伯语	{阿拉伯语=语言, 欧洲=地区}	国家list
欧洲都有哪些国家讲英语	{欧洲=地区, 英语=语言}	国家list
南美都有哪些国家讲俄语	{俄语=语言, 南美=地区}	国家list
欧洲都有哪些国家讲法语	{法语=语言, 欧洲=地区}	国家list
南美都有哪些国家讲汉语	{汉语=语言, 南美=地区}	国家list
亚洲都有哪些国家讲朝鲜语	{亚洲=地区, 朝鲜语=语言}	国家list
亚洲都有哪些国家讲西班牙语	{西班牙语=语言, 亚洲=地区}	国家list
亚洲都有哪些国家讲法语	{亚洲=地区, 法语=语言}	国家list
欧洲都有哪些国家讲斯瓦希里语	{欧洲=地区, 斯瓦希里语=语言}	国家list
南美都有哪些国家讲意大利语	{意大利语=语言, 南美=地区}	国家list
东南亚都有哪些国家讲韩语	{东南亚=地区, 韩语=语言}	国家list
东南亚都有哪些国家讲日语	{东南亚=地区, 日语=语言}	国家list
南美都有哪些国家讲德语	{德语=语言, 南美=地区}	国家list
东南亚都有哪些国家讲越南语	{东南亚=地区, 越南语=语言}	国家list
欧洲都有哪些国家讲俄语	{俄语=语言, 欧洲=地区}	国家list
亚洲都有哪些国家讲越南语	{亚洲=地区, 越南语=语言}	国家list
东南亚都有哪些国家讲汉语	{东南亚=地区, 汉语=语言}	国家list
东南亚都有哪些国家讲泰米尔语	{东南亚=地区, 泰米尔语=语言}	国家list
南美都有哪些国家讲斯瓦希里语	{斯瓦希里语=语言, 南美=地区}	国家list
东南亚都有哪些国家讲德语	{东南亚=地区, 德语=语言}	国家list
欧洲都有哪些国家讲泰米尔语	{欧洲=地区, 泰米尔语=语言}	国家list
东南亚都有哪些国家讲朝鲜语	{东南亚=地区, 朝鲜语=语言}	国家list
南美都有哪些国家讲阿拉伯语	{阿拉伯语=语言, 南美=地区}	国家list
欧洲都有哪些国家讲德语	{欧洲=地区, 德语=语言}	国家list
东南亚都有哪些国家讲法语	{东南亚=地区, 法语=语言}	国家list
亚洲都有哪些国家讲韩语	{亚洲=地区, 韩语=语言}	国家list
南美都有哪些国家讲朝鲜语	{朝鲜语=语言, 南美=地区}	国家list
欧洲都有哪些国家讲汉语	{欧洲=地区, 汉语=语言}	国家list
东南亚都有哪些国家讲英语	{东南亚=地区, 英语=语言}	国家list
南美都有哪些国家讲西班牙语	{西班牙语=语言, 南美=地区}	国家list
欧洲都有哪些国家讲西班牙语	{西班牙语=语言, 欧洲=地区}	国家list
亚洲都有哪些国家讲汉语	{亚洲=地区, 汉语=语言}	国家list
东南亚都有哪些国家讲俄语	{东南亚=地区, 俄语=语言}	国家list
南美都有哪些国家讲韩语	{韩语=语言, 南美=地区}	国家list
亚洲都有哪些国家讲泰米尔语	{亚洲=地区, 泰米尔语=语言}	国家list
亚洲都有哪些国家讲意大利语	{亚洲=地区, 意大利语=语言}	国家list
东南亚都有哪些国家讲意大利语	{东南亚=地区, 意大利语=语言}	国家list
欧洲都有哪些国家讲朝鲜语	{欧洲=地区, 朝鲜语=语言}	国家list
讲朝鲜语的亚洲国家	{亚洲=地区, 朝鲜语=语言}	国家list
讲英语的东南亚国家	{东南亚=地区, 英语=语言}	国家list
讲汉语的亚洲国家	{亚洲=地区, 汉语=语言}	国家list
讲泰米尔语的欧洲国家	{欧洲=地区, 泰米尔语=语言}	国家list
讲西班牙语的南美国家	{西班牙语=语言, 南美=地区}	国家list
讲泰米尔语的东南亚国家	{东南亚=地区, 泰米尔语=语言}	国家list
讲英语的欧洲国家	{欧洲=地区, 英语=语言}	国家list
讲韩语的欧洲国家	{韩语=语言, 欧洲=地区}	国家list
讲越南语的东南亚国家	{东南亚=地区, 越南语=语言}	国家list
讲韩语的东南亚国家	{东南亚=地区, 韩语=语言}	国家list
讲日语的亚洲国家	{亚洲=地区, 日语=语言}	国家list
讲越南语的亚洲国家	{亚洲=地区, 越南语=语言}	国家list
讲越南语的南美国家	{越南语=语言, 南美=地区}	国家list
讲英语的亚洲国家	{亚洲=地区, 英语=语言}	国家list
讲朝鲜语的东南亚国家	{东南亚=地区, 朝鲜语=语言}	国家list
讲德语的亚洲国家	{亚洲=地区, 德语=语言}	国家list
讲法语的南美国家	{法语=语言, 南美=地区}	国家list
讲汉语的欧洲国家	{欧洲=地区, 汉语=语言}	国家list
讲阿拉伯语的南美国家	{阿拉伯语=语言, 南美=地区}	国家list
讲泰米尔语的南美国家	{泰米尔语=语言, 南美=地区}	国家list
讲阿拉伯语的东南亚国家	{东南亚=地区, 阿拉伯语=语言}	国家list
讲朝鲜语的欧洲国家	{欧洲=地区, 朝鲜语=语言}	国家list
讲德语的南美国家	{德语=语言, 南美=地区}	国家list
讲法语的亚洲国家	{亚洲=地区, 法语=语言}	国家list
讲俄语的欧洲国家	{俄语=语言, 欧洲=地区}	国家list
讲斯瓦希里语的亚洲国家	{亚洲=地区, 斯瓦希里语=语言}	国家list
讲泰米尔语的亚洲国家	{亚洲=地区, 泰米尔语=语言}	国家list
讲朝鲜语的南美国家	{朝鲜语=语言, 南美=地区}	国家list
讲英语的南美国家	{英语=语言, 南美=地区}	国家list
讲俄语的东南亚国家	{东南亚=地区, 俄语=语言}	国家list
讲意大利语的南美国家	{意大利语=语言, 南美=地区}	国家list
讲意大利语的欧洲国家	{欧洲=地区, 意大利语=语言}	国家list
讲阿拉伯语的欧洲国家	{阿拉伯语=语言, 欧洲=地区}	国家list
讲韩语的南美国家	{韩语=语言, 南美=地区}	国家list
讲法语的东南亚国家	{东南亚=地区, 法语=语言}	国家list
讲西班牙语的东南亚国家	{西班牙语=语言, 东南亚=地区}	国家list
讲越南语的欧洲国家	{欧洲=地区, 越南语=语言}	国家list
讲斯瓦希里语的欧洲国家	{欧洲=地区, 斯瓦希里语=语言}	国家list
讲阿拉伯语的亚洲国家	{阿拉伯语=语言, 亚洲=地区}	国家list
说朝鲜语的南美国家都有哪些	{朝鲜语=语言, 南美=地区}	国家list
说斯瓦希里语的东南亚国家都有哪些	{东南亚=地区, 斯瓦希里语=语言}	国家list
说英语的南美国家都有哪些	{英语=语言, 南美=地区}	国家list
说泰米尔语的南美国家都有哪些	{泰米尔语=语言, 南美=地区}	国家list
说韩语的南美国家都有哪些	{韩语=语言, 南美=地区}	国家list
说德语的东南亚国家都有哪些	{东南亚=地区, 德语=语言}	国家list
说朝鲜语的欧洲国家都有哪些	{欧洲=地区, 朝鲜语=语言}	国家list
说斯瓦希里语的亚洲国家都有哪些	{亚洲=地区, 斯瓦希里语=语言}	国家list
说意大利语的亚洲国家都有哪些	{亚洲=地区, 意大利语=语言}	国家list
说英语的亚洲国家都有哪些	{亚洲=地区, 英语=语言}	国家list
说阿拉伯语的欧洲国家都有哪些	{阿拉伯语=语言, 欧洲=地区}	国家list
说俄语的欧洲国家都有哪些	{俄语=语言, 欧洲=地区}	国家list
说西班牙语的东南亚国家都有哪些	{西班牙语=语言, 东南亚=地区}	国家list
说汉语的亚洲国家都有哪些	{亚洲=地区, 汉语=语言}	国家list
说西班牙语的南美国家都有哪些	{西班牙语=语言, 南美=地区}	国家list
说俄语的亚洲国家都有哪些	{亚洲=地区, 俄语=语言}	国家list
说斯瓦希里语的南美国家都有哪些	{斯瓦希里语=语言, 南美=地区}	国家list
说德语的南美国家都有哪些	{德语=语言, 南美=地区}	国家list
说意大利语的南美国家都有哪些	{意大利语=语言, 南美=地区}	国家list
说西班牙语的亚洲国家都有哪些	{西班牙语=语言, 亚洲=地区}	国家list
说法语的亚洲国家都有哪些	{亚洲=地区, 法语=语言}	国家list
说韩语的欧洲国家都有哪些	{韩语=语言, 欧洲=地区}	国家list
说泰米尔语的东南亚国家都有哪些	{东南亚=地区, 泰米尔语=语言}	国家list
说斯瓦希里语的欧洲国家都有哪些	{欧洲=地区, 斯瓦希里语=语言}	国家list
说阿拉伯语的亚洲国家都有哪些	{阿拉伯语=语言, 亚洲=地区}	国家list
说法语的南美国家都有哪些	{法语=语言, 南美=地区}	国家list
说日语的东南亚国家都有哪些	{东南亚=地区, 日语=语言}	国家list
说越南语的亚洲国家都有哪些	{亚洲=地区, 越南语=语言}	国家list
说日语的南美国家都有哪些	{日语=语言, 南美=地区}	国家list
说俄语的南美国家都有哪些	{俄语=语言, 南美=地区}	国家list
说泰米尔语的欧洲国家都有哪些	{欧洲=地区, 泰米尔语=语言}	国家list
说汉语的南美国家都有哪些	{汉语=语言, 南美=地区}	国家list
说日语的欧洲国家都有哪些	{日语=语言, 欧洲=地区}	国家list
说德语的欧洲国家都有哪些	{欧洲=地区, 德语=语言}	国家list
说法语的欧洲国家都有哪些	{法语=语言, 欧洲=地区}	国家list
说韩语的东南亚国家都有哪些	{东南亚=地区, 韩语=语言}	国家list
说汉语的东南亚国家都有哪些	{东南亚=地区, 汉语=语言}	国家list
说英语的东南亚国家都有哪些	{东南亚=地区, 英语=语言}	国家list
说日语的亚洲国家都有哪些	{亚洲=地区, 日语=语言}	国家list
说汉语的欧洲国家都有哪些	{欧洲=地区, 汉语=语言}	国家list
说朝鲜语的亚洲国家都有哪些	{亚洲=地区, 朝鲜语=语言}	国家list
说西班牙语的欧洲国家都有哪些	{西班牙语=语言, 欧洲=地区}	国家list
说俄语的东南亚国家都有哪些	{东南亚=地区, 俄语=语言}	国家list
说意大利语的东南亚国家都有哪些	{东南亚=地区, 意大利语=语言}	国家list
说朝鲜语的东南亚国家都有哪些	{东南亚=地区, 朝鲜语=语言}	国家list
说越南语的东南亚国家都有哪些	{东南亚=地区, 越南语=语言}	国家list
说越南语的欧洲国家都有哪些	{欧洲=地区, 越南语=语言}	国家list
讲西班牙语的东南亚国家有哪些	{西班牙语=语言, 东南亚=地区}	国家list
讲泰米尔语的亚洲国家有哪些	{亚洲=地区, 泰米尔语=语言}	国家list
讲西班牙语的南美国家有哪些	{西班牙语=语言, 南美=地区}	国家list
讲日语的亚洲国家有哪些	{亚洲=地区, 日语=语言}	国家list
讲泰米尔语的南美国家有哪些	{泰米尔语=语言, 南美=地区}	国家list
讲法语的亚洲国家有哪些	{亚洲=地区, 法语=语言}	国家list
讲阿拉伯语的欧洲国家有哪些	{阿拉伯语=语言, 欧洲=地区}	国家list
讲斯瓦希里语的南美国家有哪些	{斯瓦希里语=语言, 南美=地区}	国家list
讲朝鲜语的亚洲国家有哪些	{亚洲=地区, 朝鲜语=语言}	国家list
讲汉语的东南亚国家有哪些	{东南亚=地区, 汉语=语言}	国家list
讲俄语的亚洲国家有哪些	{亚洲=地区, 俄语=语言}	国家list
讲越南语的亚洲国家有哪些	{亚洲=地区, 越南语=语言}	国家list
讲斯瓦希里语的亚洲国家有哪些	{亚洲=地区, 斯瓦希里语=语言}	国家list
讲西班牙语的亚洲国家有哪些	{西班牙语=语言, 亚洲=地区}	国家list
讲日语的南美国家有哪些	{日语=语言, 南美=地区}	国家list
讲斯瓦希里语的欧洲国家有哪些	{欧洲=地区, 斯瓦希里语=语言}	国家list
讲德语的南美国家有哪些	{德语=语言, 南美=地区}	国家list
讲法语的南美国家有哪些	{法语=语言, 南美=地区}	国家list
讲韩语的欧洲国家有哪些	{韩语=语言, 欧洲=地区}	国家list
讲意大利语的欧洲国家有哪些	{欧洲=地区, 意大利语=语言}	国家list
讲越南语的东南亚国家有哪些	{东南亚=地区, 越南语=语言}	国家list
讲英语的亚洲国家有哪些	{亚洲=地区, 英语=语言}	国家list
讲韩语的东南亚国家有哪些	{东南亚=地区, 韩语=语言}	国家list
讲日语的东南亚国家有哪些	{东南亚=地区, 日语=语言}	国家list
讲汉语的欧洲国家有哪些	{欧洲=地区, 汉语=语言}	国家list
讲朝鲜语的南美国家有哪些	{朝鲜语=语言, 南美=地区}	国家list
讲俄语的欧洲国家有哪些	{俄语=语言, 欧洲=地区}	国家list
讲英语的南美国家有哪些	{英语=语言, 南美=地区}	国家list
讲法语的东南亚国家有哪些	{东南亚=地区, 法语=语言}	国家list
讲泰米尔语的欧洲国家有哪些	{欧洲=地区, 泰米尔语=语言}	国家list
讲斯瓦希里语的东南亚国家有哪些	{东南亚=地区, 斯瓦希里语=语言}	国家list
哪些南美国家讲西班牙语	{西班牙语=语言, 南美=地区}	国家list
哪些欧洲国家讲法语	{法语=语言, 欧洲=地区}	国家list
哪些南美国家讲德语	{德语=语言, 南美=地区}	国家list
哪些东南亚国家讲越南语	{东南亚=地区, 越南语=语言}	国家list
哪些欧洲国家讲西班牙语	{西班牙语=语言, 欧洲=地区}	国家list
哪些东南亚国家讲法语	{东南亚=地区, 法语=语言}	国家list
哪些东南亚国家讲意大利语	{东南亚=地区, 意大利语=语言}	国家list
哪些亚洲国家讲阿拉伯语	{亚洲=地区, 阿拉伯语=语言}	国家list
哪些欧洲国家讲汉语	{欧洲=地区, 汉语=语言}	国家list
哪些南美国家讲越南语	{南美=地区, 越南语=语言}	国家list
哪些东南亚国家讲德语	{东南亚=地区, 德语=语言}	国家list
哪些南美国家讲斯瓦希里语	{斯瓦希里语=语言, 南美=地区}	国家list
哪些亚洲国家讲法语	{亚洲=地区, 法语=语言}	国家list
哪些欧洲国家讲泰米尔语	{欧洲=地区, 泰米尔语=语言}	国家list
哪些东南亚国家讲汉语	{东南亚=地区, 汉语=语言}	国家list
哪些欧洲国家讲德语	{欧洲=地区, 德语=语言}	国家list
哪些亚洲国家讲意大利语	{亚洲=地区, 意大利语=语言}	国家list
哪些东南亚国家讲西班牙语	{东南亚=地区, 西班牙语=语言}	国家list
哪些南美国家讲日语	{日语=语言, 南美=地区}	国家list
哪些欧洲国家讲英语	{欧洲=地区, 英语=语言}	国家list
哪些欧洲国家讲日语	{日语=语言, 欧洲=地区}	国家list
哪些欧洲国家讲斯瓦希里语	{欧洲=地区, 斯瓦希里语=语言}	国家list
哪些东南亚国家讲阿拉伯语	{东南亚=地区, 阿拉伯语=语言}	国家list
哪些欧洲国家讲韩语	{欧洲=地区, 韩语=语言}	国家list
哪些南美国家讲俄语	{俄语=语言, 南美=地区}	国家list
哪些亚洲国家讲朝鲜语	{亚洲=地区, 朝鲜语=语言}	国家list
哪些东南亚国家讲朝鲜语	{东南亚=地区, 朝鲜语=语言}	国家list
哪些亚洲国家讲俄语	{亚洲=地区, 俄语=语言}	国家list
哪些南美国家讲阿拉伯语	{阿拉伯语=语言, 南美=地区}	国家list
哪些亚洲国家讲斯瓦希里语	{亚洲=地区, 斯瓦希里语=语言}	国家list
哪些南美国家讲意大利语	{意大利语=语言, 南美=地区}	国家list
哪些欧洲国家讲意大利语	{欧洲=地区, 意大利语=语言}	国家list
哪些亚洲国家讲德语	{亚洲=地区, 德语=语言}	国家list
哪些东南亚国家讲俄语	{东南亚=地区, 俄语=语言}	国家list
哪些欧洲国家讲阿拉伯语	{阿拉伯语=语言, 欧洲=地区}	国家list
哪些亚洲国家讲越南语	{亚洲=地区, 越南语=语言}	国家list
哪些欧洲国家讲俄语	{俄语=语言, 欧洲=地区}	国家list
哪些东南亚国家讲英语	{东南亚=地区, 英语=语言}	国家list
哪些欧洲国家讲越南语	{欧洲=地区, 越南语=语言}	国家list
哪些欧洲国家讲朝鲜语	{欧洲=地区, 朝鲜语=语言}	国家list
哪些亚洲国家讲英语	{亚洲=地区, 英语=语言}	国家list
哪些南美国家讲朝鲜语	{朝鲜语=语言, 南美=地区}	国家list
哪些亚洲国家讲泰米尔语	{亚洲=地区, 泰米尔语=语言}	国家list
哪些南美国家讲法语	{法语=语言, 南美=地区}	国家list
哪些亚洲国家讲西班牙语	{西班牙语=语言, 亚洲=地区}	国家list
哪些南美国家讲韩语	{韩语=语言, 南美=地区}	国家list
哪些亚洲国家讲日语	{亚洲=地区, 日语=语言}	国家list
都有哪些亚洲国家讲汉语	{亚洲=地区, 汉语=语言}	国家list
都有哪些欧洲国家讲意大利语	{欧洲=地区, 意大利语=语言}	国家list
都有哪些欧洲国家讲法语	{法语=语言, 欧洲=地区}	国家list
都有哪些南美国家讲汉语	{汉语=语言, 南美=地区}	国家list
都有哪些欧洲国家讲阿拉伯语	{阿拉伯语=语言, 欧洲=地区}	国家list
都有哪些东南亚国家讲韩语	{东南亚=地区, 韩语=语言}	国家list
都有哪些东南亚国家讲德语	{东南亚=地区, 德语=语言}	国家list
都有哪些南美国家讲意大利语	{意大利语=语言, 南美=地区}	国家list
都有哪些欧洲国家讲朝鲜语	{欧洲=地区, 朝鲜语=语言}	国家list
都有哪些亚洲国家讲朝鲜语	{亚洲=地区, 朝鲜语=语言}	国家list
都有哪些南美国家讲阿拉伯语	{阿拉伯语=语言, 南美=地区}	国家list
都有哪些亚洲国家讲西班牙语	{西班牙语=语言, 亚洲=地区}	国家list
都有哪些南美国家讲斯瓦希里语	{斯瓦希里语=语言, 南美=地区}	国家list
都有哪些欧洲国家讲俄语	{俄语=语言, 欧洲=地区}	国家list
都有哪些亚洲国家讲日语	{亚洲=地区, 日语=语言}	国家list
都有哪些南美国家讲西班牙语	{西班牙语=语言, 南美=地区}	国家list
都有哪些亚洲国家讲意大利语	{亚洲=地区, 意大利语=语言}	国家list
都有哪些欧洲国家讲日语	{日语=语言, 欧洲=地区}	国家list
都有哪些东南亚国家讲越南语	{东南亚=地区, 越南语=语言}	国家list
都有哪些东南亚国家讲意大利语	{东南亚=地区, 意大利语=语言}	国家list
都有哪些南美国家讲越南语	{南美=地区, 越南语=语言}	国家list
都有哪些东南亚国家讲英语	{东南亚=地区, 英语=语言}	国家list
都有哪些南美国家讲英语	{英语=语言, 南美=地区}	国家list
都有哪些南美国家讲法语	{法语=语言, 南美=地区}	国家list
都有哪些欧洲国家讲德语	{欧洲=地区, 德语=语言}	国家list
都有哪些亚洲国家讲德语	{亚洲=地区, 德语=语言}	国家list
都有哪些东南亚国家讲汉语	{东南亚=地区, 汉语=语言}	国家list
都有哪些亚洲国家讲越南语	{亚洲=地区, 越南语=语言}	国家list
都有哪些欧洲国家讲韩语	{欧洲=地区, 韩语=语言}	国家list
都有哪些南美国家讲日语	{日语=语言, 南美=地区}	国家list
都有哪些欧洲国家讲泰米尔语	{欧洲=地区, 泰米尔语=语言}	国家list
都有哪些东南亚国家讲斯瓦希里语	{东南亚=地区, 斯瓦希里语=语言}	国家list
都有哪些欧洲国家讲汉语	{欧洲=地区, 汉语=语言}	国家list
都有哪些欧洲国家讲越南语	{欧洲=地区, 越南语=语言}	国家list
都有哪些东南亚国家讲西班牙语	{东南亚=地区, 西班牙语=语言}	国家list
都有哪些南美国家讲泰米尔语	{泰米尔语=语言, 南美=地区}	国家list
都有哪些东南亚国家讲泰米尔语	{东南亚=地区, 泰米尔语=语言}	国家list
都有哪些欧洲国家讲英语	{欧洲=地区, 英语=语言}	国家list
都有哪些欧洲国家讲斯瓦希里语	{欧洲=地区, 斯瓦希里语=语言}	国家list
都有哪些亚洲国家讲英语	{亚洲=地区, 英语=语言}	国家list
都有哪些亚洲国家讲俄语	{亚洲=地区, 俄语=语言}	国家list
里昂的不可错过的美食	{里昂=城市}	美食
西归浦的不可错过的美食	{西归浦=城市}	美食
澳门的不可错过的美食	{澳门=城市}	美食
吉萨的不可错过的美食	{吉萨=城市}	美食
台北的不可错过的美食	{台北=城市}	美食
香港的不可错过的美食	{香港=城市}	美食
芭堤雅的不可错过的美食	{芭堤雅=城市}	美食
巴黎的不可错过的美食	{巴黎=城市}	美食
首尔的不可错过的美食	{首尔=城市}	美食
普吉岛的不可错过的美食	{普吉岛=城市}	美食
东京都有什么美食	{东京=城市}	美食
首尔都有什么美食	{首尔=城市}	美食
澳门都有什么美食	{澳门=城市}	美食
普吉岛都有什么美食	{普吉岛=城市}	美食
芭堤雅都有什么美食	{芭堤雅=城市}	美食
西归浦都有什么美食	{西归浦=城市}	美食
新加坡都有什么美食	{新加坡=城市}	美食
吉萨都有什么美食	{吉萨=城市}	美食
巴黎都有什么美食	{巴黎=城市}	美食
纽约市都有什么美食	{纽约市=城市}	美食
香港都有什么美食	{香港=城市}	美食
台北都有什么美食	{台北=城市}	美食
西归浦有什么美食	{西归浦=城市}	美食
里昂有什么美食	{里昂=城市}	美食
芭堤雅有什么美食	{芭堤雅=城市}	美食
普吉岛有什么美食	{普吉岛=城市}	美食
新加坡有什么美食	{新加坡=城市}	美食
首尔有什么美食	{首尔=城市}	美食
台北有什么美食	{台北=城市}	美食
纽约市有什么美食	{纽约市=城市}	美食
香港有什么美食	{香港=城市}	美食
吉萨有什么美食	{吉萨=城市}	美食
里昂有哪些美食	{里昂=城市}	美食
香港有哪些美食	{香港=城市}	美食
东京有哪些美食	{东京=城市}	美食
新加坡有哪些美食	{新加坡=城市}	美食
巴黎有哪些美食	{巴黎=城市}	美食
吉萨有哪些美食	{吉萨=城市}	美食
芭堤雅有哪些美食	{芭堤雅=城市}	美食
首尔有哪些美食	{首尔=城市}	美食
台北有哪些美食	{台北=城市}	美食
澳门有哪些美食	{澳门=城市}	美食
去东京应该吃什么	{东京=城市}	美食
去里昂应该吃什么	{里昂=城市}	美食
去吉萨应该吃什么	{吉萨=城市}	美食
去西归浦应该吃什么	{西归浦=城市}	美食
去芭堤雅应该吃什么	{芭堤雅=城市}	美食
去纽约市应该吃什么	{纽约市=城市}	美食
去普吉岛应该吃什么	{普吉岛=城市}	美食
去香港应该吃什么	{香港=城市}	美食
去澳门应该吃什么	{澳门=城市}	美食
应该去纽约市吃什么	{纽约市=城市}	美食
应该去香港吃什么	{香港=城市}	美食
应该去巴黎吃什么	{巴黎=城市}	美食
应该去首尔吃什么	{首尔=城市}	美食
应该去芭堤雅吃什么	{芭堤雅=城市}	美食
应该去澳门吃什么	{澳门=城市}	美食
应该去西归浦吃什么	{西归浦=城市}	美食
应该去东京吃什么	{东京=城市}	美食
应该去吉萨吃什么	{吉萨=城市}	美食
应该去里昂吃什么	{里昂=城市}	美食
应该去新加坡吃什么	{新加坡=城市}	美食
去吉萨要吃什么	{吉萨=城市}	美食
去首尔要吃什么	{首尔=城市}	美食
去台北要吃什么	{台北=城市}	美食
去纽约市要吃什么	{纽约市=城市}	美食
去东京要吃什么	{东京=城市}	美食
去里昂要吃什么	{里昂=城市}	美食
去澳门要吃什么	{澳门=城市}	美食
去新加坡要吃什么	{新加坡=城市}	美食
去香港要吃什么	{香港=城市}	美食
去西归浦要吃什么	{西归浦=城市}	美食
去巴黎要吃什么	{巴黎=城市}	美食
去芭堤雅要吃什么	{芭堤雅=城市}	美食
去台北能吃到什么	{台北=城市}	美食
去纽约市能吃到什么	{纽约市=城市}	美食
去芭堤雅能吃到什么	{芭堤雅=城市}	美食
去首尔能吃到什么	{首尔=城市}	美食
去里昂能吃到什么	{里昂=城市}	美食
去新加坡能吃到什么	{新加坡=城市}	美食
去普吉岛能吃到什么	{普吉岛=城市}	美食
去巴黎能吃到什么	{巴黎=城市}	美食
去西归浦能吃到什么	{西归浦=城市}	美食
去东京能吃到什么	{东京=城市}	美食
去澳门能吃到什么	{澳门=城市}	美食
去香港能吃到什么	{香港=城市}	美食
在首尔应该吃什么	{首尔=城市}	美食
在里昂应该吃什么	{里昂=城市}	美食
在台北应该吃什么	{台北=城市}	美食
在芭堤雅应该吃什么	{芭堤雅=城市}	美食
在澳门应该吃什么	{澳门=城市}	美食
在吉萨应该吃什么	{吉萨=城市}	美食
在东京应该吃什么	{东京=城市}	美食
在巴黎应该吃什么	{巴黎=城市}	美食
在香港应该吃什么	{香港=城市}	美食
在普吉岛应该吃什么	{普吉岛=城市}	美食
在新加坡应该吃什么	{新加坡=城市}	美食
在西归浦应该吃什么	{西归浦=城市}	美食
在纽约市应该吃什么	{纽约市=城市}	美食
在吉萨要吃什么	{吉萨=城市}	美食
在西归浦要吃什么	{西归浦=城市}	美食
在里昂要吃什么	{里昂=城市}	美食
在普吉岛要吃什么	{普吉岛=城市}	美食
在首尔要吃什么	{首尔=城市}	美食
在东京要吃什么	{东京=城市}	美食
在巴黎要吃什么	{巴黎=城市}	美食
在芭堤雅要吃什么	{芭堤雅=城市}	美食
在纽约市要吃什么	{纽约市=城市}	美食
在首尔能吃到什么	{首尔=城市}	美食
在纽约市能吃到什么	{纽约市=城市}	美食
在吉萨能吃到什么	{吉萨=城市}	美食
在东京能吃到什么	{东京=城市}	美食
在巴黎能吃到什么	{巴黎=城市}	美食
在芭堤雅能吃到什么	{芭堤雅=城市}	美食
在香港能吃到什么	{香港=城市}	美食
在里昂能吃到什么	{里昂=城市}	美食
在台北能吃到什么	{台北=城市}	美食
在西归浦能吃到什么	{西归浦=城市}	美食
在新加坡能吃到什么	{新加坡=城市}	美食
求推荐巴黎的美食	{巴黎=城市}	美食
求推荐西归浦的美食	{西归浦=城市}	美食
求推荐芭堤雅的美食	{芭堤雅=城市}	美食
求推荐澳门的美食	{澳门=城市}	美食
求推荐香港的美食	{香港=城市}	美食
求推荐台北的美食	{台北=城市}	美食
求推荐纽约市的美食	{纽约市=城市}	美食
求推荐吉萨的美食	{吉萨=城市}	美食
求推荐新加坡的美食	{新加坡=城市}	美食
求推荐首尔的美食	{首尔=城市}	美食
求推荐东京的美食	{东京=城市}	美食
求推荐普吉岛的美食	{普吉岛=城市}	美食
求推荐里昂的美食	{里昂=城市}	美食
推荐东京的美食	{东京=城市}	美食
推荐西归浦的美食	{西归浦=城市}	美食
推荐新加坡的美食	{新加坡=城市}	美食
推荐首尔的美食	{首尔=城市}	美食
推荐纽约市的美食	{纽约市=城市}	美食
推荐里昂的美食	{里昂=城市}	美食
推荐巴黎的美食	{巴黎=城市}	美食
推荐普吉岛的美食	{普吉岛=城市}	美食
推荐芭堤雅的美食	{芭堤雅=城市}	美食
推荐台北的美食	{台北=城市}	美食
推荐澳门的美食	{澳门=城市}	美食
普吉岛有什么吃的	{普吉岛=城市}	美食
纽约市有什么吃的	{纽约市=城市}	美食
东京有什么吃的	{东京=城市}	美食
台北有什么吃的	{台北=城市}	美食
新加坡有什么吃的	{新加坡=城市}	美食
西归浦有什么吃的	{西归浦=城市}	美食
吉萨有什么吃的	{吉萨=城市}	美食
巴黎有什么吃的	{巴黎=城市}	美食
澳门有什么吃的	{澳门=城市}	美食
首尔有什么吃的	{首尔=城市}	美食
香港有什么吃的	{香港=城市}	美食
芭堤雅有什么吃的	{芭堤雅=城市}	美食
西归浦的不可错过的美景	{西归浦=城市}	美景
澳门的不可错过的美景	{澳门=城市}	美景
巴黎的不可错过的美景	{巴黎=城市}	美景
吉萨的不可错过的美景	{吉萨=城市}	美景
纽约市的不可错过的美景	{纽约市=城市}	美景
首尔的不可错过的美景	{首尔=城市}	美景
新加坡的不可错过的美景	{新加坡=城市}	美景
台北的不可错过的美景	{台北=城市}	美景
里昂的不可错过的美景	{里昂=城市}	美景
香港的不可错过的美景	{香港=城市}	美景
吉萨都有什么美景	{吉萨=城市}	美景
巴黎都有什么美景	{巴黎=城市}	美景
首尔都有什么美景	{首尔=城市}	美景
澳门都有什么美景	{澳门=城市}	美景
里昂都有什么美景	{里昂=城市}	美景
台北都有什么美景	{台北=城市}	美景
香港都有什么美景	{香港=城市}	美景
西归浦都有什么美景	{西归浦=城市}	美景
纽约市都有什么美景	{纽约市=城市}	美景
普吉岛都有什么美景	{普吉岛=城市}	美景
东京都有什么美景	{东京=城市}	美景
澳门有什么美景	{澳门=城市}	美景
巴黎有什么美景	{巴黎=城市}	美景
吉萨有什么美景	{吉萨=城市}	美景
普吉岛有什么美景	{普吉岛=城市}	美景
首尔有什么美景	{首尔=城市}	美景
新加坡有什么美景	{新加坡=城市}	美景
台北有什么美景	{台北=城市}	美景
西归浦有什么美景	{西归浦=城市}	美景
香港有什么美景	{香港=城市}	美景
东京有什么美景	{东京=城市}	美景
芭堤雅有什么美景	{芭堤雅=城市}	美景
里昂有什么美景	{里昂=城市}	美景
里昂有哪些美景	{里昂=城市}	美景
澳门有哪些美景	{澳门=城市}	美景
吉萨有哪些美景	{吉萨=城市}	美景
新加坡有哪些美景	{新加坡=城市}	美景
纽约市有哪些美景	{纽约市=城市}	美景
台北有哪些美景	{台北=城市}	美景
东京有哪些美景	{东京=城市}	美景
巴黎有哪些美景	{巴黎=城市}	美景
芭堤雅有哪些美景	{芭堤雅=城市}	美景
普吉岛有哪些美景	{普吉岛=城市}	美景
香港有哪些美景	{香港=城市}	美景
首尔有哪些美景	{首尔=城市}	美景
西归浦有哪些美景	{西归浦=城市}	美景
去东京应该玩什么	{东京=城市}	美景
去台北应该玩什么	{台北=城市}	美景
去巴黎应该玩什么	{巴黎=城市}	美景
去香港应该玩什么	{香港=城市}	美景
去芭堤雅应该玩什么	{芭堤雅=城市}	美景
去纽约市应该玩什么	{纽约市=城市}	美景
去新加坡应该玩什么	{新加坡=城市}	美景
去西归浦应该玩什么	{西归浦=城市}	美景
去吉萨应该玩什么	{吉萨=城市}	美景
去澳门应该玩什么	{澳门=城市}	美景
去首尔应该玩什么	{首尔=城市}	美景
去里昂应该玩什么	{里昂=城市}	美景
应该去里昂玩什么	{里昂=城市}	美景
应该去新加坡玩什么	{新加坡=城市}	美景
应该去纽约市玩什么	{纽约市=城市}	美景
应该去香港玩什么	{香港=城市}	美景
应该去台北玩什么	{台北=城市}	美景
应该去芭堤雅玩什么	{芭堤雅=城市}	美景
应该去吉萨玩什么	{吉萨=城市}	美景
应该去普吉岛玩什么	{普吉岛=城市}	美景
应该去巴黎玩什么	{巴黎=城市}	美景
应该去西归浦玩什么	{西归浦=城市}	美景
去芭堤雅要玩什么	{芭堤雅=城市}	美景
去西归浦要玩什么	{西归浦=城市}	美景
去普吉岛要玩什么	{普吉岛=城市}	美景
去东京要玩什么	{东京=城市}	美景
去香港要玩什么	{香港=城市}	美景
去巴黎要玩什么	{巴黎=城市}	美景
去新加坡要玩什么	{新加坡=城市}	美景
去纽约市要玩什么	{纽约市=城市}	美景
去首尔要玩什么	{首尔=城市}	美景
去吉萨要玩什么	{吉萨=城市}	美景
去台北要玩什么	{台北=城市}	美景
去台北能玩到什么	{台北=城市}	美景
去香港能玩到什么	{香港=城市}	美景
去普吉岛能玩到什么	{普吉岛=城市}	美景
去首尔能玩到什么	{首尔=城市}	美景
去吉萨能玩到什么	{吉萨=城市}	美景
去里昂能玩到什么	{里昂=城市}	美景
去纽约市能玩到什么	{纽约市=城市}	美景
去芭堤雅能玩到什么	{芭堤雅=城市}	美景
去巴黎能玩到什么	{巴黎=城市}	美景
去澳门能玩到什么	{澳门=城市}	美景
在普吉岛应该玩什么	{普吉岛=城市}	美景
在巴黎应该玩什么	{巴黎=城市}	美景
在新加坡应该玩什么	{新加坡=城市}	美景
在首尔应该玩什么	{首尔=城市}	美景
在纽约市应该玩什么	{纽约市=城市}	美景
在东京应该玩什么	{东京=城市}	美景
在西归浦应该玩什么	{西归浦=城市}	美景
在香港应该玩什么	{香港=城市}	美景
在芭堤雅应该玩什么	{芭堤雅=城市}	美景
在里昂应该玩什么	{里昂=城市}	美景
在澳门应该玩什么	{澳门=城市}	美景
在台北应该玩什么	{台北=城市}	美景
在吉萨应该玩什么	{吉萨=城市}	美景
在普吉岛要玩什么	{普吉岛=城市}	美景
在澳门要玩什么	{澳门=城市}	美景
在纽约市要玩什么	{纽约市=城市}	美景
在西归浦要玩什么	{西归浦=城市}	美景
在香港要玩什么	{香港=城市}	美景
在芭堤雅要玩什么	{芭堤雅=城市}	美景
在首尔要玩什么	{首尔=城市}	美景
在吉萨要玩什么	{吉萨=城市}	美景
在里昂要玩什么	{里昂=城市}	美景
在台北要玩什么	{台北=城市}	美景
在东京要玩什么	{东京=城市}	美景
在巴黎要玩什么	{巴黎=城市}	美景
在里昂能玩到什么	{里昂=城市}	美景
在香港能玩到什么	{香港=城市}	美景
在澳门能玩到什么	{澳门=城市}	美景
在芭堤雅能玩到什么	{芭堤雅=城市}	美景
在普吉岛能玩到什么	{普吉岛=城市}	美景
在吉萨能玩到什么	{吉萨=城市}	美景
在首尔能玩到什么	{首尔=城市}	美景
在新加坡能玩到什么	{新加坡=城市}	美景
在巴黎能玩到什么	{巴黎=城市}	美景
在纽约市能玩到什么	{纽约市=城市}	美景
在台北能玩到什么	{台北=城市}	美景
求推荐芭堤雅的美景	{芭堤雅=城市}	美景
求推荐纽约市的美景	{纽约市=城市}	美景
求推荐新加坡的美景	{新加坡=城市}	美景
求推荐普吉岛的美景	{普吉岛=城市}	美景
求推荐里昂的美景	{里昂=城市}	美景
求推荐台北的美景	{台北=城市}	美景
求推荐香港的美景	{香港=城市}	美景
求推荐首尔的美景	{首尔=城市}	美景
求推荐西归浦的美景	{西归浦=城市}	美景
求推荐巴黎的美景	{巴黎=城市}	美景
推荐东京的美景	{东京=城市}	美景
推荐台北的美景	{台北=城市}	美景
推荐新加坡的美景	{新加坡=城市}	美景
推荐西归浦的美景	{西归浦=城市}	美景
推荐巴黎的美景	{巴黎=城市}	美景
推荐纽约市的美景	{纽约市=城市}	美景
推荐首尔的美景	{首尔=城市}	美景
推荐香港的美景	{香港=城市}	美景
推荐芭堤雅的美景	{芭堤雅=城市}	美景
推荐澳门的美景	{澳门=城市}	美景
推荐里昂的美景	{里昂=城市}	美景
纽约市有什么玩的	{纽约市=城市}	美景
普吉岛有什么玩的	{普吉岛=城市}	美景
西归浦有什么玩的	{西归浦=城市}	美景
巴黎有什么玩的	{巴黎=城市}	美景
澳门有什么玩的	{澳门=城市}	美景
新加坡有什么玩的	{新加坡=城市}	美景
吉萨有什么玩的	{吉萨=城市}	美景
芭堤雅有什么玩的	{芭堤雅=城市}	美景
香港有什么玩的	{香港=城市}	美景
里昂有什么玩的	{里昂=城市}	美景
台北有什么玩的	{台北=城市}	美景
普吉岛玩的地方	{普吉岛=城市}	美景
东京玩的地方	{东京=城市}	美景
澳门玩的地方	{澳门=城市}	美景
西归浦玩的地方	{西归浦=城市}	美景
台北玩的地方	{台北=城市}	美景
纽约市玩的地方	{纽约市=城市}	美景
香港玩的地方	{香港=城市}	美景
巴黎玩的地方	{巴黎=城市}	美景
新加坡玩的地方	{新加坡=城市}	美景
里昂玩的地方	{里昂=城市}	美景
芭堤雅玩的地方	{芭堤雅=城市}	美景
在里昂该去哪儿	{里昂=城市}	美景
在东京该去哪儿	{东京=城市}	美景
在纽约市该去哪儿	{纽约市=城市}	美景
在澳门该去哪儿	{澳门=城市}	美景
在芭堤雅该去哪儿	{芭堤雅=城市}	美景
在吉萨该去哪儿	{吉萨=城市}	美景
在新加坡该去哪儿	{新加坡=城市}	美景
在台北该去哪儿	{台北=城市}	美景
在香港该去哪儿	{香港=城市}	美景
在首尔该去哪儿	{首尔=城市}	美景
在巴黎该去哪儿	{巴黎=城市}	美景
在西归浦该去哪儿	{西归浦=城市}	美景
台北都有什么可以买的	{台北=城市}	购物推荐
首尔都有什么可以买的	{首尔=城市}	购物推荐
芭堤雅都有什么可以买的	{芭堤雅=城市}	购物推荐
香港都有什么可以买的	{香港=城市}	购物推荐
西归浦都有什么可以买的	{西归浦=城市}	购物推荐
里昂都有什么可以买的	{里昂=城市}	购物推荐
新加坡都有什么可以买的	{新加坡=城市}	购物推荐
吉萨都有什么可以买的	{吉萨=城市}	购物推荐
澳门都有什么可以买的	{澳门=城市}	购物推荐
普吉岛都有什么可以买的	{普吉岛=城市}	购物推荐
纽约市都有什么可以买的	{纽约市=城市}	购物推荐
巴黎都有什么可以买的	{巴黎=城市}	购物推荐
东京有什么可以买的	{东京=城市}	购物推荐
纽约市有什么可以买的	{纽约市=城市}	购物推荐
西归浦有什么可以买的	{西归浦=城市}	购物推荐
新加坡有什么可以买的	{新加坡=城市}	购物推荐
首尔有什么可以买的	{首尔=城市}	购物推荐
里昂有什么可以买的	{里昂=城市}	购物推荐
普吉岛有什么可以买的	{普吉岛=城市}	购物推荐
香港有什么可以买的	{香港=城市}	购物推荐
台北有什么可以买的	{台北=城市}	购物推荐
澳门有什么可以买的	{澳门=城市}	购物推荐
巴黎有什么可以买的	{巴黎=城市}	购物推荐
芭堤雅有什么可以买的	{芭堤雅=城市}	购物推荐
吉萨有什么可以买的	{吉萨=城市}	购物推荐
芭堤雅有哪些可以买的	{芭堤雅=城市}	购物推荐
里昂有哪些可以买的	{里昂=城市}	购物推荐
首尔有哪些可以买的	{首尔=城市}	购物推荐
香港有哪些可以买的	{香港=城市}	购物推荐
西归浦有哪些可以买的	{西归浦=城市}	购物推荐
澳门有哪些可以买的	{澳门=城市}	购物推荐
台北有哪些可以买的	{台北=城市}	购物推荐
新加坡有哪些可以买的	{新加坡=城市}	购物推荐
普吉岛有哪些可以买的	{普吉岛=城市}	购物推荐
东京有哪些可以买的	{东京=城市}	购物推荐
去东京应该买什么	{东京=城市}	购物推荐
去普吉岛应该买什么	{普吉岛=城市}	购物推荐
去首尔应该买什么	{首尔=城市}	购物推荐
去西归浦应该买什么	{西归浦=城市}	购物推荐
去巴黎应该买什么	{巴黎=城市}	购物推荐
去吉萨应该买什么	{吉萨=城市}	购物推荐
去里昂应该买什么	{里昂=城市}	购物推荐
去香港应该买什么	{香港=城市}	购物推荐
去芭堤雅应该买什么	{芭堤雅=城市}	购物推荐
去新加坡应该买什么	{新加坡=城市}	购物推荐
去纽约市应该买什么	{纽约市=城市}	购物推荐
应该去芭堤雅买什么	{芭堤雅=城市}	购物推荐
应该去里昂买什么	{里昂=城市}	购物推荐
应该去巴黎买什么	{巴黎=城市}	购物推荐
应该去吉萨买什么	{吉萨=城市}	购物推荐
应该去普吉岛买什么	{普吉岛=城市}	购物推荐
应该去西归浦买什么	{西归浦=城市}	购物推荐
应该去台北买什么	{台北=城市}	购物推荐
应该去澳门买什么	{澳门=城市}	购物推荐
应该去纽约市买什么	{纽约市=城市}	购物推荐
应该去东京买什么	{东京=城市}	购物推荐
应该去香港买什么	{香港=城市}	购物推荐
应该去首尔买什么	{首尔=城市}	购物推荐
去普吉岛要买什么	{普吉岛=城市}	购物推荐
去澳门要买什么	{澳门=城市}	购物推荐
去芭堤雅要买什么	{芭堤雅=城市}	购物推荐
去巴黎要买什么	{巴黎=城市}	购物推荐
去首尔要买什么	{首尔=城市}	购物推荐
去香港要买什么	{香港=城市}	购物推荐
去纽约市要买什么	{纽约市=城市}	购物推荐
去新加坡要买什么	{新加坡=城市}	购物推荐
去台北要买什么	{台北=城市}	购物推荐
去里昂要买什么	{里昂=城市}	购物推荐
去吉萨要买什么	{吉萨=城市}	购物推荐
去西归浦要买什么	{西归浦=城市}	购物推荐
去东京要买什么	{东京=城市}	购物推荐
去首尔能买到什么	{首尔=城市}	购物推荐
去东京能买到什么	{东京=城市}	购物推荐
去香港能买到什么	{香港=城市}	购物推荐
去澳门能买到什么	{澳门=城市}	购物推荐
去芭堤雅能买到什么	{芭堤雅=城市}	购物推荐
去新加坡能买到什么	{新加坡=城市}	购物推荐
去普吉岛能买到什么	{普吉岛=城市}	购物推荐
去纽约市能买到什么	{纽约市=城市}	购物推荐
去吉萨能买到什么	{吉萨=城市}	购物推荐
去台北能买到什么	{台北=城市}	购物推荐
去里昂能买到什么	{里昂=城市}	购物推荐
在东京应该买什么	{东京=城市}	购物推荐
在西归浦应该买什么	{西归浦=城市}	购物推荐
在纽约市应该买什么	{纽约市=城市}	购物推荐
在普吉岛应该买什么	{普吉岛=城市}	购物推荐
在巴黎应该买什么	{巴黎=城市}	购物推荐
在香港应该买什么	{香港=城市}	购物推荐
在首尔应该买什么	{首尔=城市}	购物推荐
在芭堤雅应该买什么	{芭堤雅=城市}	购物推荐
在吉萨应该买什么	{吉萨=城市}	购物推荐
在新加坡应该买什么	{新加坡=城市}	购物推荐
在台北应该买什么	{台北=城市}	购物推荐
在西归浦要买什么	{西归浦=城市}	购物推荐
在吉萨要买什么	{吉萨=城市}	购物推荐
在新加坡要买什么	{新加坡=城市}	购物推荐
在巴黎要买什么	{巴黎=城市}	购物推荐
在东京要买什么	{东京=城市}	购物推荐
在台北要买什么	{台北=城市}	购物推荐
在澳门要买什么	{澳门=城市}	购物推荐
在香港要买什么	{香港=城市}	购物推荐
在普吉岛要买什么	{普吉岛=城市}	购物推荐
在纽约市能买到什么	{纽约市=城市}	购物推荐
在新加坡能买到什么	{新加坡=城市}	购物推荐
在西归浦能买到什么	{西归浦=城市}	购物推荐
在里昂能买到什么	{里昂=城市}	购物推荐
在首尔能买到什么	{首尔=城市}	购物推荐
在澳门能买到什么	{澳门=城市}	购物推荐
在吉萨能买到什么	{吉萨=城市}	购物推荐
在香港能买到什么	{香港=城市}	购物推荐
在普吉岛能买到什么	{普吉岛=城市}	购物推荐
在东京能买到什么	{东京=城市}	购物推荐
在芭堤雅能买到什么	{芭堤雅=城市}	购物推荐
求推荐首尔的商品	{首尔=城市}	购物推荐
求推荐香港的商品	{香港=城市}	购物推荐
求推荐巴黎的商品	{巴黎=城市}	购物推荐
求推荐吉萨的商品	{吉萨=城市}	购物推荐
求推荐西归浦的商品	{西归浦=城市}	购物推荐
求推荐台北的商品	{台北=城市}	购物推荐
求推荐里昂的商品	{里昂=城市}	购物推荐
求推荐澳门的商品	{澳门=城市}	购物推荐
求推荐芭堤雅的商品	{芭堤雅=城市}	购物推荐
推荐台北的商品	{台北=城市}	购物推荐
推荐纽约市的商品	{纽约市=城市}	购物推荐
推荐吉萨的商品	{吉萨=城市}	购物推荐
推荐芭堤雅的商品	{芭堤雅=城市}	购物推荐
推荐里昂的商品	{里昂=城市}	购物推荐
推荐普吉岛的商品	{普吉岛=城市}	购物推荐
推荐东京的商品	{东京=城市}	购物推荐
推荐首尔的商品	{首尔=城市}	购物推荐
推荐巴黎的商品	{巴黎=城市}	购物推荐
推荐西归浦的商品	{西归浦=城市}	购物推荐
推荐香港的商品	{香港=城市}	购物推荐
推荐新加坡的商品	{新加坡=城市}	购物推荐
推荐澳门的商品	{澳门=城市}	购物推荐
澳门有什么可以买的	{澳门=城市}	购物推荐
巴黎有什么可以买的	{巴黎=城市}	购物推荐
台北有什么可以买的	{台北=城市}	购物推荐
纽约市有什么可以买的	{纽约市=城市}	购物推荐
芭堤雅有什么可以买的	{芭堤雅=城市}	购物推荐
普吉岛有什么可以买的	{普吉岛=城市}	购物推荐
东京有什么可以买的	{东京=城市}	购物推荐
西归浦有什么可以买的	{西归浦=城市}	购物推荐
新加坡有什么可以买的	{新加坡=城市}	购物推荐
首尔有什么可以买的	{首尔=城市}	购物推荐
里昂有什么可以买的	{里昂=城市}	购物推荐
吉萨有什么可以买的	{吉萨=城市}	购物推荐
首尔的人口是多少	{首尔=城市}	人口
西归浦的人口是多少	{西归浦=城市}	人口
普吉岛的人口是多少	{普吉岛=城市}	人口
香港的人口是多少	{香港=城市}	人口
里昂的人口是多少	{里昂=城市}	人口
纽约市的人口是多少	{纽约市=城市}	人口
新加坡的人口是多少	{新加坡=城市}	人口
吉萨有多少人	{吉萨=城市}	人口
台北有多少人	{台北=城市}	人口
普吉岛有多少人	{普吉岛=城市}	人口
西归浦有多少人	{西归浦=城市}	人口
新加坡有多少人	{新加坡=城市}	人口
东京有多少人	{东京=城市}	人口
纽约市有多少人	{纽约市=城市}	人口
香港有多少人	{香港=城市}	人口
芭堤雅有多少人	{芭堤雅=城市}	人口
首尔有多少人	{首尔=城市}	人口
澳门有多少人	{澳门=城市}	人口
新加坡的人口多吗	{新加坡=城市}	人口
芭堤雅的人口多吗	{芭堤雅=城市}	人口
纽约市的人口多吗	{纽约市=城市}	人口
东京的人口多吗	{东京=城市}	人口
台北的人口多吗	{台北=城市}	人口
巴黎的人口多吗	{巴黎=城市}	人口
首尔的人口多吗	{首尔=城市}	人口
普吉岛的人口多吗	{普吉岛=城市}	人口
巴黎人口有多少	{巴黎=城市}	人口
吉萨人口有多少	{吉萨=城市}	人口
西归浦人口有多少	{西归浦=城市}	人口
香港人口有多少	{香港=城市}	人口
首尔人口有多少	{首尔=城市}	人口
澳门人口有多少	{澳门=城市}	人口
东京人口有多少	{东京=城市}	人口
纽约市人口有多少	{纽约市=城市}	人口
里昂人口有多少	{里昂=城市}	人口
新加坡人口有多少	{新加坡=城市}	人口
芭堤雅人口有多少	{芭堤雅=城市}	人口
新加坡人口多吗	{新加坡=城市}	人口
芭堤雅人口多吗	{芭堤雅=城市}	人口
吉萨人口多吗	{吉萨=城市}	人口
香港人口多吗	{香港=城市}	人口
里昂人口多吗	{里昂=城市}	人口
台北人口多吗	{台北=城市}	人口
巴黎人口多吗	{巴黎=城市}	人口
纽约市人口多吗	{纽约市=城市}	人口
西归浦人口多吗	{西归浦=城市}	人口
首尔人口多吗	{首尔=城市}	人口
东京人口多吗	{东京=城市}	人口
普吉岛人口多吗	{普吉岛=城市}	人口
澳门人口多吗	{澳门=城市}	人口
新加坡人口是多少	{新加坡=城市}	人口
吉萨人口是多少	{吉萨=城市}	人口
东京人口是多少	{东京=城市}	人口
芭堤雅人口是多少	{芭堤雅=城市}	人口
纽约市人口是多少	{纽约市=城市}	人口
里昂人口是多少	{里昂=城市}	人口
台北人口是多少	{台北=城市}	人口
西归浦人口是多少	{西归浦=城市}	人口
澳门人口是多少	{澳门=城市}	人口
普吉岛人口是多少	{普吉岛=城市}	人口
吉萨住了多少人	{吉萨=城市}	人口
巴黎住了多少人	{巴黎=城市}	人口
香港住了多少人	{香港=城市}	人口
台北住了多少人	{台北=城市}	人口
普吉岛住了多少人	{普吉岛=城市}	人口
东京住了多少人	{东京=城市}	人口
澳门住了多少人	{澳门=城市}	人口
西归浦住了多少人	{西归浦=城市}	人口
首尔住了多少人	{首尔=城市}	人口
芭堤雅住了多少人	{芭堤雅=城市}	人口
新加坡住了多少人	{新加坡=城市}	人口
纽约市住了多少人	{纽约市=城市}	人口
东京有多少人口	{东京=城市}	人口
台北有多少人口	{台北=城市}	人口
巴黎有多少人口	{巴黎=城市}	人口
西归浦有多少人口	{西归浦=城市}	人口
新加坡有多少人口	{新加坡=城市}	人口
纽约市有多少人口	{纽约市=城市}	人口
里昂有多少人口	{里昂=城市}	人口
首尔有多少人口	{首尔=城市}	人口
吉萨有多少人口	{吉萨=城市}	人口
普吉岛有多少人口	{普吉岛=城市}	人口
香港有多少人口	{香港=城市}	人口
台北人口数量	{台北=城市}	人口
普吉岛人口数量	{普吉岛=城市}	人口
巴黎人口数量	{巴黎=城市}	人口
新加坡人口数量	{新加坡=城市}	人口
芭堤雅人口数量	{芭堤雅=城市}	人口
东京人口数量	{东京=城市}	人口
首尔人口数量	{首尔=城市}	人口
吉萨人口数量	{吉萨=城市}	人口
香港人口数量	{香港=城市}	人口
里昂人口数量	{里昂=城市}	人口
纽约市人口数量	{纽约市=城市}	人口
澳门人口数量	{澳门=城市}	人口
西归浦人口数量	{西归浦=城市}	人口
里昂人多吗	{里昂=城市}	人口
首尔人多吗	{首尔=城市}	人口
芭堤雅人多吗	{芭堤雅=城市}	人口
台北人多吗	{台北=城市}	人口
新加坡人多吗	{新加坡=城市}	人口
澳门人多吗	{澳门=城市}	人口
纽约市人多吗	{纽约市=城市}	人口
普吉岛人多吗	{普吉岛=城市}	人口
香港人多吗	{香港=城市}	人口
西归浦人多吗	{西归浦=城市}	人口
香港面积是多少	{香港=城市}	面积
澳门面积是多少	{澳门=城市}	面积
芭堤雅面积是多少	{芭堤雅=城市}	面积
巴黎面积是多少	{巴黎=城市}	面积
里昂面积是多少	{里昂=城市}	面积
普吉岛面积是多少	{普吉岛=城市}	面积
首尔面积是多少	{首尔=城市}	面积
新加坡面积是多少	{新加坡=城市}	面积
吉萨面积是多少	{吉萨=城市}	面积
西归浦面积是多少	{西归浦=城市}	面积
东京面积是多少	{东京=城市}	面积
台北面积是多少	{台北=城市}	面积
吉萨多大	{吉萨=城市}	面积
里昂多大	{里昂=城市}	面积
西归浦多大	{西归浦=城市}	面积
普吉岛多大	{普吉岛=城市}	面积
香港多大	{香港=城市}	面积
新加坡多大	{新加坡=城市}	面积
芭堤雅多大	{芭堤雅=城市}	面积
台北多大	{台北=城市}	面积
纽约市多大	{纽约市=城市}	面积
澳门多大	{澳门=城市}	面积
首尔多大	{首尔=城市}	面积
巴黎多大	{巴黎=城市}	面积
东京多大	{东京=城市}	面积
西归浦大吗	{西归浦=城市}	面积
东京大吗	{东京=城市}	面积
台北大吗	{台北=城市}	面积
巴黎大吗	{巴黎=城市}	面积
芭堤雅大吗	{芭堤雅=城市}	面积
首尔大吗	{首尔=城市}	面积
澳门大吗	{澳门=城市}	面积
纽约市大吗	{纽约市=城市}	面积
香港大吗	{香港=城市}	面积
纽约市小吗	{纽约市=城市}	面积
里昂小吗	{里昂=城市}	面积
吉萨小吗	{吉萨=城市}	面积
台北小吗	{台北=城市}	面积
澳门小吗	{澳门=城市}	面积
西归浦小吗	{西归浦=城市}	面积
新加坡小吗	{新加坡=城市}	面积
芭堤雅小吗	{芭堤雅=城市}	面积
东京小吗	{东京=城市}	面积
巴黎小吗	{巴黎=城市}	面积
西归浦有多大	{西归浦=城市}	面积
香港有多大	{香港=城市}	面积
芭堤雅有多大	{芭堤雅=城市}	面积
东京有多大	{东京=城市}	面积
吉萨有多大	{吉萨=城市}	面积
澳门有多大	{澳门=城市}	面积
普吉岛有多大	{普吉岛=城市}	面积
新加坡有多大	{新加坡=城市}	面积
首尔有多大	{首尔=城市}	面积
台北有多大	{台北=城市}	面积
里昂有多大	{里昂=城市}	面积
纽约市有多大	{纽约市=城市}	面积
纽约市的面积	{纽约市=城市}	面积
澳门的面积	{澳门=城市}	面积
香港的面积	{香港=城市}	面积
新加坡的面积	{新加坡=城市}	面积
吉萨的面积	{吉萨=城市}	面积
台北的面积	{台北=城市}	面积
东京的面积	{东京=城市}	面积
巴黎的面积	{巴黎=城市}	面积
芭堤雅的面积	{芭堤雅=城市}	面积
普吉岛的面积	{普吉岛=城市}	面积
里昂的面积	{里昂=城市}	面积
西归浦的面积	{西归浦=城市}	面积
首尔的面积	{首尔=城市}	面积
澳门占地面积	{澳门=城市}	面积
西归浦占地面积	{西归浦=城市}	面积
新加坡占地面积	{新加坡=城市}	面积
普吉岛占地面积	{普吉岛=城市}	面积
里昂占地面积	{里昂=城市}	面积
香港占地面积	{香港=城市}	面积
东京占地面积	{东京=城市}	面积
首尔占地面积	{首尔=城市}	面积
纽约市占地面积	{纽约市=城市}	面积
吉萨占地面积	{吉萨=城市}	面积
台北的面积有多大	{台北=城市}	面积
普吉岛的面积有多大	{普吉岛=城市}	面积
芭堤雅的面积有多大	{芭堤雅=城市}	面积
西归浦的面积有多大	{西归浦=城市}	面积
澳门的面积有多大	{澳门=城市}	面积
里昂的面积有多大	{里昂=城市}	面积
香港的面积有多大	{香港=城市}	面积
东京的面积有多大	{东京=城市}	面积
纽约市的面积有多大	{纽约市=城市}	面积
首尔的面积有多大	{首尔=城市}	面积
巴黎的面积有多大	{巴黎=城市}	面积
吉萨的面积有多大	{吉萨=城市}	面积
巴黎的面积有多少	{巴黎=城市}	面积
纽约市的面积有多少	{纽约市=城市}	面积
香港的面积有多少	{香港=城市}	面积
吉萨的面积有多少	{吉萨=城市}	面积
首尔的面积有多少	{首尔=城市}	面积
新加坡的面积有多少	{新加坡=城市}	面积
台北的面积有多少	{台北=城市}	面积
里昂的面积有多少	{里昂=城市}	面积
澳门的面积有多少	{澳门=城市}	面积
芭堤雅的面积有多少	{芭堤雅=城市}	面积
东京的面积有多少	{东京=城市}	面积
普吉岛的面积有多少	{普吉岛=城市}	面积
里昂的面积是多少	{里昂=城市}	面积
纽约市的面积是多少	{纽约市=城市}	面积
台北的面积是多少	{台北=城市}	面积
香港的面积是多少	{香港=城市}	面积
东京的面积是多少	{东京=城市}	面积
巴黎的面积是多少	{巴黎=城市}	面积
吉萨的面积是多少	{吉萨=城市}	面积
新加坡的面积是多少	{新加坡=城市}	面积
首尔的面积是多少	{首尔=城市}	面积
西归浦很大吗	{西归浦=城市}	面积
香港很大吗	{香港=城市}	面积
台北很大吗	{台北=城市}	面积
澳门很大吗	{澳门=城市}	面积
吉萨很大吗	{吉萨=城市}	面积
巴黎很大吗	{巴黎=城市}	面积
纽约市很大吗	{纽约市=城市}	面积
里昂很大吗	{里昂=城市}	面积
新加坡很大吗	{新加坡=城市}	面积
普吉岛很大吗	{普吉岛=城市}	面积
芭堤雅很大吗	{芭堤雅=城市}	面积
东京很大吗	{东京=城市}	面积
台北在哪儿	{台北=城市}	位置
西归浦在哪儿	{西归浦=城市}	位置
东京在哪儿	{东京=城市}	位置
澳门在哪儿	{澳门=城市}	位置
香港在哪儿	{香港=城市}	位置
里昂在哪儿	{里昂=城市}	位置
吉萨在哪儿	{吉萨=城市}	位置
普吉岛在哪儿	{普吉岛=城市}	位置
巴黎在哪儿	{巴黎=城市}	位置
芭堤雅在哪儿	{芭堤雅=城市}	位置
新加坡在哪儿	{新加坡=城市}	位置
首尔在什么地方	{首尔=城市}	位置
澳门在什么地方	{澳门=城市}	位置
西归浦在什么地方	{西归浦=城市}	位置
新加坡在什么地方	{新加坡=城市}	位置
巴黎在什么地方	{巴黎=城市}	位置
里昂在什么地方	{里昂=城市}	位置
芭堤雅在什么地方	{芭堤雅=城市}	位置
香港在什么地方	{香港=城市}	位置
台北在什么地方	{台北=城市}	位置
东京在什么地方	{东京=城市}	位置
纽约市在什么地方	{纽约市=城市}	位置
普吉岛在什么地方	{普吉岛=城市}	位置
吉萨在什么地方	{吉萨=城市}	位置
香港位于哪里	{香港=城市}	位置
台北位于哪里	{台北=城市}	位置
新加坡位于哪里	{新加坡=城市}	位置
吉萨位于哪里	{吉萨=城市}	位置
里昂位于哪里	{里昂=城市}	位置
普吉岛位于哪里	{普吉岛=城市}	位置
巴黎位于哪里	{巴黎=城市}	位置
东京位于哪里	{东京=城市}	位置
首尔位于哪里	{首尔=城市}	位置
纽约市位于哪里	{纽约市=城市}	位置
西归浦位于哪里	{西归浦=城市}	位置
澳门位于哪里	{澳门=城市}	位置
香港位于哪儿	{香港=城市}	位置
新加坡位于哪儿	{新加坡=城市}	位置
普吉岛位于哪儿	{普吉岛=城市}	位置
芭堤雅位于哪儿	{芭堤雅=城市}	位置
吉萨位于哪儿	{吉萨=城市}	位置
台北位于哪儿	{台北=城市}	位置
东京位于哪儿	{东京=城市}	位置
西归浦位于哪儿	{西归浦=城市}	位置
首尔位于哪儿	{首尔=城市}	位置
西归浦位于什么地方	{西归浦=城市}	位置
里昂位于什么地方	{里昂=城市}	位置
吉萨位于什么地方	{吉萨=城市}	位置
纽约市位于什么地方	{纽约市=城市}	位置
普吉岛位于什么地方	{普吉岛=城市}	位置
新加坡位于什么地方	{新加坡=城市}	位置
台北位于什么地方	{台北=城市}	位置
澳门位于什么地方	{澳门=城市}	位置
巴黎位于什么地方	{巴黎=城市}	位置
首尔位于什么地方	{首尔=城市}	位置
芭堤雅位于什么地方	{芭堤雅=城市}	位置
