介绍一下美国签证的难度	{难度=签证特定信息属性}	1.签证办理的全部详细信息
介绍一下美国签证的签证种类	{签证种类=签证特定信息属性}	1.签证办理的全部详细信息
介绍一下美国签证的准备材料	{准备材料=签证特定信息属性}	1.签证办理的全部详细信息
介绍一下美国签证的先期条件	{先期条件=签证特定信息属性}	1.签证办理的全部详细信息
玩儿怎么办签证	{玩儿=签证种类相关词}	1.签证办理的全部详细信息
出国旅行怎么办签证	{出国旅行=签证种类相关词}	1.签证办理的全部详细信息
去冈山怎么办签证	{冈山=签证地理位置}	1.签证办理的全部详细信息
去洛杉矶怎么办签证	{洛杉矶=签证地理位置}	1.签证办理的全部详细信息
去贡布怎么办签证	{贡布=签证地理位置}	1.签证办理的全部详细信息
去内坦亚怎么办签证	{内坦亚=签证地理位置}	1.签证办理的全部详细信息
去会安怎么办签证	{会安=签证地理位置}	1.签证办理的全部详细信息
去吉萨怎么办签证	{吉萨=签证地理位置}	1.签证办理的全部详细信息
去奥马鲁怎么办签证	{奥马鲁=签证地理位置}	1.签证办理的全部详细信息
去蓝山怎么办签证	{蓝山=签证地理位置}	1.签证办理的全部详细信息
去仁川怎么办签证	{仁川=签证地理位置}	1.签证办理的全部详细信息
去拜伦湾怎么办签证	{拜伦湾=签证地理位置}	1.签证办理的全部详细信息
去基隆怎么办签证	{基隆=签证地理位置}	1.签证办理的全部详细信息
去维罗纳怎么办签证	{维罗纳=签证地理位置}	1.签证办理的全部详细信息
去春川怎么办签证	{春川=签证地理位置}	1.签证办理的全部详细信息
去格蒙登怎么办签证	{格蒙登=签证地理位置}	1.签证办理的全部详细信息
去蒙特雷怎么办签证	{蒙特雷=签证地理位置}	1.签证办理的全部详细信息
去凯米怎么办签证	{凯米=签证地理位置}	1.签证办理的全部详细信息
去巴哈马怎么办签证	{巴哈马=签证地理位置}	1.签证办理的全部详细信息
去马尼拉怎么办签证	{马尼拉=签证地理位置}	1.签证办理的全部详细信息
去塔巴怎么办签证	{塔巴=签证地理位置}	1.签证办理的全部详细信息
去土耳其怎么办签证	{土耳其=签证地理位置}	1.签证办理的全部详细信息
去日惹怎么办签证	{日惹=签证地理位置}	1.签证办理的全部详细信息
去西班牙怎么办签证	{西班牙=签证地理位置}	1.签证办理的全部详细信息
去兰卡威怎么办签证	{兰卡威=签证地理位置}	1.签证办理的全部详细信息
去梅赫伦怎么办签证	{梅赫伦=签证地理位置}	1.签证办理的全部详细信息
去云林怎么办签证	{云林=签证地理位置}	1.签证办理的全部详细信息
去南非怎么办签证	{南非=签证地理位置}	1.签证办理的全部详细信息
去萨斯费怎么办签证	{萨斯费=签证地理位置}	1.签证办理的全部详细信息
去泰国怎么办签证	{泰国=签证地理位置}	1.签证办理的全部详细信息
去罗得岛怎么办签证	{罗得岛=签证地理位置}	1.签证办理的全部详细信息
去怡保怎么办签证	{怡保=签证地理位置}	1.签证办理的全部详细信息
去箱根怎么办签证	{箱根=签证地理位置}	1.签证办理的全部详细信息
去阿尔勒怎么办签证	{阿尔勒=签证地理位置}	1.签证办理的全部详细信息
去勃固怎么办签证	{勃固=签证地理位置}	1.签证办理的全部详细信息
去胡萨维克怎么办签证	{胡萨维克=签证地理位置}	1.签证办理的全部详细信息
去琅南塔怎么办签证	{琅南塔=签证地理位置}	1.签证办理的全部详细信息
去阿瓦诺斯怎么办签证	{阿瓦诺斯=签证地理位置}	1.签证办理的全部详细信息
去爪哇岛怎么办签证	{爪哇岛=签证地理位置}	1.签证办理的全部详细信息
去赞丹怎么办签证	{赞丹=签证地理位置}	1.签证办理的全部详细信息
去安吉利斯怎么办签证	{安吉利斯=签证地理位置}	1.签证办理的全部详细信息
去卡利怎么办签证	{卡利=签证地理位置}	1.签证办理的全部详细信息
去越南怎么办签证	{越南=签证地理位置}	1.签证办理的全部详细信息
去塞萨洛尼基怎么办签证	{塞萨洛尼基=签证地理位置}	1.签证办理的全部详细信息
去汉堡怎么办签证	{汉堡=签证地理位置}	1.签证办理的全部详细信息
去施瓦茨怎么办签证	{施瓦茨=签证地理位置}	1.签证办理的全部详细信息
去卡罗维发利怎么办签证	{卡罗维发利=签证地理位置}	1.签证办理的全部详细信息
去西雅图怎么办签证	{西雅图=签证地理位置}	1.签证办理的全部详细信息
去阿巴斯港怎么办签证	{阿巴斯港=签证地理位置}	1.签证办理的全部详细信息
去伊卡怎么办签证	{伊卡=签证地理位置}	1.签证办理的全部详细信息
去长野怎么办签证	{长野=签证地理位置}	1.签证办理的全部详细信息
去纳塔尔怎么办签证	{纳塔尔=签证地理位置}	1.签证办理的全部详细信息
去亭可马里怎么办签证	{亭可马里=签证地理位置}	1.签证办理的全部详细信息
去圣克鲁斯怎么办签证	{圣克鲁斯=签证地理位置}	1.签证办理的全部详细信息
去芬兰怎么办签证	{芬兰=签证地理位置}	1.签证办理的全部详细信息
去布达佩斯怎么办签证	{布达佩斯=签证地理位置}	1.签证办理的全部详细信息
去以色列怎么办签证	{以色列=签证地理位置}	1.签证办理的全部详细信息
去宿雾怎么办签证	{宿雾=签证地理位置}	1.签证办理的全部详细信息
去泰尔奇怎么办签证	{泰尔奇=签证地理位置}	1.签证办理的全部详细信息
去拉包尔怎么办签证	{拉包尔=签证地理位置}	1.签证办理的全部详细信息
去拿骚怎么办签证	{拿骚=签证地理位置}	1.签证办理的全部详细信息
去慕尼黑怎么办签证	{慕尼黑=签证地理位置}	1.签证办理的全部详细信息
去里尔怎么办签证	{里尔=签证地理位置}	1.签证办理的全部详细信息
去网走怎么办签证	{网走=签证地理位置}	1.签证办理的全部详细信息
去乌斯怀亚怎么办签证	{乌斯怀亚=签证地理位置}	1.签证办理的全部详细信息
去横滨怎么办签证	{横滨=签证地理位置}	1.签证办理的全部详细信息
去帕萨迪纳怎么办签证	{帕萨迪纳=签证地理位置}	1.签证办理的全部详细信息
去所罗门群岛怎么办签证	{所罗门群岛=签证地理位置}	1.签证办理的全部详细信息
去拉哈尔怎么办签证	{拉哈尔=签证地理位置}	1.签证办理的全部详细信息
去宫古岛怎么办签证	{宫古岛=签证地理位置}	1.签证办理的全部详细信息
去拿撒勒怎么办签证	{拿撒勒=签证地理位置}	1.签证办理的全部详细信息
去华盛顿怎么办签证	{华盛顿=签证地理位置}	1.签证办理的全部详细信息
去萨斯卡通怎么办签证	{萨斯卡通=签证地理位置}	1.签证办理的全部详细信息
去温特图尔怎么办签证	{温特图尔=签证地理位置}	1.签证办理的全部详细信息
去圣彼得堡怎么办签证	{圣彼得堡=签证地理位置}	1.签证办理的全部详细信息
去塞维利亚怎么办签证	{塞维利亚=签证地理位置}	1.签证办理的全部详细信息
去夏蒙尼怎么办签证	{夏蒙尼=签证地理位置}	1.签证办理的全部详细信息
去克鲁姆洛夫怎么办签证	{克鲁姆洛夫=签证地理位置}	1.签证办理的全部详细信息
去纽伦堡怎么办签证	{纽伦堡=签证地理位置}	1.签证办理的全部详细信息
去代尔夫特怎么办签证	{代尔夫特=签证地理位置}	1.签证办理的全部详细信息
去尼姆怎么办签证	{尼姆=签证地理位置}	1.签证办理的全部详细信息
去富良野怎么办签证	{富良野=签证地理位置}	1.签证办理的全部详细信息
去阿里山怎么办签证	{阿里山=签证地理位置}	1.签证办理的全部详细信息
去万荣怎么办签证	{万荣=签证地理位置}	1.签证办理的全部详细信息
去仰光怎么办签证	{仰光=签证地理位置}	1.签证办理的全部详细信息
去拉什特怎么办签证	{拉什特=签证地理位置}	1.签证办理的全部详细信息
去马尔代夫怎么办签证	{马尔代夫=签证地理位置}	1.签证办理的全部详细信息
去伯克利怎么办签证	{伯克利=签证地理位置}	1.签证办理的全部详细信息
去圣塞瓦斯蒂安怎么办签证	{圣塞瓦斯蒂安=签证地理位置}	1.签证办理的全部详细信息
去兰达岛怎么办签证	{兰达岛=签证地理位置}	1.签证办理的全部详细信息
去圣安娜怎么办签证	{圣安娜=签证地理位置}	1.签证办理的全部详细信息
去圣安德烈怎么办签证	{圣安德烈=签证地理位置}	1.签证办理的全部详细信息
去龙仁市怎么办签证	{龙仁市=签证地理位置}	1.签证办理的全部详细信息
去普诺怎么办签证	{普诺=签证地理位置}	1.签证办理的全部详细信息
去蒂瑟默哈拉默怎么办签证	{蒂瑟默哈拉默=签证地理位置}	1.签证办理的全部详细信息
去克里特岛怎么办签证	{克里特岛=签证地理位置}	1.签证办理的全部详细信息
去罗萨里奥怎么办签证	{罗萨里奥=签证地理位置}	1.签证办理的全部详细信息
去斯卡恩怎么办签证	{斯卡恩=签证地理位置}	1.签证办理的全部详细信息
去柏威夏怎么办签证	{柏威夏=签证地理位置}	1.签证办理的全部详细信息
去五渔村怎么办签证	{五渔村=签证地理位置}	1.签证办理的全部详细信息
去海兰泡怎么办签证	{海兰泡=签证地理位置}	1.签证办理的全部详细信息
去老挝怎么办签证	{老挝=签证地理位置}	1.签证办理的全部详细信息
去赖扬出国旅行需要怎么办签证	{赖扬=签证地理位置, 出国旅行=签证种类相关词}	1.签证办理的全部详细信息
去伊势玩儿需要怎么办签证	{玩儿=签证种类相关词, 伊势=签证地理位置}	1.签证办理的全部详细信息
去沙迦出国旅行需要怎么办签证	{沙迦=签证地理位置, 出国旅行=签证种类相关词}	1.签证办理的全部详细信息
去坎莫尔玩儿需要怎么办签证	{玩儿=签证种类相关词, 坎莫尔=签证地理位置}	1.签证办理的全部详细信息
去佩奇玩儿需要怎么办签证	{佩奇=签证地理位置, 玩儿=签证种类相关词}	1.签证办理的全部详细信息
去安特卫普玩儿需要怎么办签证	{安特卫普=签证地理位置, 玩儿=签证种类相关词}	1.签证办理的全部详细信息
去多伦多出国旅行需要怎么办签证	{多伦多=签证地理位置, 出国旅行=签证种类相关词}	1.签证办理的全部详细信息
去夏蒙尼出国旅行需要怎么办签证	{夏蒙尼=签证地理位置, 出国旅行=签证种类相关词}	1.签证办理的全部详细信息
去千叶市出国旅行需要怎么办签证	{千叶市=签证地理位置, 出国旅行=签证种类相关词}	1.签证办理的全部详细信息
去基尔根尼玩儿需要怎么办签证	{玩儿=签证种类相关词, 基尔根尼=签证地理位置}	1.签证办理的全部详细信息
去博拉博拉岛玩儿需要怎么办签证	{玩儿=签证种类相关词, 博拉博拉岛=签证地理位置}	1.签证办理的全部详细信息
去波尔图出国旅行需要怎么办签证	{波尔图=签证地理位置, 出国旅行=签证种类相关词}	1.签证办理的全部详细信息
去阿吉曼出国旅行需要怎么办签证	{阿吉曼=签证地理位置, 出国旅行=签证种类相关词}	1.签证办理的全部详细信息
去门多萨出国旅行需要怎么办签证	{门多萨=签证地理位置, 出国旅行=签证种类相关词}	1.签证办理的全部详细信息
去美瑛玩儿需要怎么办签证	{美瑛=签证地理位置, 玩儿=签证种类相关词}	1.签证办理的全部详细信息
去巴塞卢什玩儿需要怎么办签证	{巴塞卢什=签证地理位置, 玩儿=签证种类相关词}	1.签证办理的全部详细信息
去萨法加玩儿需要怎么办签证	{玩儿=签证种类相关词, 萨法加=签证地理位置}	1.签证办理的全部详细信息
去沙姆沙伊赫出国旅行需要怎么办签证	{沙姆沙伊赫=签证地理位置, 出国旅行=签证种类相关词}	1.签证办理的全部详细信息
去叶卡捷琳堡出国旅行需要怎么办签证	{出国旅行=签证种类相关词, 叶卡捷琳堡=签证地理位置}	1.签证办理的全部详细信息
去北九州玩儿需要怎么办签证	{玩儿=签证种类相关词, 北九州=签证地理位置}	1.签证办理的全部详细信息
去美因茨玩儿需要怎么办签证	{玩儿=签证种类相关词, 美因茨=签证地理位置}	1.签证办理的全部详细信息
去埃拉特玩儿需要怎么办签证	{埃拉特=签证地理位置, 玩儿=签证种类相关词}	1.签证办理的全部详细信息
去格林德瓦玩儿需要怎么办签证	{格林德瓦=签证地理位置, 玩儿=签证种类相关词}	1.签证办理的全部详细信息
去格雷茅斯出国旅行需要怎么办签证	{格雷茅斯=签证地理位置, 出国旅行=签证种类相关词}	1.签证办理的全部详细信息
去玛瑙斯市玩儿需要怎么办签证	{玩儿=签证种类相关词, 玛瑙斯市=签证地理位置}	1.签证办理的全部详细信息
去光州出国旅行需要怎么办签证	{出国旅行=签证种类相关词, 光州=签证地理位置}	1.签证办理的全部详细信息
去蒂豪尼玩儿需要怎么办签证	{蒂豪尼=签证地理位置, 玩儿=签证种类相关词}	1.签证办理的全部详细信息
去广岛出国旅行需要怎么办签证	{广岛=签证地理位置, 出国旅行=签证种类相关词}	1.签证办理的全部详细信息
去惠灵顿玩儿需要怎么办签证	{惠灵顿=签证地理位置, 玩儿=签证种类相关词}	1.签证办理的全部详细信息
去柏林出国旅行需要怎么办签证	{柏林=签证地理位置, 出国旅行=签证种类相关词}	1.签证办理的全部详细信息
去东京玩儿需要怎么办签证	{玩儿=签证种类相关词, 东京=签证地理位置}	1.签证办理的全部详细信息
去埃格尔玩儿需要怎么办签证	{玩儿=签证种类相关词, 埃格尔=签证地理位置}	1.签证办理的全部详细信息
去加拿大出国旅行需要怎么办签证	{加拿大=签证地理位置, 出国旅行=签证种类相关词}	1.签证办理的全部详细信息
去亭可马里玩儿需要怎么办签证	{亭可马里=签证地理位置, 玩儿=签证种类相关词}	1.签证办理的全部详细信息
去堪培拉出国旅行需要怎么办签证	{出国旅行=签证种类相关词, 堪培拉=签证地理位置}	1.签证办理的全部详细信息
去拉斯帕尔马斯玩儿需要怎么办签证	{玩儿=签证种类相关词, 拉斯帕尔马斯=签证地理位置}	1.签证办理的全部详细信息
去雅典出国旅行需要怎么办签证	{雅典=签证地理位置, 出国旅行=签证种类相关词}	1.签证办理的全部详细信息
去图尔库出国旅行需要怎么办签证	{出国旅行=签证种类相关词, 图尔库=签证地理位置}	1.签证办理的全部详细信息
去尼斯玩儿需要怎么办签证	{尼斯=签证地理位置, 玩儿=签证种类相关词}	1.签证办理的全部详细信息
去哈瑟尔特玩儿需要怎么办签证	{哈瑟尔特=签证地理位置, 玩儿=签证种类相关词}	1.签证办理的全部详细信息
去俄罗斯出国旅行需要怎么办签证	{俄罗斯=签证地理位置, 出国旅行=签证种类相关词}	1.签证办理的全部详细信息
去塞维利亚玩儿需要怎么办签证	{塞维利亚=签证地理位置, 玩儿=签证种类相关词}	1.签证办理的全部详细信息
去卡劳出国旅行需要怎么办签证	{卡劳=签证地理位置, 出国旅行=签证种类相关词}	1.签证办理的全部详细信息
去琅勃拉邦玩儿需要怎么办签证	{玩儿=签证种类相关词, 琅勃拉邦=签证地理位置}	1.签证办理的全部详细信息
去密西沙加出国旅行需要怎么办签证	{密西沙加=签证地理位置, 出国旅行=签证种类相关词}	1.签证办理的全部详细信息
去檀香山玩儿需要怎么办签证	{玩儿=签证种类相关词, 檀香山=签证地理位置}	1.签证办理的全部详细信息
去长崎出国旅行需要怎么办签证	{长崎=签证地理位置, 出国旅行=签证种类相关词}	1.签证办理的全部详细信息
去函馆玩儿需要怎么办签证	{函馆=签证地理位置, 玩儿=签证种类相关词}	1.签证办理的全部详细信息
去鲁汶出国旅行需要怎么办签证	{鲁汶=签证地理位置, 出国旅行=签证种类相关词}	1.签证办理的全部详细信息
去会晒玩儿需要怎么办签证	{会晒=签证地理位置, 玩儿=签证种类相关词}	1.签证办理的全部详细信息
去斯卡恩玩儿需要怎么办签证	{玩儿=签证种类相关词, 斯卡恩=签证地理位置}	1.签证办理的全部详细信息
去圣地亚哥-德孔波斯特拉玩儿需要怎么办签证	{玩儿=签证种类相关词, 圣地亚哥-德孔波斯特拉=签证地理位置}	1.签证办理的全部详细信息
去捷克布杰约维采出国旅行需要怎么办签证	{捷克布杰约维采=签证地理位置, 出国旅行=签证种类相关词}	1.签证办理的全部详细信息
去特内里费岛玩儿需要怎么办签证	{特内里费岛=签证地理位置, 玩儿=签证种类相关词}	1.签证办理的全部详细信息
去布里斯班玩儿需要怎么办签证	{玩儿=签证种类相关词, 布里斯班=签证地理位置}	1.签证办理的全部详细信息
去苏莱曼尼亚出国旅行需要怎么办签证	{苏莱曼尼亚=签证地理位置, 出国旅行=签证种类相关词}	1.签证办理的全部详细信息
去莫雷阿岛出国旅行需要怎么办签证	{莫雷阿岛=签证地理位置, 出国旅行=签证种类相关词}	1.签证办理的全部详细信息
去圣塞瓦斯蒂安玩儿需要怎么办签证	{圣塞瓦斯蒂安=签证地理位置, 玩儿=签证种类相关词}	1.签证办理的全部详细信息
去德国玩儿需要怎么办签证	{玩儿=签证种类相关词, 德国=签证地理位置}	1.签证办理的全部详细信息
去圣克拉拉玩儿需要怎么办签证	{圣克拉拉=签证地理位置, 玩儿=签证种类相关词}	1.签证办理的全部详细信息
去那不勒斯出国旅行需要怎么办签证	{那不勒斯=签证地理位置, 出国旅行=签证种类相关词}	1.签证办理的全部详细信息
去摩尔曼斯克玩儿需要怎么办签证	{玩儿=签证种类相关词, 摩尔曼斯克=签证地理位置}	1.签证办理的全部详细信息
去库塔玩儿需要怎么办签证	{玩儿=签证种类相关词, 库塔=签证地理位置}	1.签证办理的全部详细信息
去昌原玩儿需要怎么办签证	{玩儿=签证种类相关词, 昌原=签证地理位置}	1.签证办理的全部详细信息
去垦丁玩儿需要怎么办签证	{垦丁=签证地理位置, 玩儿=签证种类相关词}	1.签证办理的全部详细信息
去泰尔奇玩儿需要怎么办签证	{泰尔奇=签证地理位置, 玩儿=签证种类相关词}	1.签证办理的全部详细信息
去奥比都斯玩儿需要怎么办签证	{奥比都斯=签证地理位置, 玩儿=签证种类相关词}	1.签证办理的全部详细信息
去阿雷格里港玩儿需要怎么办签证	{阿雷格里港=签证地理位置, 玩儿=签证种类相关词}	1.签证办理的全部详细信息
去彰化出国旅行需要怎么办签证	{彰化=签证地理位置, 出国旅行=签证种类相关词}	1.签证办理的全部详细信息
去英国出国旅行需要怎么办签证	{英国=签证地理位置, 出国旅行=签证种类相关词}	1.签证办理的全部详细信息
去萨拉曼卡出国旅行需要怎么办签证	{萨拉曼卡=签证地理位置, 出国旅行=签证种类相关词}	1.签证办理的全部详细信息
去伊瓜苏港玩儿需要怎么办签证	{伊瓜苏港=签证地理位置, 玩儿=签证种类相关词}	1.签证办理的全部详细信息
去普吉岛玩儿需要怎么办签证	{玩儿=签证种类相关词, 普吉岛=签证地理位置}	1.签证办理的全部详细信息
去冲绳玩儿需要怎么办签证	{玩儿=签证种类相关词, 冲绳=签证地理位置}	1.签证办理的全部详细信息
去巴斯出国旅行需要怎么办签证	{巴斯=签证地理位置, 出国旅行=签证种类相关词}	1.签证办理的全部详细信息
去荷兰出国旅行需要怎么办签证	{荷兰=签证地理位置, 出国旅行=签证种类相关词}	1.签证办理的全部详细信息
去以色列玩儿需要怎么办签证	{以色列=签证地理位置, 玩儿=签证种类相关词}	1.签证办理的全部详细信息
去希欧福克玩儿需要怎么办签证	{希欧福克=签证地理位置, 玩儿=签证种类相关词}	1.签证办理的全部详细信息
去霍尼亚拉玩儿需要怎么办签证	{霍尼亚拉=签证地理位置, 玩儿=签证种类相关词}	1.签证办理的全部详细信息
去海法玩儿需要怎么办签证	{海法=签证地理位置, 玩儿=签证种类相关词}	1.签证办理的全部详细信息
去爱丽丝泉出国旅行需要怎么办签证	{爱丽丝泉=签证地理位置, 出国旅行=签证种类相关词}	1.签证办理的全部详细信息
去沙夫豪森玩儿需要怎么办签证	{玩儿=签证种类相关词, 沙夫豪森=签证地理位置}	1.签证办理的全部详细信息
去里雄莱锡安出国旅行需要怎么办签证	{里雄莱锡安=签证地理位置, 出国旅行=签证种类相关词}	1.签证办理的全部详细信息
去费城出国旅行需要怎么办签证	{费城=签证地理位置, 出国旅行=签证种类相关词}	1.签证办理的全部详细信息
去圣加仑玩儿需要怎么办签证	{圣加仑=签证地理位置, 玩儿=签证种类相关词}	1.签证办理的全部详细信息
去伊豆出国旅行需要怎么办签证	{伊豆=签证地理位置, 出国旅行=签证种类相关词}	1.签证办理的全部详细信息
去耶路撒冷玩儿需要怎么办签证	{耶路撒冷=签证地理位置, 玩儿=签证种类相关词}	1.签证办理的全部详细信息
去埃兹出国旅行需要怎么办签证	{埃兹=签证地理位置, 出国旅行=签证种类相关词}	1.签证办理的全部详细信息
去伊拉克利翁玩儿需要怎么办签证	{伊拉克利翁=签证地理位置, 玩儿=签证种类相关词}	1.签证办理的全部详细信息
去爱尔兰玩儿需要怎么办签证	{爱尔兰=签证地理位置, 玩儿=签证种类相关词}	1.签证办理的全部详细信息
去埃斯泰尔戈姆玩儿需要怎么办签证	{玩儿=签证种类相关词, 埃斯泰尔戈姆=签证地理位置}	1.签证办理的全部详细信息
去隆德出国旅行需要怎么办签证	{隆德=签证地理位置, 出国旅行=签证种类相关词}	1.签证办理的全部详细信息
去栋索尔出国旅行需要怎么办签证	{栋索尔=签证地理位置, 出国旅行=签证种类相关词}	1.签证办理的全部详细信息
去第戎出国旅行需要怎么办签证	{第戎=签证地理位置, 出国旅行=签证种类相关词}	1.签证办理的全部详细信息
去恩纳出国旅行需要怎么办签证	{恩纳=签证地理位置, 出国旅行=签证种类相关词}	1.签证办理的全部详细信息
去圣莫里茨玩儿需要怎么办签证	{圣莫里茨=签证地理位置, 玩儿=签证种类相关词}	1.签证办理的全部详细信息
去蒂阿瑙出国旅行需要怎么办签证	{蒂阿瑙=签证地理位置, 出国旅行=签证种类相关词}	1.签证办理的全部详细信息
去怡保出国旅行需要怎么办签证	{怡保=签证地理位置, 出国旅行=签证种类相关词}	1.签证办理的全部详细信息
去凯萨莉亚玩儿需要怎么办签证	{凯萨莉亚=签证地理位置, 玩儿=签证种类相关词}	1.签证办理的全部详细信息
去马尔代夫出国旅行需要怎么办签证	{马尔代夫=签证地理位置, 出国旅行=签证种类相关词}	1.签证办理的全部详细信息
办签证要多久	{}	[所需时长]
办西雅图需要多久	{西雅图=签证地理位置}	[所需时长]
办春川需要多久	{春川=签证地理位置}	[所需时长]
办加里宁格勒需要多久	{加里宁格勒=签证地理位置}	[所需时长]
办多伦多需要多久	{多伦多=签证地理位置}	[所需时长]
办捷克需要多久	{捷克=签证地理位置}	[所需时长]
办利雅得需要多久	{利雅得=签证地理位置}	[所需时长]
办大分需要多久	{大分=签证地理位置}	[所需时长]
办马尔默需要多久	{马尔默=签证地理位置}	[所需时长]
办槟城需要多久	{槟城=签证地理位置}	[所需时长]
办丽水需要多久	{丽水=签证地理位置}	[所需时长]
办萨拉戈萨需要多久	{萨拉戈萨=签证地理位置}	[所需时长]
办林雪平需要多久	{林雪平=签证地理位置}	[所需时长]
办英国湖区需要多久	{英国湖区=签证地理位置}	[所需时长]
办公主港需要多久	{公主港=签证地理位置}	[所需时长]
办董里需要多久	{董里=签证地理位置}	[所需时长]
办库塔需要多久	{库塔=签证地理位置}	[所需时长]
办民丹岛需要多久	{民丹岛=签证地理位置}	[所需时长]
办阿洛陶需要多久	{阿洛陶=签证地理位置}	[所需时长]
办特罗姆瑟需要多久	{特罗姆瑟=签证地理位置}	[所需时长]
办基洛夫需要多久	{基洛夫=签证地理位置}	[所需时长]
办伊萨菲厄泽需要多久	{伊萨菲厄泽=签证地理位置}	[所需时长]
办印度尼西亚需要多久	{印度尼西亚=签证地理位置}	[所需时长]
办加拿大需要多久	{加拿大=签证地理位置}	[所需时长]
办赫尔辛堡需要多久	{赫尔辛堡=签证地理位置}	[所需时长]
办沃特福德需要多久	{沃特福德=签证地理位置}	[所需时长]
办米什科尔茨需要多久	{米什科尔茨=签证地理位置}	[所需时长]
办纽卡斯尔需要多久	{纽卡斯尔=签证地理位置}	[所需时长]
办纳塔尔需要多久	{纳塔尔=签证地理位置}	[所需时长]
办凯库拉需要多久	{凯库拉=签证地理位置}	[所需时长]
办亚历山大需要多久	{亚历山大=签证地理位置}	[所需时长]
办尼斯需要多久	{尼斯=签证地理位置}	[所需时长]
办万荣需要多久	{万荣=签证地理位置}	[所需时长]
办伏尔加格勒需要多久	{伏尔加格勒=签证地理位置}	[所需时长]
办开普敦需要多久	{开普敦=签证地理位置}	[所需时长]
办瓦胡卡岛需要多久	{瓦胡卡岛=签证地理位置}	[所需时长]
办撒丁岛需要多久	{撒丁岛=签证地理位置}	[所需时长]
办特鲁希略需要多久	{特鲁希略=签证地理位置}	[所需时长]
办丹麦需要多久	{丹麦=签证地理位置}	[所需时长]
办圣莫尼卡需要多久	{圣莫尼卡=签证地理位置}	[所需时长]
办阿讷西需要多久	{阿讷西=签证地理位置}	[所需时长]
办但尼丁需要多久	{但尼丁=签证地理位置}	[所需时长]
办瓦伊塔佩需要多久	{瓦伊塔佩=签证地理位置}	[所需时长]
办帕萨迪纳需要多久	{帕萨迪纳=签证地理位置}	[所需时长]
办马来西亚需要多久	{马来西亚=签证地理位置}	[所需时长]
办布达佩斯需要多久	{布达佩斯=签证地理位置}	[所需时长]
办水原需要多久	{水原=签证地理位置}	[所需时长]
办檀香山需要多久	{檀香山=签证地理位置}	[所需时长]
办帕拉阿图需要多久	{帕拉阿图=签证地理位置}	[所需时长]
办特内里费岛需要多久	{特内里费岛=签证地理位置}	[所需时长]
办里雄莱锡安需要多久	{里雄莱锡安=签证地理位置}	[所需时长]
办琅多需要多久	{琅多=签证地理位置}	[所需时长]
办休伊需要多久	{休伊=签证地理位置}	[所需时长]
办金边需要多久	{金边=签证地理位置}	[所需时长]
办布宜诺斯艾利斯需要多久	{布宜诺斯艾利斯=签证地理位置}	[所需时长]
办陶尔米纳需要多久	{陶尔米纳=签证地理位置}	[所需时长]
办亚庇需要多久	{亚庇=签证地理位置}	[所需时长]
办本托特需要多久	{本托特=签证地理位置}	[所需时长]
办柏林需要多久	{柏林=签证地理位置}	[所需时长]
办清莱需要多久	{清莱=签证地理位置}	[所需时长]
办丹老需要多久	{丹老=签证地理位置}	[所需时长]
办萨斯费需要多久	{萨斯费=签证地理位置}	[所需时长]
办巴厘巴板需要多久	{巴厘巴板=签证地理位置}	[所需时长]
办阿罗萨需要多久	{阿罗萨=签证地理位置}	[所需时长]
办卢克索需要多久	{卢克索=签证地理位置}	[所需时长]
办科莫需要多久	{科莫=签证地理位置}	[所需时长]
办塔布阿苏需要多久	{塔布阿苏=签证地理位置}	[所需时长]
办博德需要多久	{博德=签证地理位置}	[所需时长]
办瑞士需要多久	{瑞士=签证地理位置}	[所需时长]
办马尼拉需要多久	{马尼拉=签证地理位置}	[所需时长]
办阿威罗需要多久	{阿威罗=签证地理位置}	[所需时长]
办塞得港需要多久	{塞得港=签证地理位置}	[所需时长]
办川崎需要多久	{川崎=签证地理位置}	[所需时长]
办日内瓦需要多久	{日内瓦=签证地理位置}	[所需时长]
办佐贺需要多久	{佐贺=签证地理位置}	[所需时长]
办堪培拉需要多久	{堪培拉=签证地理位置}	[所需时长]
办尼泊尔需要多久	{尼泊尔=签证地理位置}	[所需时长]
办棉花堡需要多久	{棉花堡=签证地理位置}	[所需时长]
办迪南需要多久	{迪南=签证地理位置}	[所需时长]
办埃斯波需要多久	{埃斯波=签证地理位置}	[所需时长]
办利物浦需要多久	{利物浦=签证地理位置}	[所需时长]
办巴西需要多久	{巴西=签证地理位置}	[所需时长]
办格拉纳达需要多久	{格拉纳达=签证地理位置}	[所需时长]
办清州需要多久	{清州=签证地理位置}	[所需时长]
办阿维拉需要多久	{阿维拉=签证地理位置}	[所需时长]
办锡耶纳需要多久	{锡耶纳=签证地理位置}	[所需时长]
办珀斯需要多久	{珀斯=签证地理位置}	[所需时长]
办白沙瓦需要多久	{白沙瓦=签证地理位置}	[所需时长]
办西归浦需要多久	{西归浦=签证地理位置}	[所需时长]
办韩国需要多久	{韩国=签证地理位置}	[所需时长]
办长滩需要多久	{长滩=签证地理位置}	[所需时长]
办希腊需要多久	{希腊=签证地理位置}	[所需时长]
办莱蒂西亚需要多久	{莱蒂西亚=签证地理位置}	[所需时长]
办首尔需要多久	{首尔=签证地理位置}	[所需时长]
办苏兹达尔需要多久	{苏兹达尔=签证地理位置}	[所需时长]
办塔巴需要多久	{塔巴=签证地理位置}	[所需时长]
办萨尔茨堡需要多久	{萨尔茨堡=签证地理位置}	[所需时长]
办蒲甘需要多久	{蒲甘=签证地理位置}	[所需时长]
办法蒂玛需要多久	{法蒂玛=签证地理位置}	[所需时长]
办玛丽亚温泉市需要多久	{玛丽亚温泉市=签证地理位置}	[所需时长]
办美奈需要多久	{美奈=签证地理位置}	[所需时长]
办签证要多久需要准备什么材料	{}	[所需时长][准备材料]
小孩儿怎么办理安卡拉签证	{小孩儿=特定人群, 安卡拉=签证地理位置}	1.签证办理的全部详细信息
军人怎么办理克拉克签证	{克拉克=签证地理位置, 军人=特定人群}	1.签证办理的全部详细信息
小孩儿怎么办理塔伊夫签证	{塔伊夫=签证地理位置, 小孩儿=特定人群}	1.签证办理的全部详细信息
军人怎么办理龙达签证	{军人=特定人群, 龙达=签证地理位置}	1.签证办理的全部详细信息
小朋友怎么办理约翰内斯堡签证	{约翰内斯堡=签证地理位置, 小朋友=特定人群}	1.签证办理的全部详细信息
残疾人怎么办理都柏林签证	{残疾人=特定人群, 都柏林=签证地理位置}	1.签证办理的全部详细信息
小朋友怎么办理锡尔赫特签证	{锡尔赫特=签证地理位置, 小朋友=特定人群}	1.签证办理的全部详细信息
军人怎么办理特鲁希略签证	{特鲁希略=签证地理位置, 军人=特定人群}	1.签证办理的全部详细信息
老人怎么办理波尔多签证	{老人=特定人群, 波尔多=签证地理位置}	1.签证办理的全部详细信息
小孩儿怎么办理波尔蒂芒签证	{小孩儿=特定人群, 波尔蒂芒=签证地理位置}	1.签证办理的全部详细信息
残疾人怎么办理杜塞尔多夫签证	{残疾人=特定人群, 杜塞尔多夫=签证地理位置}	1.签证办理的全部详细信息
小孩儿怎么办理沙努尔签证	{小孩儿=特定人群, 沙努尔=签证地理位置}	1.签证办理的全部详细信息
小朋友怎么办理旭川签证	{小朋友=特定人群, 旭川=签证地理位置}	1.签证办理的全部详细信息
小朋友怎么办理蔚山签证	{蔚山=签证地理位置, 小朋友=特定人群}	1.签证办理的全部详细信息
残疾人怎么办理新北签证	{残疾人=特定人群, 新北=签证地理位置}	1.签证办理的全部详细信息
残疾人怎么办理布鲁塞尔签证	{残疾人=特定人群, 布鲁塞尔=签证地理位置}	1.签证办理的全部详细信息
小孩儿怎么办理巴西利亚签证	{小孩儿=特定人群, 巴西利亚=签证地理位置}	1.签证办理的全部详细信息
残疾人怎么办理费城签证	{费城=签证地理位置, 残疾人=特定人群}	1.签证办理的全部详细信息
小朋友怎么办理阿巴斯港签证	{小朋友=特定人群, 阿巴斯港=签证地理位置}	1.签证办理的全部详细信息
小朋友怎么办理埃拉特签证	{埃拉特=签证地理位置, 小朋友=特定人群}	1.签证办理的全部详细信息
军人怎么办理万鸦老签证	{军人=特定人群, 万鸦老=签证地理位置}	1.签证办理的全部详细信息
老人怎么办理设拉子签证	{老人=特定人群, 设拉子=签证地理位置}	1.签证办理的全部详细信息
老人怎么办理白马市签证	{老人=特定人群, 白马市=签证地理位置}	1.签证办理的全部详细信息
小朋友怎么办理基尔根尼签证	{小朋友=特定人群, 基尔根尼=签证地理位置}	1.签证办理的全部详细信息
老人怎么办理南极半岛签证	{老人=特定人群, 南极半岛=签证地理位置}	1.签证办理的全部详细信息
残疾人怎么办理圣地亚哥签证	{残疾人=特定人群, 圣地亚哥=签证地理位置}	1.签证办理的全部详细信息
小朋友怎么办理釜山签证	{釜山=签证地理位置, 小朋友=特定人群}	1.签证办理的全部详细信息
小朋友怎么办理阿雷格里港签证	{阿雷格里港=签证地理位置, 小朋友=特定人群}	1.签证办理的全部详细信息
老人怎么办理丹布勒签证	{老人=特定人群, 丹布勒=签证地理位置}	1.签证办理的全部详细信息
小孩儿怎么办理埃拉特签证	{小孩儿=特定人群, 埃拉特=签证地理位置}	1.签证办理的全部详细信息
军人怎么办理撒丁岛签证	{军人=特定人群, 撒丁岛=签证地理位置}	1.签证办理的全部详细信息
小朋友怎么办理科克斯巴扎尔签证	{小朋友=特定人群, 科克斯巴扎尔=签证地理位置}	1.签证办理的全部详细信息
军人怎么办理杜塞尔多夫签证	{军人=特定人群, 杜塞尔多夫=签证地理位置}	1.签证办理的全部详细信息
小朋友怎么办理哈瑟尔特签证	{哈瑟尔特=签证地理位置, 小朋友=特定人群}	1.签证办理的全部详细信息
老人怎么办理坡州签证	{老人=特定人群, 坡州=签证地理位置}	1.签证办理的全部详细信息
残疾人怎么办理萨斯费签证	{残疾人=特定人群, 萨斯费=签证地理位置}	1.签证办理的全部详细信息
小孩儿怎么办理亚琛签证	{小孩儿=特定人群, 亚琛=签证地理位置}	1.签证办理的全部详细信息
老人怎么办理阿里山签证	{阿里山=签证地理位置, 老人=特定人群}	1.签证办理的全部详细信息
残疾人怎么办理土耳其签证	{土耳其=签证地理位置, 残疾人=特定人群}	1.签证办理的全部详细信息
残疾人怎么办理澎湖列岛签证	{澎湖列岛=签证地理位置, 残疾人=特定人群}	1.签证办理的全部详细信息
小朋友怎么办理惠灵顿签证	{惠灵顿=签证地理位置, 小朋友=特定人群}	1.签证办理的全部详细信息
老人怎么办理神户签证	{老人=特定人群, 神户=签证地理位置}	1.签证办理的全部详细信息
小朋友怎么办理塞格德签证	{塞格德=签证地理位置, 小朋友=特定人群}	1.签证办理的全部详细信息
军人怎么办理法尤姆签证	{法尤姆=签证地理位置, 军人=特定人群}	1.签证办理的全部详细信息
军人怎么办理哈尔施塔特签证	{军人=特定人群, 哈尔施塔特=签证地理位置}	1.签证办理的全部详细信息
军人怎么办理拉斯海马签证	{军人=特定人群, 拉斯海马=签证地理位置}	1.签证办理的全部详细信息
小孩儿怎么办理吉萨签证	{小孩儿=特定人群, 吉萨=签证地理位置}	1.签证办理的全部详细信息
小孩儿怎么办理博卡拉签证	{小孩儿=特定人群, 博卡拉=签证地理位置}	1.签证办理的全部详细信息
小朋友怎么办理兰卡威签证	{小朋友=特定人群, 兰卡威=签证地理位置}	1.签证办理的全部详细信息
军人怎么办理萨能签证	{军人=特定人群, 萨能=签证地理位置}	1.签证办理的全部详细信息
小朋友怎么办理拉彭兰塔签证	{拉彭兰塔=签证地理位置, 小朋友=特定人群}	1.签证办理的全部详细信息
小朋友怎么办理巴登-巴登签证	{小朋友=特定人群, 巴登-巴登=签证地理位置}	1.签证办理的全部详细信息
残疾人怎么办理甲米签证	{残疾人=特定人群, 甲米=签证地理位置}	1.签证办理的全部详细信息
老人怎么办理伊斯兰堡签证	{伊斯兰堡=签证地理位置, 老人=特定人群}	1.签证办理的全部详细信息
老人怎么办理蒲甘签证	{老人=特定人群, 蒲甘=签证地理位置}	1.签证办理的全部详细信息
老人怎么办理丹麦签证	{老人=特定人群, 丹麦=签证地理位置}	1.签证办理的全部详细信息
残疾人怎么办理瓦尼莫签证	{残疾人=特定人群, 瓦尼莫=签证地理位置}	1.签证办理的全部详细信息
小孩儿怎么办理阿斯旺签证	{小孩儿=特定人群, 阿斯旺=签证地理位置}	1.签证办理的全部详细信息
老人怎么办理谢尔盖耶夫签证	{老人=特定人群, 谢尔盖耶夫=签证地理位置}	1.签证办理的全部详细信息
小孩儿怎么办理法蒂玛签证	{小孩儿=特定人群, 法蒂玛=签证地理位置}	1.签证办理的全部详细信息
小朋友怎么办理阿讷西签证	{阿讷西=签证地理位置, 小朋友=特定人群}	1.签证办理的全部详细信息
残疾人怎么办理扎金索斯签证	{扎金索斯=签证地理位置, 残疾人=特定人群}	1.签证办理的全部详细信息
小孩儿怎么办理普纳奥亚签证	{小孩儿=特定人群, 普纳奥亚=签证地理位置}	1.签证办理的全部详细信息
老人怎么办理斯特拉斯堡签证	{斯特拉斯堡=签证地理位置, 老人=特定人群}	1.签证办理的全部详细信息
老人怎么办理巴兰基亚签证	{老人=特定人群, 巴兰基亚=签证地理位置}	1.签证办理的全部详细信息
残疾人怎么办理埃格尔签证	{残疾人=特定人群, 埃格尔=签证地理位置}	1.签证办理的全部详细信息
小朋友怎么办理阿瓦诺斯签证	{阿瓦诺斯=签证地理位置, 小朋友=特定人群}	1.签证办理的全部详细信息
残疾人怎么办理萨尔瓦多签证	{残疾人=特定人群, 萨尔瓦多=签证地理位置}	1.签证办理的全部详细信息
残疾人怎么办理金边签证	{残疾人=特定人群, 金边=签证地理位置}	1.签证办理的全部详细信息
老人怎么办理安卡拉签证	{安卡拉=签证地理位置, 老人=特定人群}	1.签证办理的全部详细信息
军人怎么办理晋州市签证	{晋州市=签证地理位置, 军人=特定人群}	1.签证办理的全部详细信息
老人怎么办理阿拉梅达签证	{老人=特定人群, 阿拉梅达=签证地理位置}	1.签证办理的全部详细信息
小朋友怎么办理南特签证	{南特=签证地理位置, 小朋友=特定人群}	1.签证办理的全部详细信息
军人怎么办理罗托鲁瓦签证	{罗托鲁瓦=签证地理位置, 军人=特定人群}	1.签证办理的全部详细信息
老人怎么办理台北签证	{老人=特定人群, 台北=签证地理位置}	1.签证办理的全部详细信息
军人怎么办理豪尔签证	{军人=特定人群, 豪尔=签证地理位置}	1.签证办理的全部详细信息
小孩儿怎么办理中国签证	{小孩儿=特定人群, 中国=签证地理位置}	1.签证办理的全部详细信息
老人怎么办理图恩签证	{图恩=签证地理位置, 老人=特定人群}	1.签证办理的全部详细信息
老人怎么办理凯夫拉维克签证	{老人=特定人群, 凯夫拉维克=签证地理位置}	1.签证办理的全部详细信息
残疾人怎么办理拉什特签证	{残疾人=特定人群, 拉什特=签证地理位置}	1.签证办理的全部详细信息
军人怎么办理维甘签证	{军人=特定人群, 维甘=签证地理位置}	1.签证办理的全部详细信息
军人怎么办理清州签证	{清州=签证地理位置, 军人=特定人群}	1.签证办理的全部详细信息
小朋友怎么办理贡布签证	{贡布=签证地理位置, 小朋友=特定人群}	1.签证办理的全部详细信息
小孩儿怎么办理曼谷签证	{小孩儿=特定人群, 曼谷=签证地理位置}	1.签证办理的全部详细信息
小朋友怎么办理劳特布龙嫩签证	{劳特布龙嫩=签证地理位置, 小朋友=特定人群}	1.签证办理的全部详细信息
小孩儿怎么办理圣路易斯签证	{小孩儿=特定人群, 圣路易斯=签证地理位置}	1.签证办理的全部详细信息
小朋友怎么办理巴淡岛签证	{巴淡岛=签证地理位置, 小朋友=特定人群}	1.签证办理的全部详细信息
老人怎么办理伊斯法罕签证	{老人=特定人群, 伊斯法罕=签证地理位置}	1.签证办理的全部详细信息
军人怎么办理帕坦签证	{军人=特定人群, 帕坦=签证地理位置}	1.签证办理的全部详细信息
小朋友怎么办理贝尔谢巴签证	{小朋友=特定人群, 贝尔谢巴=签证地理位置}	1.签证办理的全部详细信息
小孩儿怎么办理伏尔加格勒签证	{小孩儿=特定人群, 伏尔加格勒=签证地理位置}	1.签证办理的全部详细信息
军人怎么办理拉包尔签证	{军人=特定人群, 拉包尔=签证地理位置}	1.签证办理的全部详细信息
老人怎么办理马德望签证	{老人=特定人群, 马德望=签证地理位置}	1.签证办理的全部详细信息
残疾人怎么办理屏东签证	{残疾人=特定人群, 屏东=签证地理位置}	1.签证办理的全部详细信息
小孩儿怎么办理科英布拉签证	{小孩儿=特定人群, 科英布拉=签证地理位置}	1.签证办理的全部详细信息
小朋友怎么办理棉花堡签证	{棉花堡=签证地理位置, 小朋友=特定人群}	1.签证办理的全部详细信息
军人怎么办理拉斯佩齐亚签证	{军人=特定人群, 拉斯佩齐亚=签证地理位置}	1.签证办理的全部详细信息
残疾人怎么办理浦项市签证	{浦项市=签证地理位置, 残疾人=特定人群}	1.签证办理的全部详细信息
小孩儿怎么办理五渔村签证	{小孩儿=特定人群, 五渔村=签证地理位置}	1.签证办理的全部详细信息
小朋友怎么办理内罗毕签证	{内罗毕=签证地理位置, 小朋友=特定人群}	1.签证办理的全部详细信息
小朋友怎么办签证	{小朋友=特定人群}	1.签证办理的全部详细信息
军人怎么办签证	{军人=特定人群}	1.签证办理的全部详细信息
小孩儿怎么办签证	{小孩儿=特定人群}	1.签证办理的全部详细信息
老人怎么办签证	{老人=特定人群}	1.签证办理的全部详细信息
残疾人怎么办签证	{残疾人=特定人群}	1.签证办理的全部详细信息
老人玩儿怎么办签证	{老人=特定人群, 玩儿=签证种类相关词}	1.签证办理的全部详细信息
军人出国旅行怎么办签证	{军人=特定人群, 出国旅行=签证种类相关词}	1.签证办理的全部详细信息
军人玩儿怎么办签证	{军人=特定人群, 玩儿=签证种类相关词}	1.签证办理的全部详细信息
老人出国旅行怎么办签证	{老人=特定人群, 出国旅行=签证种类相关词}	1.签证办理的全部详细信息
小朋友玩儿怎么办签证	{玩儿=签证种类相关词, 小朋友=特定人群}	1.签证办理的全部详细信息
小孩儿办签证需要多长时间	{小孩儿=特定人群}	[所需时长]
小朋友办签证需要多长时间	{小朋友=特定人群}	[所需时长]
军人办签证需要多长时间	{军人=特定人群}	[所需时长]
老人办签证需要多长时间	{老人=特定人群}	[所需时长]
残疾人办签证需要多长时间	{残疾人=特定人群}	[所需时长]
出国旅行办签证需要多久	{出国旅行=签证种类相关词}	[所需时长]
玩儿办签证需要多久	{玩儿=签证种类相关词}	[所需时长]
办签证难吗	{}	[难度]
办洛桑的签证难吗	{洛桑=签证地理位置}	[难度]
办沙迦的签证难吗	{沙迦=签证地理位置}	[难度]
办汉堡的签证难吗	{汉堡=签证地理位置}	[难度]
办斐济的签证难吗	{斐济=签证地理位置}	[难度]
办夜丰颂的签证难吗	{夜丰颂=签证地理位置}	[难度]
办哥本哈根的签证难吗	{哥本哈根=签证地理位置}	[难度]
办缅甸的签证难吗	{缅甸=签证地理位置}	[难度]
办台北的签证难吗	{台北=签证地理位置}	[难度]
办鹿特丹的签证难吗	{鹿特丹=签证地理位置}	[难度]
办吉达的签证难吗	{吉达=签证地理位置}	[难度]
办库兰达的签证难吗	{库兰达=签证地理位置}	[难度]
办原州市的签证难吗	{原州市=签证地理位置}	[难度]
办图卢兹的签证难吗	{图卢兹=签证地理位置}	[难度]
办卢戈的签证难吗	{卢戈=签证地理位置}	[难度]
办东京的签证难吗	{东京=签证地理位置}	[难度]
办台中的签证难吗	{台中=签证地理位置}	[难度]
办丹布勒的签证难吗	{丹布勒=签证地理位置}	[难度]
办关丹的签证难吗	{关丹=签证地理位置}	[难度]
办剑桥的签证难吗	{剑桥=签证地理位置}	[难度]
办沃斯的签证难吗	{沃斯=签证地理位置}	[难度]
办涛岛的签证难吗	{涛岛=签证地理位置}	[难度]
办金门的签证难吗	{金门=签证地理位置}	[难度]
办萨法加的签证难吗	{萨法加=签证地理位置}	[难度]
办苏梅岛的签证难吗	{苏梅岛=签证地理位置}	[难度]
办拉哈尔的签证难吗	{拉哈尔=签证地理位置}	[难度]
办塔巴的签证难吗	{塔巴=签证地理位置}	[难度]
办柏林的签证难吗	{柏林=签证地理位置}	[难度]
办屏东的签证难吗	{屏东=签证地理位置}	[难度]
办丰沙尔的签证难吗	{丰沙尔=签证地理位置}	[难度]
办瑞典的签证难吗	{瑞典=签证地理位置}	[难度]
办葡萄牙的签证难吗	{葡萄牙=签证地理位置}	[难度]
办卡罗维发利的签证难吗	{卡罗维发利=签证地理位置}	[难度]
办马尔代夫的签证难吗	{马尔代夫=签证地理位置}	[难度]
办利斯特维扬卡的签证难吗	{利斯特维扬卡=签证地理位置}	[难度]
办曼彻斯特的签证难吗	{曼彻斯特=签证地理位置}	[难度]
办拜伦湾的签证难吗	{拜伦湾=签证地理位置}	[难度]
办吉隆坡的签证难吗	{吉隆坡=签证地理位置}	[难度]
办拉姆拉的签证难吗	{拉姆拉=签证地理位置}	[难度]
办弗里堡的签证难吗	{弗里堡=签证地理位置}	[难度]
办纳塔尔的签证难吗	{纳塔尔=签证地理位置}	[难度]
办巴基斯坦的签证难吗	{巴基斯坦=签证地理位置}	[难度]
办那慕尔的签证难吗	{那慕尔=签证地理位置}	[难度]
办法蒂玛的签证难吗	{法蒂玛=签证地理位置}	[难度]
办拉斯帕尔马斯的签证难吗	{拉斯帕尔马斯=签证地理位置}	[难度]
办南迪的签证难吗	{南迪=签证地理位置}	[难度]
办仙台的签证难吗	{仙台=签证地理位置}	[难度]
办班多尔班的签证难吗	{班多尔班=签证地理位置}	[难度]
办马赛的签证难吗	{马赛=签证地理位置}	[难度]
办哥德堡的签证难吗	{哥德堡=签证地理位置}	[难度]
办拿撒勒的签证难吗	{拿撒勒=签证地理位置}	[难度]
办利兹的签证难吗	{利兹=签证地理位置}	[难度]
办斯塔万格的签证难吗	{斯塔万格=签证地理位置}	[难度]
办欧登塞的签证难吗	{欧登塞=签证地理位置}	[难度]
办戛纳的签证难吗	{戛纳=签证地理位置}	[难度]
办芽庄的签证难吗	{芽庄=签证地理位置}	[难度]
办卡塔尼亚的签证难吗	{卡塔尼亚=签证地理位置}	[难度]
办第戎的签证难吗	{第戎=签证地理位置}	[难度]
办巴黎的签证难吗	{巴黎=签证地理位置}	[难度]
办马卡蒂的签证难吗	{马卡蒂=签证地理位置}	[难度]
办佩奇的签证难吗	{佩奇=签证地理位置}	[难度]
办阿洛陶的签证难吗	{阿洛陶=签证地理位置}	[难度]
办特罗姆瑟的签证难吗	{特罗姆瑟=签证地理位置}	[难度]
办阿比斯库的签证难吗	{阿比斯库=签证地理位置}	[难度]
办日惹的签证难吗	{日惹=签证地理位置}	[难度]
办法属波利尼西亚的签证难吗	{法属波利尼西亚=签证地理位置}	[难度]
办玛瑙斯市的签证难吗	{玛瑙斯市=签证地理位置}	[难度]
办沃特福德的签证难吗	{沃特福德=签证地理位置}	[难度]
办布阿苏的签证难吗	{布阿苏=签证地理位置}	[难度]
办内罗毕的签证难吗	{内罗毕=签证地理位置}	[难度]
办卢塞恩的签证难吗	{卢塞恩=签证地理位置}	[难度]
办圣沃尔夫冈的签证难吗	{圣沃尔夫冈=签证地理位置}	[难度]
办千叶市的签证难吗	{千叶市=签证地理位置}	[难度]
办董里的签证难吗	{董里=签证地理位置}	[难度]
办沙特的签证难吗	{沙特=签证地理位置}	[难度]
办万隆的签证难吗	{万隆=签证地理位置}	[难度]
办日内瓦的签证难吗	{日内瓦=签证地理位置}	[难度]
办荷兰的签证难吗	{荷兰=签证地理位置}	[难度]
办澳门的签证难吗	{澳门=签证地理位置}	[难度]
办多哈的签证难吗	{多哈=签证地理位置}	[难度]
办阿巴斯港的签证难吗	{阿巴斯港=签证地理位置}	[难度]
办库奥皮奥的签证难吗	{库奥皮奥=签证地理位置}	[难度]
办美奈的签证难吗	{美奈=签证地理位置}	[难度]
办比雷埃夫斯的签证难吗	{比雷埃夫斯=签证地理位置}	[难度]
办潘切市的签证难吗	{潘切市=签证地理位置}	[难度]
办威克洛郡的签证难吗	{威克洛郡=签证地理位置}	[难度]
办斗湖的签证难吗	{斗湖=签证地理位置}	[难度]
办白沙瓦的签证难吗	{白沙瓦=签证地理位置}	[难度]
办麦德林的签证难吗	{麦德林=签证地理位置}	[难度]
办卢加诺的签证难吗	{卢加诺=签证地理位置}	[难度]
办霍巴特的签证难吗	{霍巴特=签证地理位置}	[难度]
办美因茨的签证难吗	{美因茨=签证地理位置}	[难度]
办巴塞尔的签证难吗	{巴塞尔=签证地理位置}	[难度]
办丽水的签证难吗	{丽水=签证地理位置}	[难度]
办会晒的签证难吗	{会晒=签证地理位置}	[难度]
办全州的签证难吗	{全州=签证地理位置}	[难度]
办春武里府的签证难吗	{春武里府=签证地理位置}	[难度]
办台东的签证难吗	{台东=签证地理位置}	[难度]
办干尼亚的签证难吗	{干尼亚=签证地理位置}	[难度]
办杜塞尔多夫的签证难吗	{杜塞尔多夫=签证地理位置}	[难度]
办伊拉克利翁的签证难吗	{伊拉克利翁=签证地理位置}	[难度]
签证难度，需要多久	{}	[难度]
玩儿办签证难吗	{玩儿=签证种类相关词}	[难度]
出国旅行办签证难吗	{出国旅行=签证种类相关词}	[难度]
老人办理签证难吗	{老人=特定人群}	[难度]
小朋友办理签证难吗	{小朋友=特定人群}	[难度]
小孩儿办理签证难吗	{小孩儿=特定人群}	[难度]
残疾人办理签证难吗	{残疾人=特定人群}	[难度]
军人办理签证难吗	{军人=特定人群}	[难度]
办签证难吗，需要准备什么材料	{}	[难度][准备材料]
办签证有什么条件难不难	{}	[难度][先期条件]
旅游签证难办吗	{旅游签证=签证种类}	[难度]
访问签证难办吗	{访问签证=签证种类}	[难度]
工作签证难办吗	{工作签证=签证种类}	[难度]
过境签证难办吗	{过境签证=签证种类}	[难度]
乘务签证难办吗	{乘务签证=签证种类}	[难度]
外交、公务签证难办吗	{外交、公务签证=签证种类}	[难度]
定居签证难办吗	{定居签证=签证种类}	[难度]
记者签证难办吗	{记者签证=签证种类}	[难度]
办签证有什么条件	{}	[先期条件]
出国旅行办签证有什么条件	{出国旅行=签证种类相关词}	[先期条件]
玩儿办签证有什么条件	{玩儿=签证种类相关词}	[先期条件]
办签证有什么条件需要准备什么材料	{}	[准备材料]
办签证有什么条件需要多久	{}	[先期条件][所需时间]
办多特蒙德有什么条件	{多特蒙德=签证地理位置}	[先期条件]
办累西腓有什么条件	{累西腓=签证地理位置}	[先期条件]
办瓦尼莫有什么条件	{瓦尼莫=签证地理位置}	[先期条件]
办博拉博拉岛有什么条件	{博拉博拉岛=签证地理位置}	[先期条件]
办旭川有什么条件	{旭川=签证地理位置}	[先期条件]
办阿努拉德普勒有什么条件	{阿努拉德普勒=签证地理位置}	[先期条件]
办五渔村有什么条件	{五渔村=签证地理位置}	[先期条件]
办劳特布龙嫩有什么条件	{劳特布龙嫩=签证地理位置}	[先期条件]
办奥比都斯有什么条件	{奥比都斯=签证地理位置}	[先期条件]
办巴色有什么条件	{巴色=签证地理位置}	[先期条件]
办龙达有什么条件	{龙达=签证地理位置}	[先期条件]
办高威有什么条件	{高威=签证地理位置}	[先期条件]
办廷布有什么条件	{廷布=签证地理位置}	[先期条件]
办釜山有什么条件	{釜山=签证地理位置}	[先期条件]
办提比里亚有什么条件	{提比里亚=签证地理位置}	[先期条件]
办卢卡有什么条件	{卢卡=签证地理位置}	[先期条件]
办拿骚有什么条件	{拿骚=签证地理位置}	[先期条件]
办布雷有什么条件	{布雷=签证地理位置}	[先期条件]
办温莎市有什么条件	{温莎市=签证地理位置}	[先期条件]
办莱蒂西亚有什么条件	{莱蒂西亚=签证地理位置}	[先期条件]
办阿吉曼有什么条件	{阿吉曼=签证地理位置}	[先期条件]
办马赛马拉有什么条件	{马赛马拉=签证地理位置}	[先期条件]
办马丘比丘有什么条件	{马丘比丘=签证地理位置}	[先期条件]
办旧金山有什么条件	{旧金山=签证地理位置}	[先期条件]
办圣保罗有什么条件	{圣保罗=签证地理位置}	[先期条件]
办巴基斯坦有什么条件	{巴基斯坦=签证地理位置}	[先期条件]
办东枝有什么条件	{东枝=签证地理位置}	[先期条件]
办长滩岛有什么条件	{长滩岛=签证地理位置}	[先期条件]
办萨斯卡通有什么条件	{萨斯卡通=签证地理位置}	[先期条件]
办普罗旺斯有什么条件	{普罗旺斯=签证地理位置}	[先期条件]
办罗什平纳有什么条件	{罗什平纳=签证地理位置}	[先期条件]
办勃固有什么条件	{勃固=签证地理位置}	[先期条件]
办特罗姆瑟有什么条件	{特罗姆瑟=签证地理位置}	[先期条件]
办阿尔科巴萨有什么条件	{阿尔科巴萨=签证地理位置}	[先期条件]
办波尔蒂芒有什么条件	{波尔蒂芒=签证地理位置}	[先期条件]
办帕岸岛有什么条件	{帕岸岛=签证地理位置}	[先期条件]
办东京有什么条件	{东京=签证地理位置}	[先期条件]
办伊朗有什么条件	{伊朗=签证地理位置}	[先期条件]
办德黑兰有什么条件	{德黑兰=签证地理位置}	[先期条件]
办芒特哈根有什么条件	{芒特哈根=签证地理位置}	[先期条件]
办莫皮蒂岛有什么条件	{莫皮蒂岛=签证地理位置}	[先期条件]
办开普敦有什么条件	{开普敦=签证地理位置}	[先期条件]
办维罗纳有什么条件	{维罗纳=签证地理位置}	[先期条件]
办苏黎世有什么条件	{苏黎世=签证地理位置}	[先期条件]
办贝尔马尔有什么条件	{贝尔马尔=签证地理位置}	[先期条件]
办富川有什么条件	{富川=签证地理位置}	[先期条件]
办贝特谢安有什么条件	{贝特谢安=签证地理位置}	[先期条件]
办维甘有什么条件	{维甘=签证地理位置}	[先期条件]
办辛特拉有什么条件	{辛特拉=签证地理位置}	[先期条件]
办意大利有什么条件	{意大利=签证地理位置}	[先期条件]
办毛凯岛有什么条件	{毛凯岛=签证地理位置}	[先期条件]
办乌纳瓦图纳有什么条件	{乌纳瓦图纳=签证地理位置}	[先期条件]
办波哥大有什么条件	{波哥大=签证地理位置}	[先期条件]
办喀山有什么条件	{喀山=签证地理位置}	[先期条件]
办基隆有什么条件	{基隆=签证地理位置}	[先期条件]
办登别有什么条件	{登别=签证地理位置}	[先期条件]
办伊斯梅利亚有什么条件	{伊斯梅利亚=签证地理位置}	[先期条件]
办布里恩茨有什么条件	{布里恩茨=签证地理位置}	[先期条件]
办箭镇有什么条件	{箭镇=签证地理位置}	[先期条件]
办麦德林有什么条件	{麦德林=签证地理位置}	[先期条件]
办河内有什么条件	{河内=签证地理位置}	[先期条件]
办瓦胡卡岛有什么条件	{瓦胡卡岛=签证地理位置}	[先期条件]
办热那亚有什么条件	{热那亚=签证地理位置}	[先期条件]
办蒂卡普湖有什么条件	{蒂卡普湖=签证地理位置}	[先期条件]
办蒙达有什么条件	{蒙达=签证地理位置}	[先期条件]
办棕榈泉有什么条件	{棕榈泉=签证地理位置}	[先期条件]
办霍伦有什么条件	{霍伦=签证地理位置}	[先期条件]
办利物浦有什么条件	{利物浦=签证地理位置}	[先期条件]
办布鲁塞尔有什么条件	{布鲁塞尔=签证地理位置}	[先期条件]
办图尔奈有什么条件	{图尔奈=签证地理位置}	[先期条件]
办斯特拉斯堡有什么条件	{斯特拉斯堡=签证地理位置}	[先期条件]
办赫尔辛格有什么条件	{赫尔辛格=签证地理位置}	[先期条件]
办潘切市有什么条件	{潘切市=签证地理位置}	[先期条件]
办冰岛有什么条件	{冰岛=签证地理位置}	[先期条件]
办都柏林有什么条件	{都柏林=签证地理位置}	[先期条件]
办巴淡岛有什么条件	{巴淡岛=签证地理位置}	[先期条件]
办台南有什么条件	{台南=签证地理位置}	[先期条件]
办纳塔尔有什么条件	{纳塔尔=签证地理位置}	[先期条件]
办罗斯基勒有什么条件	{罗斯基勒=签证地理位置}	[先期条件]
办丹老有什么条件	{丹老=签证地理位置}	[先期条件]
办静冈有什么条件	{静冈=签证地理位置}	[先期条件]
办神户有什么条件	{神户=签证地理位置}	[先期条件]
办普雷韦扎有什么条件	{普雷韦扎=签证地理位置}	[先期条件]
办皮皮岛有什么条件	{皮皮岛=签证地理位置}	[先期条件]
办民丹岛有什么条件	{民丹岛=签证地理位置}	[先期条件]
办霍尼亚拉有什么条件	{霍尼亚拉=签证地理位置}	[先期条件]
办杰尔有什么条件	{杰尔=签证地理位置}	[先期条件]
办凯恩斯有什么条件	{凯恩斯=签证地理位置}	[先期条件]
办昆卡有什么条件	{昆卡=签证地理位置}	[先期条件]
办马萨达有什么条件	{马萨达=签证地理位置}	[先期条件]
办塞格德有什么条件	{塞格德=签证地理位置}	[先期条件]
办八打灵再也有什么条件	{八打灵再也=签证地理位置}	[先期条件]
办设拉子有什么条件	{设拉子=签证地理位置}	[先期条件]
办锡尔赫特有什么条件	{锡尔赫特=签证地理位置}	[先期条件]
办托马尔有什么条件	{托马尔=签证地理位置}	[先期条件]
办特拉维夫有什么条件	{特拉维夫=签证地理位置}	[先期条件]
办安吉利斯有什么条件	{安吉利斯=签证地理位置}	[先期条件]
办普那卡有什么条件	{普那卡=签证地理位置}	[先期条件]
办圣路易斯有什么条件	{圣路易斯=签证地理位置}	[先期条件]
办鲁西永有什么条件	{鲁西永=签证地理位置}	[先期条件]
小朋友办签证有什么条件	{小朋友=特定人群}	[先期条件]
小孩儿办签证有什么条件	{小孩儿=特定人群}	[先期条件]
残疾人办签证有什么条件	{残疾人=特定人群}	[先期条件]
老人办签证有什么条件	{老人=特定人群}	[先期条件]
军人办签证有什么条件	{军人=特定人群}	[先期条件]
办理过境签证有什么条件	{过境签证=签证种类}	[先期条件]
办理工作签证有什么条件	{工作签证=签证种类}	[先期条件]
办理访问签证有什么条件	{访问签证=签证种类}	[先期条件]
办理外交、公务签证有什么条件	{外交、公务签证=签证种类}	[先期条件]
办理记者签证有什么条件	{记者签证=签证种类}	[先期条件]
办理学习签证有什么条件	{学习签证=签证种类}	[先期条件]
办理乘务签证有什么条件	{乘务签证=签证种类}	[先期条件]
办理旅游签证有什么条件	{旅游签证=签证种类}	[先期条件]
办理定居签证有什么条件	{定居签证=签证种类}	[先期条件]
出国旅行办理什么签证种类	{出国旅行=签证种类相关词}	[签证种类]
玩儿办理什么签证种类	{玩儿=签证种类相关词}	[签证种类]
办旅游签证要准备什么材料	{旅游签证=签证种类}	[准备材料]
办乘务签证要准备什么材料	{乘务签证=签证种类}	[准备材料]
办学习签证要准备什么材料	{学习签证=签证种类}	[准备材料]
办工作签证要准备什么材料	{工作签证=签证种类}	[准备材料]
办访问签证要准备什么材料	{访问签证=签证种类}	[准备材料]
办过境签证要准备什么材料	{过境签证=签证种类}	[准备材料]
办记者签证要准备什么材料	{记者签证=签证种类}	[准备材料]
办定居签证要准备什么材料	{定居签证=签证种类}	[准备材料]
办理旅游签证要多长时间	{旅游签证=签证种类}	[所需时长]
办理学习签证要多长时间	{学习签证=签证种类}	[所需时长]
办理记者签证要多长时间	{记者签证=签证种类}	[所需时长]
办理乘务签证要多长时间	{乘务签证=签证种类}	[所需时长]
办理过境签证要多长时间	{过境签证=签证种类}	[所需时长]
办理定居签证要多长时间	{定居签证=签证种类}	[所需时长]
办理外交、公务签证要多长时间	{外交、公务签证=签证种类}	[所需时长]
办理访问签证要多长时间	{访问签证=签证种类}	[所需时长]
办理工作签证要多长时间	{工作签证=签证种类}	[所需时长]
布莱顿的定居签证怎么办理	{布莱顿=签证地理位置, 定居签证=签证种类}	1.签证办理的全部详细信息
名古屋的定居签证怎么办理	{名古屋=签证地理位置, 定居签证=签证种类}	1.签证办理的全部详细信息
仰光的定居签证怎么办理	{仰光=签证地理位置, 定居签证=签证种类}	1.签证办理的全部详细信息
马六甲的记者签证怎么办理	{记者签证=签证种类, 马六甲=签证地理位置}	1.签证办理的全部详细信息
阿马尔菲的学习签证怎么办理	{阿马尔菲=签证地理位置, 学习签证=签证种类}	1.签证办理的全部详细信息
沙夫豪森的乘务签证怎么办理	{沙夫豪森=签证地理位置, 乘务签证=签证种类}	1.签证办理的全部详细信息
莫尔斯比港的乘务签证怎么办理	{莫尔斯比港=签证地理位置, 乘务签证=签证种类}	1.签证办理的全部详细信息
格拉斯哥的过境签证怎么办理	{格拉斯哥=签证地理位置, 过境签证=签证种类}	1.签证办理的全部详细信息
富吉拉的定居签证怎么办理	{定居签证=签证种类, 富吉拉=签证地理位置}	1.签证办理的全部详细信息
萨尔瓦多的学习签证怎么办理	{萨尔瓦多=签证地理位置, 学习签证=签证种类}	1.签证办理的全部详细信息
羊角村的乘务签证怎么办理	{羊角村=签证地理位置, 乘务签证=签证种类}	1.签证办理的全部详细信息
拉斯维加斯的定居签证怎么办理	{拉斯维加斯=签证地理位置, 定居签证=签证种类}	1.签证办理的全部详细信息
马当的过境签证怎么办理	{马当=签证地理位置, 过境签证=签证种类}	1.签证办理的全部详细信息
春蓬的旅游签证怎么办理	{旅游签证=签证种类, 春蓬=签证地理位置}	1.签证办理的全部详细信息
安卡拉的旅游签证怎么办理	{安卡拉=签证地理位置, 旅游签证=签证种类}	1.签证办理的全部详细信息
以色列的访问签证怎么办理	{以色列=签证地理位置, 访问签证=签证种类}	1.签证办理的全部详细信息
盐湖城的旅游签证怎么办理	{盐湖城=签证地理位置, 旅游签证=签证种类}	1.签证办理的全部详细信息
卢卡拉的记者签证怎么办理	{记者签证=签证种类, 卢卡拉=签证地理位置}	1.签证办理的全部详细信息
琅南塔的定居签证怎么办理	{定居签证=签证种类, 琅南塔=签证地理位置}	1.签证办理的全部详细信息
霍基蒂卡的工作签证怎么办理	{工作签证=签证种类, 霍基蒂卡=签证地理位置}	1.签证办理的全部详细信息
特罗姆瑟的学习签证怎么办理	{特罗姆瑟=签证地理位置, 学习签证=签证种类}	1.签证办理的全部详细信息
恩格尔贝格的定居签证怎么办理	{定居签证=签证种类, 恩格尔贝格=签证地理位置}	1.签证办理的全部详细信息
埃德蒙顿的学习签证怎么办理	{埃德蒙顿=签证地理位置, 学习签证=签证种类}	1.签证办理的全部详细信息
萨克拉门托的定居签证怎么办理	{定居签证=签证种类, 萨克拉门托=签证地理位置}	1.签证办理的全部详细信息
萨格里斯的学习签证怎么办理	{萨格里斯=签证地理位置, 学习签证=签证种类}	1.签证办理的全部详细信息
法属波利尼西亚的记者签证怎么办理	{记者签证=签证种类, 法属波利尼西亚=签证地理位置}	1.签证办理的全部详细信息
内比都的工作签证怎么办理	{内比都=签证地理位置, 工作签证=签证种类}	1.签证办理的全部详细信息
但尼丁的定居签证怎么办理	{定居签证=签证种类, 但尼丁=签证地理位置}	1.签证办理的全部详细信息
利马的外交、公务签证怎么办理	{外交、公务签证=签证种类, 利马=签证地理位置}	1.签证办理的全部详细信息
安东的记者签证怎么办理	{记者签证=签证种类, 安东=签证地理位置}	1.签证办理的全部详细信息
木浦市的乘务签证怎么办理	{木浦市=签证地理位置, 乘务签证=签证种类}	1.签证办理的全部详细信息
大溪地的学习签证怎么办理	{大溪地=签证地理位置, 学习签证=签证种类}	1.签证办理的全部详细信息
拉包尔的过境签证怎么办理	{拉包尔=签证地理位置, 过境签证=签证种类}	1.签证办理的全部详细信息
波茨坦的旅游签证怎么办理	{旅游签证=签证种类, 波茨坦=签证地理位置}	1.签证办理的全部详细信息
伊拉克的记者签证怎么办理	{记者签证=签证种类, 伊拉克=签证地理位置}	1.签证办理的全部详细信息
京都的定居签证怎么办理	{定居签证=签证种类, 京都=签证地理位置}	1.签证办理的全部详细信息
岘港的外交、公务签证怎么办理	{外交、公务签证=签证种类, 岘港=签证地理位置}	1.签证办理的全部详细信息
奥马鲁的过境签证怎么办理	{奥马鲁=签证地理位置, 过境签证=签证种类}	1.签证办理的全部详细信息
布里斯班的乘务签证怎么办理	{布里斯班=签证地理位置, 乘务签证=签证种类}	1.签证办理的全部详细信息
仙本那的过境签证怎么办理	{仙本那=签证地理位置, 过境签证=签证种类}	1.签证办理的全部详细信息
维甘的过境签证怎么办理	{过境签证=签证种类, 维甘=签证地理位置}	1.签证办理的全部详细信息
瓜拉登嘉楼的乘务签证怎么办理	{瓜拉登嘉楼=签证地理位置, 乘务签证=签证种类}	1.签证办理的全部详细信息
巴塞罗那的过境签证怎么办理	{巴塞罗那=签证地理位置, 过境签证=签证种类}	1.签证办理的全部详细信息
奥兰多的定居签证怎么办理	{定居签证=签证种类, 奥兰多=签证地理位置}	1.签证办理的全部详细信息
塞班的乘务签证怎么办理	{塞班=签证地理位置, 乘务签证=签证种类}	1.签证办理的全部详细信息
帕罗的记者签证怎么办理	{记者签证=签证种类, 帕罗=签证地理位置}	1.签证办理的全部详细信息
廷布的工作签证怎么办理	{工作签证=签证种类, 廷布=签证地理位置}	1.签证办理的全部详细信息
奥地利的乘务签证怎么办理	{奥地利=签证地理位置, 乘务签证=签证种类}	1.签证办理的全部详细信息
弗雷斯诺的工作签证怎么办理	{工作签证=签证种类, 弗雷斯诺=签证地理位置}	1.签证办理的全部详细信息
热浪岛的定居签证怎么办理	{定居签证=签证种类, 热浪岛=签证地理位置}	1.签证办理的全部详细信息
拉彭兰塔的外交、公务签证怎么办理	{拉彭兰塔=签证地理位置, 外交、公务签证=签证种类}	1.签证办理的全部详细信息
长滩岛的访问签证怎么办理	{访问签证=签证种类, 长滩岛=签证地理位置}	1.签证办理的全部详细信息
马丘比丘的外交、公务签证怎么办理	{马丘比丘=签证地理位置, 外交、公务签证=签证种类}	1.签证办理的全部详细信息
耶路撒冷的乘务签证怎么办理	{耶路撒冷=签证地理位置, 乘务签证=签证种类}	1.签证办理的全部详细信息
达哈卜的定居签证怎么办理	{定居签证=签证种类, 达哈卜=签证地理位置}	1.签证办理的全部详细信息
登巴萨的旅游签证怎么办理	{旅游签证=签证种类, 登巴萨=签证地理位置}	1.签证办理的全部详细信息
科伦坡的外交、公务签证怎么办理	{外交、公务签证=签证种类, 科伦坡=签证地理位置}	1.签证办理的全部详细信息
努韦巴的旅游签证怎么办理	{努韦巴=签证地理位置, 旅游签证=签证种类}	1.签证办理的全部详细信息
阿维拉的定居签证怎么办理	{定居签证=签证种类, 阿维拉=签证地理位置}	1.签证办理的全部详细信息
圣玛尔塔的外交、公务签证怎么办理	{圣玛尔塔=签证地理位置, 外交、公务签证=签证种类}	1.签证办理的全部详细信息
宜兰的访问签证怎么办理	{访问签证=签证种类, 宜兰=签证地理位置}	1.签证办理的全部详细信息
桃园的学习签证怎么办理	{桃园=签证地理位置, 学习签证=签证种类}	1.签证办理的全部详细信息
巴斯的访问签证怎么办理	{巴斯=签证地理位置, 访问签证=签证种类}	1.签证办理的全部详细信息
伊斯梅利亚的过境签证怎么办理	{伊斯梅利亚=签证地理位置, 过境签证=签证种类}	1.签证办理的全部详细信息
蒂瑟默哈拉默的工作签证怎么办理	{工作签证=签证种类, 蒂瑟默哈拉默=签证地理位置}	1.签证办理的全部详细信息
意大利的访问签证怎么办理	{意大利=签证地理位置, 访问签证=签证种类}	1.签证办理的全部详细信息
新加坡的过境签证怎么办理	{过境签证=签证种类, 新加坡=签证地理位置}	1.签证办理的全部详细信息
里雄莱锡安的旅游签证怎么办理	{里雄莱锡安=签证地理位置, 旅游签证=签证种类}	1.签证办理的全部详细信息
那霸的工作签证怎么办理	{工作签证=签证种类, 那霸=签证地理位置}	1.签证办理的全部详细信息
阿尔科巴萨的旅游签证怎么办理	{旅游签证=签证种类, 阿尔科巴萨=签证地理位置}	1.签证办理的全部详细信息
诺丁汉的记者签证怎么办理	{诺丁汉=签证地理位置, 记者签证=签证种类}	1.签证办理的全部详细信息
沃韦的工作签证怎么办理	{工作签证=签证种类, 沃韦=签证地理位置}	1.签证办理的全部详细信息
伊势的过境签证怎么办理	{过境签证=签证种类, 伊势=签证地理位置}	1.签证办理的全部详细信息
希腊的定居签证怎么办理	{定居签证=签证种类, 希腊=签证地理位置}	1.签证办理的全部详细信息
巴塔利亚的乘务签证怎么办理	{巴塔利亚=签证地理位置, 乘务签证=签证种类}	1.签证办理的全部详细信息
林雪平的过境签证怎么办理	{林雪平=签证地理位置, 过境签证=签证种类}	1.签证办理的全部详细信息
阿德莱德的定居签证怎么办理	{定居签证=签证种类, 阿德莱德=签证地理位置}	1.签证办理的全部详细信息
金门的外交、公务签证怎么办理	{金门=签证地理位置, 外交、公务签证=签证种类}	1.签证办理的全部详细信息
苏黎世的访问签证怎么办理	{苏黎世=签证地理位置, 访问签证=签证种类}	1.签证办理的全部详细信息
毛里求斯的记者签证怎么办理	{毛里求斯=签证地理位置, 记者签证=签证种类}	1.签证办理的全部详细信息
龙达的访问签证怎么办理	{龙达=签证地理位置, 访问签证=签证种类}	1.签证办理的全部详细信息
圣路易斯的访问签证怎么办理	{圣路易斯=签证地理位置, 访问签证=签证种类}	1.签证办理的全部详细信息
阿雷格里港的访问签证怎么办理	{阿雷格里港=签证地理位置, 访问签证=签证种类}	1.签证办理的全部详细信息
胡萨维克的记者签证怎么办理	{记者签证=签证种类, 胡萨维克=签证地理位置}	1.签证办理的全部详细信息
希欧福克的过境签证怎么办理	{希欧福克=签证地理位置, 过境签证=签证种类}	1.签证办理的全部详细信息
布达佩斯的定居签证怎么办理	{布达佩斯=签证地理位置, 定居签证=签证种类}	1.签证办理的全部详细信息
维克的学习签证怎么办理	{维克=签证地理位置, 学习签证=签证种类}	1.签证办理的全部详细信息
大阪的乘务签证怎么办理	{大阪=签证地理位置, 乘务签证=签证种类}	1.签证办理的全部详细信息
阿蒂乌岛的过境签证怎么办理	{阿蒂乌岛=签证地理位置, 过境签证=签证种类}	1.签证办理的全部详细信息
布法罗的记者签证怎么办理	{记者签证=签证种类, 布法罗=签证地理位置}	1.签证办理的全部详细信息
圣莫里茨的工作签证怎么办理	{工作签证=签证种类, 圣莫里茨=签证地理位置}	1.签证办理的全部详细信息
堪培拉的过境签证怎么办理	{过境签证=签证种类, 堪培拉=签证地理位置}	1.签证办理的全部详细信息
里雄莱锡安的工作签证怎么办理	{工作签证=签证种类, 里雄莱锡安=签证地理位置}	1.签证办理的全部详细信息
巴斯的过境签证怎么办理	{巴斯=签证地理位置, 过境签证=签证种类}	1.签证办理的全部详细信息
西归浦的过境签证怎么办理	{西归浦=签证地理位置, 过境签证=签证种类}	1.签证办理的全部详细信息
库克群岛的外交、公务签证怎么办理	{库克群岛=签证地理位置, 外交、公务签证=签证种类}	1.签证办理的全部详细信息
佩奇的旅游签证怎么办理	{旅游签证=签证种类, 佩奇=签证地理位置}	1.签证办理的全部详细信息
阿罗萨的过境签证怎么办理	{阿罗萨=签证地理位置, 过境签证=签证种类}	1.签证办理的全部详细信息
春川的访问签证怎么办理	{春川=签证地理位置, 访问签证=签证种类}	1.签证办理的全部详细信息
弗雷斯诺的学习签证怎么办理	{弗雷斯诺=签证地理位置, 学习签证=签证种类}	1.签证办理的全部详细信息
老人怎么办理定居签证	{定居签证=签证种类, 老人=特定人群}	1.签证办理的全部详细信息
小孩儿怎么办理过境签证	{小孩儿=特定人群, 过境签证=签证种类}	1.签证办理的全部详细信息
老人怎么办理工作签证	{工作签证=签证种类, 老人=特定人群}	1.签证办理的全部详细信息
残疾人怎么办理乘务签证	{残疾人=特定人群, 乘务签证=签证种类}	1.签证办理的全部详细信息
老人怎么办理访问签证	{老人=特定人群, 访问签证=签证种类}	1.签证办理的全部详细信息
小孩儿怎么办理旅游签证	{小孩儿=特定人群, 旅游签证=签证种类}	1.签证办理的全部详细信息
老人怎么办理旅游签证	{老人=特定人群, 旅游签证=签证种类}	1.签证办理的全部详细信息
军人怎么办理外交、公务签证	{军人=特定人群, 外交、公务签证=签证种类}	1.签证办理的全部详细信息
残疾人怎么办理过境签证	{残疾人=特定人群, 过境签证=签证种类}	1.签证办理的全部详细信息
小朋友怎么办理访问签证	{小朋友=特定人群, 访问签证=签证种类}	1.签证办理的全部详细信息
小朋友怎么办理工作签证	{工作签证=签证种类, 小朋友=特定人群}	1.签证办理的全部详细信息
小朋友怎么办理记者签证	{记者签证=签证种类, 小朋友=特定人群}	1.签证办理的全部详细信息
残疾人怎么办理外交、公务签证	{残疾人=特定人群, 外交、公务签证=签证种类}	1.签证办理的全部详细信息
小朋友怎么办理外交、公务签证	{外交、公务签证=签证种类, 小朋友=特定人群}	1.签证办理的全部详细信息
老人怎么办理记者签证	{老人=特定人群, 记者签证=签证种类}	1.签证办理的全部详细信息
小孩儿怎么办理访问签证	{小孩儿=特定人群, 访问签证=签证种类}	1.签证办理的全部详细信息
小孩儿怎么办理定居签证	{小孩儿=特定人群, 定居签证=签证种类}	1.签证办理的全部详细信息
军人怎么办理过境签证	{军人=特定人群, 过境签证=签证种类}	1.签证办理的全部详细信息
老人怎么办理过境签证	{老人=特定人群, 过境签证=签证种类}	1.签证办理的全部详细信息
小朋友怎么办理过境签证	{过境签证=签证种类, 小朋友=特定人群}	1.签证办理的全部详细信息
残疾人怎么办理访问签证	{残疾人=特定人群, 访问签证=签证种类}	1.签证办理的全部详细信息
残疾人怎么办理定居签证	{定居签证=签证种类, 残疾人=特定人群}	1.签证办理的全部详细信息
军人怎么办理工作签证	{工作签证=签证种类, 军人=特定人群}	1.签证办理的全部详细信息
军人怎么办理学习签证	{军人=特定人群, 学习签证=签证种类}	1.签证办理的全部详细信息
军人怎么办理旅游签证	{军人=特定人群, 旅游签证=签证种类}	1.签证办理的全部详细信息
残疾人怎么办理记者签证	{残疾人=特定人群, 记者签证=签证种类}	1.签证办理的全部详细信息
残疾人怎么办理学习签证	{残疾人=特定人群, 学习签证=签证种类}	1.签证办理的全部详细信息
小朋友怎么办理旅游签证	{旅游签证=签证种类, 小朋友=特定人群}	1.签证办理的全部详细信息
老人怎么办理外交、公务签证	{老人=特定人群, 外交、公务签证=签证种类}	1.签证办理的全部详细信息
残疾人怎么办理工作签证	{工作签证=签证种类, 残疾人=特定人群}	1.签证办理的全部详细信息
老人怎么办理学习签证	{老人=特定人群, 学习签证=签证种类}	1.签证办理的全部详细信息
学习签证怎么办理	{学习签证=签证种类}	1.签证办理的全部详细信息
乘务签证怎么办理	{乘务签证=签证种类}	1.签证办理的全部详细信息
记者签证怎么办理	{记者签证=签证种类}	1.签证办理的全部详细信息
工作签证怎么办理	{工作签证=签证种类}	1.签证办理的全部详细信息
访问签证怎么办理	{访问签证=签证种类}	1.签证办理的全部详细信息
外交、公务签证怎么办理	{外交、公务签证=签证种类}	1.签证办理的全部详细信息
旅游签证怎么办理	{旅游签证=签证种类}	1.签证办理的全部详细信息
定居签证怎么办理	{定居签证=签证种类}	1.签证办理的全部详细信息
办签证要准备什么材料	{}	[准备材料]
办高雄的签证需要准备什么材料	{高雄=签证地理位置}	[准备材料]
办巴斯的签证需要准备什么材料	{巴斯=签证地理位置}	[准备材料]
办斗湖的签证需要准备什么材料	{斗湖=签证地理位置}	[准备材料]
办乌普萨拉的签证需要准备什么材料	{乌普萨拉=签证地理位置}	[准备材料]
办鹿港的签证需要准备什么材料	{鹿港=签证地理位置}	[准备材料]
办埃伊尔斯塔济的签证需要准备什么材料	{埃伊尔斯塔济=签证地理位置}	[准备材料]
办腓特烈港的签证需要准备什么材料	{腓特烈港=签证地理位置}	[准备材料]
办蒂豪尼的签证需要准备什么材料	{蒂豪尼=签证地理位置}	[准备材料]
办热浪岛的签证需要准备什么材料	{热浪岛=签证地理位置}	[准备材料]
办门迪的签证需要准备什么材料	{门迪=签证地理位置}	[准备材料]
办布拉格的签证需要准备什么材料	{布拉格=签证地理位置}	[准备材料]
办函馆的签证需要准备什么材料	{函馆=签证地理位置}	[准备材料]
办魁北克市的签证需要准备什么材料	{魁北克市=签证地理位置}	[准备材料]
办勃固的签证需要准备什么材料	{勃固=签证地理位置}	[准备材料]
办普诺的签证需要准备什么材料	{普诺=签证地理位置}	[准备材料]
办凯恩斯的签证需要准备什么材料	{凯恩斯=签证地理位置}	[准备材料]
办攀牙的签证需要准备什么材料	{攀牙=签证地理位置}	[准备材料]
办莫斯科的签证需要准备什么材料	{莫斯科=签证地理位置}	[准备材料]
办蒂卡普湖的签证需要准备什么材料	{蒂卡普湖=签证地理位置}	[准备材料]
办佩奇的签证需要准备什么材料	{佩奇=签证地理位置}	[准备材料]
办伊萨菲厄泽的签证需要准备什么材料	{伊萨菲厄泽=签证地理位置}	[准备材料]
办诺丁汉的签证需要准备什么材料	{诺丁汉=签证地理位置}	[准备材料]
办桃园的签证需要准备什么材料	{桃园=签证地理位置}	[准备材料]
办伊尔库茨克的签证需要准备什么材料	{伊尔库茨克=签证地理位置}	[准备材料]
办奥比都斯的签证需要准备什么材料	{奥比都斯=签证地理位置}	[准备材料]
办巴兰基亚的签证需要准备什么材料	{巴兰基亚=签证地理位置}	[准备材料]
办撒丁岛的签证需要准备什么材料	{撒丁岛=签证地理位置}	[准备材料]
办瑞典的签证需要准备什么材料	{瑞典=签证地理位置}	[准备材料]
办洛杉矶的签证需要准备什么材料	{洛杉矶=签证地理位置}	[准备材料]
办卡尔维亚的签证需要准备什么材料	{卡尔维亚=签证地理位置}	[准备材料]
办伦敦的签证需要准备什么材料	{伦敦=签证地理位置}	[准备材料]
办埃德蒙顿的签证需要准备什么材料	{埃德蒙顿=签证地理位置}	[准备材料]
办台北的签证需要准备什么材料	{台北=签证地理位置}	[准备材料]
办贝克斯菲尔德的签证需要准备什么材料	{贝克斯菲尔德=签证地理位置}	[准备材料]
办多哈的签证需要准备什么材料	{多哈=签证地理位置}	[准备材料]
办科伦坡的签证需要准备什么材料	{科伦坡=签证地理位置}	[准备材料]
办旭川的签证需要准备什么材料	{旭川=签证地理位置}	[准备材料]
办乌姆盖万的签证需要准备什么材料	{乌姆盖万=签证地理位置}	[准备材料]
办马卡蒂的签证需要准备什么材料	{马卡蒂=签证地理位置}	[准备材料]
办别府的签证需要准备什么材料	{别府=签证地理位置}	[准备材料]
办卢戈的签证需要准备什么材料	{卢戈=签证地理位置}	[准备材料]
办俄斯特拉发的签证需要准备什么材料	{俄斯特拉发=签证地理位置}	[准备材料]
办美国的签证需要准备什么材料	{美国=签证地理位置}	[准备材料]
办蒙特勒的签证需要准备什么材料	{蒙特勒=签证地理位置}	[准备材料]
办托考伊的签证需要准备什么材料	{托考伊=签证地理位置}	[准备材料]
办泰国的签证需要准备什么材料	{泰国=签证地理位置}	[准备材料]
办雅加达的签证需要准备什么材料	{雅加达=签证地理位置}	[准备材料]
办奥克兰的签证需要准备什么材料	{奥克兰=签证地理位置}	[准备材料]
办温莎市的签证需要准备什么材料	{温莎市=签证地理位置}	[准备材料]
办法属波利尼西亚的签证需要准备什么材料	{法属波利尼西亚=签证地理位置}	[准备材料]
办西归浦的签证需要准备什么材料	{西归浦=签证地理位置}	[准备材料]
办甲米的签证需要准备什么材料	{甲米=签证地理位置}	[准备材料]
办坡州的签证需要准备什么材料	{坡州=签证地理位置}	[准备材料]
办奥斯陆的签证需要准备什么材料	{奥斯陆=签证地理位置}	[准备材料]
办朗布尔的签证需要准备什么材料	{朗布尔=签证地理位置}	[准备材料]
办芒特哈根的签证需要准备什么材料	{芒特哈根=签证地理位置}	[准备材料]
办库奥皮奥的签证需要准备什么材料	{库奥皮奥=签证地理位置}	[准备材料]
办波尔多的签证需要准备什么材料	{波尔多=签证地理位置}	[准备材料]
办万鸦老的签证需要准备什么材料	{万鸦老=签证地理位置}	[准备材料]
办马赛的签证需要准备什么材料	{马赛=签证地理位置}	[准备材料]
办北碧府的签证需要准备什么材料	{北碧府=签证地理位置}	[准备材料]
办阿里山的签证需要准备什么材料	{阿里山=签证地理位置}	[准备材料]
办钏路的签证需要准备什么材料	{钏路=签证地理位置}	[准备材料]
办博拉博拉岛的签证需要准备什么材料	{博拉博拉岛=签证地理位置}	[准备材料]
办克拉斯诺达尔的签证需要准备什么材料	{克拉斯诺达尔=签证地理位置}	[准备材料]
办乌布的签证需要准备什么材料	{乌布=签证地理位置}	[准备材料]
办萨法加的签证需要准备什么材料	{萨法加=签证地理位置}	[准备材料]
办艾图塔基的签证需要准备什么材料	{艾图塔基=签证地理位置}	[准备材料]
办苗栗的签证需要准备什么材料	{苗栗=签证地理位置}	[准备材料]
办蒙达的签证需要准备什么材料	{蒙达=签证地理位置}	[准备材料]
办圣马洛的签证需要准备什么材料	{圣马洛=签证地理位置}	[准备材料]
办希欧福克的签证需要准备什么材料	{希欧福克=签证地理位置}	[准备材料]
办昌原的签证需要准备什么材料	{昌原=签证地理位置}	[准备材料]
办塞得港的签证需要准备什么材料	{塞得港=签证地理位置}	[准备材料]
办菲律宾的签证需要准备什么材料	{菲律宾=签证地理位置}	[准备材料]
办巴厘巴板的签证需要准备什么材料	{巴厘巴板=签证地理位置}	[准备材料]
办网走的签证需要准备什么材料	{网走=签证地理位置}	[准备材料]
办土耳其的签证需要准备什么材料	{土耳其=签证地理位置}	[准备材料]
办海德堡的签证需要准备什么材料	{海德堡=签证地理位置}	[准备材料]
办富良野的签证需要准备什么材料	{富良野=签证地理位置}	[准备材料]
办毕尔巴鄂的签证需要准备什么材料	{毕尔巴鄂=签证地理位置}	[准备材料]
办巴勒莫的签证需要准备什么材料	{巴勒莫=签证地理位置}	[准备材料]
办清迈的签证需要准备什么材料	{清迈=签证地理位置}	[准备材料]
办格拉茨的签证需要准备什么材料	{格拉茨=签证地理位置}	[准备材料]
办米什科尔茨的签证需要准备什么材料	{米什科尔茨=签证地理位置}	[准备材料]
办亚特兰大的签证需要准备什么材料	{亚特兰大=签证地理位置}	[准备材料]
办丹老的签证需要准备什么材料	{丹老=签证地理位置}	[准备材料]
办芬兰的签证需要准备什么材料	{芬兰=签证地理位置}	[准备材料]
办拉什特的签证需要准备什么材料	{拉什特=签证地理位置}	[准备材料]
办金门的签证需要准备什么材料	{金门=签证地理位置}	[准备材料]
办马当的签证需要准备什么材料	{马当=签证地理位置}	[准备材料]
办仰光的签证需要准备什么材料	{仰光=签证地理位置}	[准备材料]
办罗斯基勒的签证需要准备什么材料	{罗斯基勒=签证地理位置}	[准备材料]
办布拉加的签证需要准备什么材料	{布拉加=签证地理位置}	[准备材料]
办素可泰的签证需要准备什么材料	{素可泰=签证地理位置}	[准备材料]
办特内里费岛的签证需要准备什么材料	{特内里费岛=签证地理位置}	[准备材料]
办新潟的签证需要准备什么材料	{新潟=签证地理位置}	[准备材料]
办玛瑙斯市的签证需要准备什么材料	{玛瑙斯市=签证地理位置}	[准备材料]
办帕劳的签证需要准备什么材料	{帕劳=签证地理位置}	[准备材料]
办卢塞恩的签证需要准备什么材料	{卢塞恩=签证地理位置}	[准备材料]
小孩儿办签证需要什么	{小孩儿=特定人群}	[准备材料]
残疾人办签证需要什么	{残疾人=特定人群}	[准备材料]
小朋友办签证需要什么	{小朋友=特定人群}	[准备材料]
军人办签证需要什么	{军人=特定人群}	[准备材料]
老人办签证需要什么	{老人=特定人群}	[准备材料]
玩儿办签证需要准备什么材料	{玩儿=签证种类相关词}	[准备材料]
出国旅行办签证需要准备什么材料	{出国旅行=签证种类相关词}	[准备材料]
