德国莱比锡的三星级酒店有哪些	{三星级=星级, 德国莱比锡=地理位置参数}	POI list
埃及苏伊士的三星级酒店有哪些	{三星级=星级, 埃及苏伊士=地理位置参数}	POI list
日本新潟的五星级酒店有哪些	{日本新潟=地理位置参数, 五星级=星级}	POI list
圣玛尔塔的四星级酒店有哪些	{圣玛尔塔=地理位置参数, 四星级=星级}	POI list
西班牙龙达的三星级酒店有哪些	{三星级=星级, 西班牙龙达=地理位置参数}	POI list
柬埔寨磅湛的三星级酒店有哪些	{三星级=星级, 柬埔寨磅湛=地理位置参数}	POI list
阿维尼翁的五星级酒店有哪些	{阿维尼翁=地理位置参数, 五星级=星级}	POI list
龙仁市的四星级酒店有哪些	{四星级=星级, 龙仁市=地理位置参数}	POI list
美国圣迭戈的五星级酒店有哪些	{美国圣迭戈=地理位置参数, 五星级=星级}	POI list
以色列贝尔谢巴的四星级酒店有哪些	{四星级=星级, 以色列贝尔谢巴=地理位置参数}	POI list
日本日光的三星级酒店有哪些	{三星级=星级, 日本日光=地理位置参数}	POI list
锡尔赫特的三星级酒店有哪些	{三星级=星级, 锡尔赫特=地理位置参数}	POI list
埃伊尔斯塔济的三星级酒店有哪些	{三星级=星级, 埃伊尔斯塔济=地理位置参数}	POI list
秘鲁阿雷基帕的四星级酒店有哪些	{四星级=星级, 秘鲁阿雷基帕=地理位置参数}	POI list
卡利的四星级酒店有哪些	{四星级=星级, 卡利=地理位置参数}	POI list
缅甸蒲甘的四星级酒店有哪些	{四星级=星级, 缅甸蒲甘=地理位置参数}	POI list
巴哈马拿骚的四星级酒店有哪些	{巴哈马拿骚=地理位置参数, 四星级=星级}	POI list
弗洛姆的五星级酒店有哪些	{弗洛姆=地理位置参数, 五星级=星级}	POI list
拉什特的四星级酒店有哪些	{四星级=星级, 拉什特=地理位置参数}	POI list
马赛马拉的三星级酒店有哪些	{三星级=星级, 马赛马拉=地理位置参数}	POI list
马丘比丘的三星级酒店有哪些	{三星级=星级, 马丘比丘=地理位置参数}	POI list
马斯帕洛马斯的五星级酒店有哪些	{马斯帕洛马斯=地理位置参数, 五星级=星级}	POI list
伊瓜苏市的五星级酒店有哪些	{伊瓜苏市=地理位置参数, 五星级=星级}	POI list
夏蒙尼的五星级酒店有哪些	{夏蒙尼=地理位置参数, 五星级=星级}	POI list
大田的四星级酒店有哪些	{四星级=星级, 大田=地理位置参数}	POI list
哥伦比亚莱蒂西亚的三星级酒店有哪些	{三星级=星级, 哥伦比亚莱蒂西亚=地理位置参数}	POI list
荷兰霍伦的四星级酒店有哪些	{四星级=星级, 荷兰霍伦=地理位置参数}	POI list
布鲁日的四星级酒店有哪些	{四星级=星级, 布鲁日=地理位置参数}	POI list
爱尔兰基尔根尼的三星级酒店有哪些	{三星级=星级, 爱尔兰基尔根尼=地理位置参数}	POI list
巴德伊舍的五星级酒店有哪些	{巴德伊舍=地理位置参数, 五星级=星级}	POI list
印度尼西亚金巴兰的五星级酒店有哪些	{印度尼西亚金巴兰=地理位置参数, 五星级=星级}	POI list
吉马良斯的四星级酒店有哪些	{四星级=星级, 吉马良斯=地理位置参数}	POI list
第戎的四星级酒店有哪些	{四星级=星级, 第戎=地理位置参数}	POI list
鲁西永的五星级酒店有哪些	{鲁西永=地理位置参数, 五星级=星级}	POI list
伊豆的三星级酒店有哪些	{三星级=星级, 伊豆=地理位置参数}	POI list
阿根廷罗萨里奥的三星级酒店有哪些	{三星级=星级, 阿根廷罗萨里奥=地理位置参数}	POI list
马尔多纳多港的四星级酒店有哪些	{四星级=星级, 马尔多纳多港=地理位置参数}	POI list
沙特麦加的四星级酒店有哪些	{四星级=星级, 沙特麦加=地理位置参数}	POI list
冰岛维克的五星级酒店有哪些	{冰岛维克=地理位置参数, 五星级=星级}	POI list
奥地利克拉根福的五星级酒店有哪些	{奥地利克拉根福=地理位置参数, 五星级=星级}	POI list
拜伦湾的五星级酒店有哪些	{拜伦湾=地理位置参数, 五星级=星级}	POI list
韩国木浦市的五星级酒店有哪些	{韩国木浦市=地理位置参数, 五星级=星级}	POI list
霍尼亚拉的四星级酒店有哪些	{霍尼亚拉=地理位置参数, 四星级=星级}	POI list
比利时布鲁塞尔的四星级酒店有哪些	{四星级=星级, 比利时布鲁塞尔=地理位置参数}	POI list
意大利陶尔米纳的五星级酒店有哪些	{意大利陶尔米纳=地理位置参数, 五星级=星级}	POI list
法属波利尼西亚帕皮提的四星级酒店有哪些	{四星级=星级, 法属波利尼西亚帕皮提=地理位置参数}	POI list
澳大利亚珀斯的四星级酒店有哪些	{四星级=星级, 澳大利亚珀斯=地理位置参数}	POI list
不丹廷布的三星级酒店有哪些	{三星级=星级, 不丹廷布=地理位置参数}	POI list
马来西亚马六甲的四星级酒店有哪些	{四星级=星级, 马来西亚马六甲=地理位置参数}	POI list
拉哈尔的三星级酒店有哪些	{三星级=星级, 拉哈尔=地理位置参数}	POI list
芬兰奥卢的五星级酒店有哪些	{芬兰奥卢=地理位置参数, 五星级=星级}	POI list
文根的三星级酒店有哪些	{三星级=星级, 文根=地理位置参数}	POI list
阿比斯库的四星级酒店有哪些	{四星级=星级, 阿比斯库=地理位置参数}	POI list
维亚纳堡的三星级酒店有哪些	{三星级=星级, 维亚纳堡=地理位置参数}	POI list
斯帕的三星级酒店有哪些	{三星级=星级, 斯帕=地理位置参数}	POI list
良瑞的四星级酒店有哪些	{四星级=星级, 良瑞=地理位置参数}	POI list
德尔斐的五星级酒店有哪些	{德尔斐=地理位置参数, 五星级=星级}	POI list
科隆的四星级酒店有哪些	{四星级=星级, 科隆=地理位置参数}	POI list
拿骚的四星级酒店有哪些	{四星级=星级, 拿骚=地理位置参数}	POI list
纳斯卡的三星级酒店有哪些	{三星级=星级, 纳斯卡=地理位置参数}	POI list
新西兰但尼丁的三星级酒店有哪些	{三星级=星级, 新西兰但尼丁=地理位置参数}	POI list
比尔森的五星级酒店有哪些	{比尔森=地理位置参数, 五星级=星级}	POI list
澳大利亚阿波罗湾的四星级酒店有哪些	{四星级=星级, 澳大利亚阿波罗湾=地理位置参数}	POI list
夏威夷的三星级酒店有哪些	{三星级=星级, 夏威夷=地理位置参数}	POI list
南非约翰内斯堡的四星级酒店有哪些	{四星级=星级, 南非约翰内斯堡=地理位置参数}	POI list
纽卡斯尔的四星级酒店有哪些	{四星级=星级, 纽卡斯尔=地理位置参数}	POI list
以色列恩戈地的四星级酒店有哪些	{四星级=星级, 以色列恩戈地=地理位置参数}	POI list
葡萄牙塔维拉的三星级酒店有哪些	{三星级=星级, 葡萄牙塔维拉=地理位置参数}	POI list
匈牙利塞格德的五星级酒店有哪些	{匈牙利塞格德=地理位置参数, 五星级=星级}	POI list
约翰内斯堡的四星级酒店有哪些	{四星级=星级, 约翰内斯堡=地理位置参数}	POI list
德国波茨坦的四星级酒店有哪些	{四星级=星级, 德国波茨坦=地理位置参数}	POI list
阿联酋迪拜的三星级酒店有哪些	{三星级=星级, 阿联酋迪拜=地理位置参数}	POI list
网走的五星级酒店有哪些	{网走=地理位置参数, 五星级=星级}	POI list
西班牙加的斯的五星级酒店有哪些	{西班牙加的斯=地理位置参数, 五星级=星级}	POI list
库克群岛阿蒂乌岛的五星级酒店有哪些	{库克群岛阿蒂乌岛=地理位置参数, 五星级=星级}	POI list
美国里弗赛德的三星级酒店有哪些	{美国里弗赛德=地理位置参数, 三星级=星级}	POI list
帕岸岛的三星级酒店有哪些	{三星级=星级, 帕岸岛=地理位置参数}	POI list
伊豆的四星级酒店有哪些	{四星级=星级, 伊豆=地理位置参数}	POI list
库斯科的五星级酒店有哪些	{库斯科=地理位置参数, 五星级=星级}	POI list
美国长滩的四星级酒店有哪些	{四星级=星级, 美国长滩=地理位置参数}	POI list
贾夫纳的三星级酒店有哪些	{三星级=星级, 贾夫纳=地理位置参数}	POI list
印度尼西亚万鸦老的五星级酒店有哪些	{印度尼西亚万鸦老=地理位置参数, 五星级=星级}	POI list
仙台的三星级酒店有哪些	{三星级=星级, 仙台=地理位置参数}	POI list
日本高山的四星级酒店有哪些	{四星级=星级, 日本高山=地理位置参数}	POI list
日本伊势的五星级酒店有哪些	{日本伊势=地理位置参数, 五星级=星级}	POI list
巴基斯坦卡拉奇的三星级酒店有哪些	{三星级=星级, 巴基斯坦卡拉奇=地理位置参数}	POI list
巴西累西腓的五星级酒店有哪些	{巴西累西腓=地理位置参数, 五星级=星级}	POI list
廷布的四星级酒店有哪些	{四星级=星级, 廷布=地理位置参数}	POI list
圣沃尔夫冈的四星级酒店有哪些	{四星级=星级, 圣沃尔夫冈=地理位置参数}	POI list
德国慕尼黑的五星级酒店有哪些	{德国慕尼黑=地理位置参数, 五星级=星级}	POI list
日本那霸的四星级酒店有哪些	{四星级=星级, 日本那霸=地理位置参数}	POI list
日本伊势的四星级酒店有哪些	{四星级=星级, 日本伊势=地理位置参数}	POI list
马来西亚斗湖的四星级酒店有哪些	{马来西亚斗湖=地理位置参数, 四星级=星级}	POI list
澳大利亚堪培拉的四星级酒店有哪些	{四星级=星级, 澳大利亚堪培拉=地理位置参数}	POI list
代尔夫特的三星级酒店有哪些	{三星级=星级, 代尔夫特=地理位置参数}	POI list
丹麦赫尔辛格的四星级酒店有哪些	{四星级=星级, 丹麦赫尔辛格=地理位置参数}	POI list
芬兰库奥皮奥的三星级酒店有哪些	{三星级=星级, 芬兰库奥皮奥=地理位置参数}	POI list
奥基的四星级酒店有哪些	{四星级=星级, 奥基=地理位置参数}	POI list
德国斯图加特的四星级酒店有哪些	{四星级=星级, 德国斯图加特=地理位置参数}	POI list
西班牙毕尔巴鄂的三星级酒店有哪些	{三星级=星级, 西班牙毕尔巴鄂=地理位置参数}	POI list
印度尼西亚龙目岛有哪些道路比较宽阔的三星级酒店	{三星级=星级, 宽阔=POI特性实体修饰, 道路=POI特性实体, 印度尼西亚龙目岛=地理位置参数}	POI list
阿联酋阿吉曼有哪些内饰比较普通的四星级酒店	{普通=POI特性实体修饰, 内饰=POI特性实体, 四星级=星级, 阿联酋阿吉曼=地理位置参数}	POI list
金海市有哪些底蕴比较浓厚的三星级酒店	{三星级=星级, 底蕴=POI特性实体, 浓厚=POI特性实体修饰, 金海市=地理位置参数}	POI list
德国巴登-巴登有哪些夜景比较差的五星级酒店	{德国巴登-巴登=地理位置参数, 夜景=POI特性实体, 差=POI特性实体修饰, 五星级=星级}	POI list
汉密尔顿有哪些外观比较不咋地的三星级酒店	{三星级=星级, 汉密尔顿=地理位置参数, 外观=POI特性实体, 不咋地=POI特性实体修饰}	POI list
彭措林有哪些风情比较有味道的五星级酒店	{有味道=POI特性实体修饰, 风情=POI特性实体, 彭措林=地理位置参数, 五星级=星级}	POI list
柬埔寨吴哥窟有哪些格局比较精致的五星级酒店	{格局=POI特性实体, 柬埔寨吴哥窟=地理位置参数, 精致=POI特性实体修饰, 五星级=星级}	POI list
日本旭川有哪些体验比较逼真的四星级酒店	{四星级=星级, 逼真=POI特性实体修饰, 体验=POI特性实体, 日本旭川=地理位置参数}	POI list
芽庄有哪些色彩比较清丽的五星级酒店	{清丽=POI特性实体修饰, 色彩=POI特性实体, 芽庄=地理位置参数, 五星级=星级}	POI list
列治文有哪些视角比较清楚的四星级酒店	{四星级=星级, 列治文=地理位置参数, 清楚=POI特性实体修饰, 视角=POI特性实体}	POI list
冰岛阿克雷里有哪些安检比较不错的四星级酒店	{四星级=星级, 不错=POI特性实体修饰, 冰岛阿克雷里=地理位置参数, 安检=POI特性实体}	POI list
日本埼玉有哪些出口比较小的四星级酒店	{四星级=星级, 出口=POI特性实体, 日本埼玉=地理位置参数, 小=POI特性实体修饰}	POI list
以色列贝特谢安有哪些绿化比较完善的五星级酒店	{完善=POI特性实体修饰, 以色列贝特谢安=地理位置参数, 绿化=POI特性实体, 五星级=星级}	POI list
秘鲁马尔多纳多港有哪些形象比较不同的五星级酒店	{形象=POI特性实体, 不同=POI特性实体修饰, 秘鲁马尔多纳多港=地理位置参数, 五星级=星级}	POI list
日本姬路有哪些冷气比较不够的五星级酒店	{冷气=POI特性实体, 日本姬路=地理位置参数, 不够=POI特性实体修饰, 五星级=星级}	POI list
锡尔赫特有哪些绿化比较不错啊的四星级酒店	{四星级=星级, 锡尔赫特=地理位置参数, 绿化=POI特性实体, 不错啊=POI特性实体修饰}	POI list
贝尔谢巴有哪些夕阳比较棒的五星级酒店	{棒=POI特性实体修饰, 夕阳=POI特性实体, 贝尔谢巴=地理位置参数, 五星级=星级}	POI list
万荣有哪些灯火比较美丽的五星级酒店	{美丽=POI特性实体修饰, 灯火=POI特性实体, 万荣=地理位置参数, 五星级=星级}	POI list
马拉加有哪些格局比较清楚的四星级酒店	{四星级=星级, 格局=POI特性实体, 清楚=POI特性实体修饰, 马拉加=地理位置参数}	POI list
阿罗萨有哪些色彩比较干净的三星级酒店	{三星级=星级, 阿罗萨=地理位置参数, 干净=POI特性实体修饰, 色彩=POI特性实体}	POI list
美国阿拉梅达有哪些现代感比较强的五星级酒店	{现代感=POI特性实体, 美国阿拉梅达=地理位置参数, 强=POI特性实体修饰, 五星级=星级}	POI list
特内里费岛有哪些海拔比较高的四星级酒店	{海拔=POI特性实体, 特内里费岛=地理位置参数, 四星级=星级, 高=POI特性实体修饰}	POI list
美国纳帕有哪些色彩比较舒服的五星级酒店	{美国纳帕=地理位置参数, 色彩=POI特性实体, 舒服=POI特性实体修饰, 五星级=星级}	POI list
开罗有哪些配置比较不够好的四星级酒店	{四星级=星级, 配置=POI特性实体, 不够好=POI特性实体修饰, 开罗=地理位置参数}	POI list
越南胡志明市有哪些生态比较完整的五星级酒店	{完整=POI特性实体修饰, 越南胡志明市=地理位置参数, 生态=POI特性实体, 五星级=星级}	POI list
意大利那不勒斯有哪些乐趣比较不多的四星级酒店	{四星级=星级, 不多=POI特性实体修饰, 乐趣=POI特性实体, 意大利那不勒斯=地理位置参数}	POI list
老挝万象有哪些夜晚比较静的四星级酒店	{四星级=星级, 夜晚=POI特性实体, 老挝万象=地理位置参数, 静=POI特性实体修饰}	POI list
葡萄牙吉马良斯有哪些香火比较鼎盛的四星级酒店	{香火=POI特性实体, 四星级=星级, 葡萄牙吉马良斯=地理位置参数, 鼎盛=POI特性实体修饰}	POI list
海参崴有哪些夕阳比较好的四星级酒店	{四星级=星级, 夕阳=POI特性实体, 海参崴=地理位置参数, 好=POI特性实体修饰}	POI list
斯里兰卡乌纳瓦图纳有哪些音场比较烂的四星级酒店	{四星级=星级, 烂=POI特性实体修饰, 音场=POI特性实体, 斯里兰卡乌纳瓦图纳=地理位置参数}	POI list
新西兰尼尔森有哪些冷气比较不够的三星级酒店	{三星级=星级, 冷气=POI特性实体, 不够=POI特性实体修饰, 新西兰尼尔森=地理位置参数}	POI list
但尼丁有哪些人气比较萧条的五星级酒店	{人气=POI特性实体, 萧条=POI特性实体修饰, 但尼丁=地理位置参数, 五星级=星级}	POI list
印度尼西亚沙努尔有哪些地势比较缓的五星级酒店	{缓=POI特性实体修饰, 印度尼西亚沙努尔=地理位置参数, 地势=POI特性实体, 五星级=星级}	POI list
法尤姆有哪些气息比较轻的三星级酒店	{三星级=星级, 法尤姆=地理位置参数, 气息=POI特性实体, 轻=POI特性实体修饰}	POI list
阿根廷卡法亚特有哪些日出比较美的的五星级酒店	{阿根廷卡法亚特=地理位置参数, 日出=POI特性实体, 美的=POI特性实体修饰, 五星级=星级}	POI list
泰国象岛有哪些卫生比较好好的三星级酒店	{三星级=星级, 泰国象岛=地理位置参数, 好好=POI特性实体修饰, 卫生=POI特性实体}	POI list
卡法萨巴有哪些氛围比较稍好的四星级酒店	{四星级=星级, 氛围=POI特性实体, 稍好=POI特性实体修饰, 卡法萨巴=地理位置参数}	POI list
法国南特有哪些形象比较全的四星级酒店	{四星级=星级, 形象=POI特性实体, 法国南特=地理位置参数, 全=POI特性实体修饰}	POI list
俄罗斯喀山有哪些形态比较凶猛的五星级酒店	{形态=POI特性实体, 俄罗斯喀山=地理位置参数, 凶猛=POI特性实体修饰, 五星级=星级}	POI list
库斯科有哪些日出比较吸引人的三星级酒店	{三星级=星级, 日出=POI特性实体, 吸引人=POI特性实体修饰, 库斯科=地理位置参数}	POI list
温莎市有哪些布景比较很好的三星级酒店	{温莎市=地理位置参数, 三星级=星级, 布景=POI特性实体, 很好=POI特性实体修饰}	POI list
安卡拉有哪些装饰比较突兀的三星级酒店	{突兀=POI特性实体修饰, 三星级=星级, 安卡拉=地理位置参数, 装饰=POI特性实体}	POI list
法国埃兹有哪些面积比较够大的三星级酒店	{三星级=星级, 够大=POI特性实体修饰, 法国埃兹=地理位置参数, 面积=POI特性实体}	POI list
列日有哪些互动性比较好的五星级酒店	{互动性=POI特性实体, 列日=地理位置参数, 好=POI特性实体修饰, 五星级=星级}	POI list
孟加拉国库尔纳有哪些音场比较烂的五星级酒店	{烂=POI特性实体修饰, 音场=POI特性实体, 孟加拉国库尔纳=地理位置参数, 五星级=星级}	POI list
阿马尔菲有哪些音场比较烂的五星级酒店	{阿马尔菲=地理位置参数, 烂=POI特性实体修饰, 音场=POI特性实体, 五星级=星级}	POI list
万象有哪些清洁度比较不错的五星级酒店	{清洁度=POI特性实体, 万象=地理位置参数, 不错=POI特性实体修饰, 五星级=星级}	POI list
马德望有哪些海拔比较太高的五星级酒店	{海拔=POI特性实体, 太高=POI特性实体修饰, 马德望=地理位置参数, 五星级=星级}	POI list
美国伯克利有哪些形象比较不同的五星级酒店	{形象=POI特性实体, 不同=POI特性实体修饰, 美国伯克利=地理位置参数, 五星级=星级}	POI list
伊豆有哪些灯火比较迷离的三星级酒店	{三星级=星级, 灯火=POI特性实体, 迷离=POI特性实体修饰, 伊豆=地理位置参数}	POI list
捷克克鲁姆洛夫有哪些外墙比较脏的五星级酒店	{捷克克鲁姆洛夫=地理位置参数, 外墙=POI特性实体, 脏=POI特性实体修饰, 五星级=星级}	POI list
瑞士布里恩茨有哪些气息比较少的四星级酒店	{少=POI特性实体修饰, 四星级=星级, 气息=POI特性实体, 瑞士布里恩茨=地理位置参数}	POI list
维多利亚市有哪些名头比较响亮的三星级酒店	{三星级=星级, 维多利亚市=地理位置参数, 响亮=POI特性实体修饰, 名头=POI特性实体}	POI list
弗里堡有哪些创意比较奇妙的五星级酒店	{奇妙=POI特性实体修饰, 弗里堡=地理位置参数, 创意=POI特性实体, 五星级=星级}	POI list
春蓬有哪些设备比较老旧了的四星级酒店	{四星级=星级, 设备=POI特性实体, 春蓬=地理位置参数, 老旧了=POI特性实体修饰}	POI list
美国芝加哥有哪些夜晚比较静悄悄的五星级酒店	{夜晚=POI特性实体, 美国芝加哥=地理位置参数, 静悄悄=POI特性实体修饰, 五星级=星级}	POI list
日本大分有哪些风情比较浓重的四星级酒店	{四星级=星级, 风情=POI特性实体, 浓重=POI特性实体修饰, 日本大分=地理位置参数}	POI list
日本热海有哪些布景比较一流的三星级酒店	{三星级=星级, 日本热海=地理位置参数, 布景=POI特性实体, 一流=POI特性实体修饰}	POI list
奥地利林茨有哪些样式比较出色的四星级酒店	{奥地利林茨=地理位置参数, 四星级=星级, 出色=POI特性实体修饰, 样式=POI特性实体}	POI list
圣卡洛斯-德巴里洛切有哪些体验比较真实的四星级酒店	{真实=POI特性实体修饰, 圣卡洛斯-德巴里洛切=地理位置参数, 四星级=星级, 体验=POI特性实体}	POI list
新西兰格林诺奇有哪些设施比较低龄化的四星级酒店	{四星级=星级, 新西兰格林诺奇=地理位置参数, 低龄化=POI特性实体修饰, 设施=POI特性实体}	POI list
圣地亚哥有哪些夜晚比较柔和的四星级酒店	{四星级=星级, 柔和=POI特性实体修饰, 夜晚=POI特性实体, 圣地亚哥=地理位置参数}	POI list
瑞士劳特布龙嫩有哪些夜晚比较安详的四星级酒店	{四星级=星级, 夜晚=POI特性实体, 安详=POI特性实体修饰, 瑞士劳特布龙嫩=地理位置参数}	POI list
挪威罗弗敦群岛有哪些视觉比较独特的三星级酒店	{三星级=星级, 视觉=POI特性实体, 独特=POI特性实体修饰, 挪威罗弗敦群岛=地理位置参数}	POI list
冰岛斯蒂基斯霍尔米有哪些声势比较惊人的四星级酒店	{冰岛斯蒂基斯霍尔米=地理位置参数, 四星级=星级, 声势=POI特性实体, 惊人=POI特性实体修饰}	POI list
罗瓦涅米有哪些夜景比较一塌糊涂的五星级酒店	{夜景=POI特性实体, 罗瓦涅米=地理位置参数, 一塌糊涂=POI特性实体修饰, 五星级=星级}	POI list
锡尔赫特有哪些外观比较简陋的四星级酒店	{四星级=星级, 简陋=POI特性实体修饰, 锡尔赫特=地理位置参数, 外观=POI特性实体}	POI list
土耳其阿瓦诺斯有哪些生态比较非常好的五星级酒店	{非常好=POI特性实体修饰, 土耳其阿瓦诺斯=地理位置参数, 生态=POI特性实体, 五星级=星级}	POI list
巴勒莫有哪些装饰比较夸张的四星级酒店	{四星级=星级, 夸张=POI特性实体修饰, 巴勒莫=地理位置参数, 装饰=POI特性实体}	POI list
英国南安普顿有哪些面积比较阔的五星级酒店	{阔=POI特性实体修饰, 英国南安普顿=地理位置参数, 面积=POI特性实体, 五星级=星级}	POI list
巴西圣保罗有哪些声势比较浩大的三星级酒店	{三星级=星级, 浩大=POI特性实体修饰, 声势=POI特性实体, 巴西圣保罗=地理位置参数}	POI list
罗什平纳有哪些布景比较有意思的五星级酒店	{布景=POI特性实体, 有意思=POI特性实体修饰, 罗什平纳=地理位置参数, 五星级=星级}	POI list
瑞士温特图尔有哪些互动性比较极强的五星级酒店	{互动性=POI特性实体, 极强=POI特性实体修饰, 瑞士温特图尔=地理位置参数, 五星级=星级}	POI list
瑞典哥德堡有哪些景色比较尚可的四星级酒店	{四星级=星级, 瑞典哥德堡=地理位置参数, 尚可=POI特性实体修饰, 景色=POI特性实体}	POI list
拿撒勒有哪些流线比较复杂的三星级酒店	{三星级=星级, 流线=POI特性实体, 复杂=POI特性实体修饰, 拿撒勒=地理位置参数}	POI list
瑞士格林德瓦有哪些招牌比较破旧的五星级酒店	{瑞士格林德瓦=地理位置参数, 招牌=POI特性实体, 破旧=POI特性实体修饰, 五星级=星级}	POI list
埃及努韦巴有哪些意义比较非凡的三星级酒店	{三星级=星级, 非凡=POI特性实体修饰, 意义=POI特性实体, 埃及努韦巴=地理位置参数}	POI list
布雷有哪些形态比较凶猛的五星级酒店	{形态=POI特性实体, 凶猛=POI特性实体修饰, 布雷=地理位置参数, 五星级=星级}	POI list
以色列内坦亚有哪些气息比较小的四星级酒店	{四星级=星级, 气息=POI特性实体, 以色列内坦亚=地理位置参数, 小=POI特性实体修饰}	POI list
哥伦比亚亚美尼亚城有哪些温度比较高啊的五星级酒店	{温度=POI特性实体, 高啊=POI特性实体修饰, 哥伦比亚亚美尼亚城=地理位置参数, 五星级=星级}	POI list
泰国大城有哪些气息比较弱的三星级酒店	{三星级=星级, 弱=POI特性实体修饰, 泰国大城=地理位置参数, 气息=POI特性实体}	POI list
菲律宾安吉利斯有哪些名气比较比较少的四星级酒店	{四星级=星级, 比较少=POI特性实体修饰, 菲律宾安吉利斯=地理位置参数, 名气=POI特性实体}	POI list
俄罗斯摩尔曼斯克有哪些声势比较浩大的五星级酒店	{浩大=POI特性实体修饰, 声势=POI特性实体, 俄罗斯摩尔曼斯克=地理位置参数, 五星级=星级}	POI list
韩国木浦市有哪些格局比较大的四星级酒店	{四星级=星级, 大=POI特性实体修饰, 格局=POI特性实体, 韩国木浦市=地理位置参数}	POI list
纽伦堡有哪些地形比较低的四星级酒店	{四星级=星级, 地形=POI特性实体, 纽伦堡=地理位置参数, 低=POI特性实体修饰}	POI list
老挝北宾有哪些知名度比较低的三星级酒店	{三星级=星级, 知名度=POI特性实体, 老挝北宾=地理位置参数, 低=POI特性实体修饰}	POI list
普诺有哪些招牌比较破旧的五星级酒店	{普诺=地理位置参数, 招牌=POI特性实体, 破旧=POI特性实体修饰, 五星级=星级}	POI list
西雅图有哪些民风比较简朴的四星级酒店	{民风=POI特性实体, 四星级=星级, 简朴=POI特性实体修饰, 西雅图=地理位置参数}	POI list
姬路有哪些格局比较不小的三星级酒店	{三星级=星级, 格局=POI特性实体, 姬路=地理位置参数, 不小=POI特性实体修饰}	POI list
门迪有哪些外表比较好的五星级酒店	{门迪=地理位置参数, 外表=POI特性实体, 好=POI特性实体修饰, 五星级=星级}	POI list
雷斯蒙有哪些结构比较分散的五星级酒店	{雷斯蒙=地理位置参数, 分散=POI特性实体修饰, 结构=POI特性实体, 五星级=星级}	POI list
依云有哪些风情比较独特的三星级酒店	{三星级=星级, 独特=POI特性实体修饰, 风情=POI特性实体, 依云=地理位置参数}	POI list
华盛顿有哪些海景比较舒畅的四星级酒店	{四星级=星级, 舒畅=POI特性实体修饰, 海景=POI特性实体, 华盛顿=地理位置参数}	POI list
龙目岛有哪些风情比较浓郁的五星级酒店	{浓郁=POI特性实体修饰, 龙目岛=地理位置参数, 风情=POI特性实体, 五星级=星级}	POI list
木浦市有哪些风格比较朴素的四星级酒店	{朴素=POI特性实体修饰, 四星级=星级, 木浦市=地理位置参数, 风格=POI特性实体}	POI list
荷兰鲁尔蒙德有哪些地形比较低的四星级酒店	{四星级=星级, 地形=POI特性实体, 荷兰鲁尔蒙德=地理位置参数, 低=POI特性实体修饰}	POI list
瑞典延雪平有哪些名声比较太大的四星级酒店	{四星级=星级, 太大=POI特性实体修饰, 瑞典延雪平=地理位置参数, 名声=POI特性实体}	POI list
赫本有哪些人气比较逊色的三星级酒店	{赫本=地理位置参数, 三星级=星级, 人气=POI特性实体, 逊色=POI特性实体修饰}	POI list
瑞士施皮茨有哪些趣味比较不错的三星级酒店	{三星级=星级, 趣味=POI特性实体, 瑞士施皮茨=地理位置参数, 不错=POI特性实体修饰}	POI list
加拿大蒙特利尔有哪些底蕴比较强的五星级酒店	{加拿大蒙特利尔=地理位置参数, 底蕴=POI特性实体, 强=POI特性实体修饰, 五星级=星级}	POI list
澳大利亚道格拉斯港哪些酒店有珊瑚	{澳大利亚道格拉斯港=地理位置参数, 珊瑚=POI内部包含实体}	POI list
阿根廷门多萨哪些酒店有锁	{锁=POI内部包含实体, 阿根廷门多萨=地理位置参数}	POI list
日本宇治哪些酒店有床铺	{日本宇治=地理位置参数, 床铺=POI内部包含实体}	POI list
荷兰马斯特里赫特哪些酒店有胡同	{荷兰马斯特里赫特=地理位置参数, 胡同=POI内部包含实体}	POI list
布里恩茨哪些酒店有大殿	{布里恩茨=地理位置参数, 大殿=POI内部包含实体}	POI list
怡保哪些酒店有大殿	{大殿=POI内部包含实体, 怡保=地理位置参数}	POI list
埃及伊斯梅利亚哪些酒店有海滩	{埃及伊斯梅利亚=地理位置参数, 海滩=POI内部包含实体}	POI list
中国高雄哪些酒店有海滩	{中国高雄=地理位置参数, 海滩=POI内部包含实体}	POI list
冰岛斯蒂基斯霍尔米哪些酒店有餐厅	{冰岛斯蒂基斯霍尔米=地理位置参数, 餐厅=POI内部包含实体}	POI list
薄荷岛哪些酒店有花园	{花园=POI内部包含实体, 薄荷岛=地理位置参数}	POI list
美国芝加哥哪些酒店有高台	{美国芝加哥=地理位置参数, 高台=POI内部包含实体}	POI list
巴布亚新几内亚新不列颠岛哪些酒店有商铺	{巴布亚新几内亚新不列颠岛=地理位置参数, 商铺=POI内部包含实体}	POI list
埃及达哈卜哪些酒店有陈设	{陈设=POI内部包含实体, 埃及达哈卜=地理位置参数}	POI list
龙仁市哪些酒店有纪念馆	{龙仁市=地理位置参数, 纪念馆=POI内部包含实体}	POI list
科隆哪些酒店有地板	{地板=POI内部包含实体, 科隆=地理位置参数}	POI list
希腊雅典哪些酒店有庭院	{希腊雅典=地理位置参数, 庭院=POI内部包含实体}	POI list
庆州哪些酒店有服装	{庆州=地理位置参数, 服装=POI内部包含实体}	POI list
伏尔加格勒哪些酒店有官邸	{伏尔加格勒=地理位置参数, 官邸=POI内部包含实体}	POI list
匈牙利希欧福克哪些酒店有蜡像馆	{匈牙利希欧福克=地理位置参数, 蜡像馆=POI内部包含实体}	POI list
门多萨哪些酒店有阶梯	{门多萨=地理位置参数, 阶梯=POI内部包含实体}	POI list
夏蒙尼哪些酒店有枫叶	{枫叶=POI内部包含实体, 夏蒙尼=地理位置参数}	POI list
印度尼西亚乌布哪些酒店有雕塑	{印度尼西亚乌布=地理位置参数, 雕塑=POI内部包含实体}	POI list
奥地利梅尔克哪些酒店有窗户	{奥地利梅尔克=地理位置参数, 窗户=POI内部包含实体}	POI list
布拉格哪些酒店有食堂	{食堂=POI内部包含实体, 布拉格=地理位置参数}	POI list
韩国丽水哪些酒店有地板	{韩国丽水=地理位置参数, 地板=POI内部包含实体}	POI list
美国布法罗哪些酒店有砂岩	{美国布法罗=地理位置参数, 砂岩=POI内部包含实体}	POI list
俄罗斯谢尔盖耶夫哪些酒店有古城堡	{俄罗斯谢尔盖耶夫=地理位置参数, 古城堡=POI内部包含实体}	POI list
枫丹白露哪些酒店有蜡像馆	{枫丹白露=地理位置参数, 蜡像馆=POI内部包含实体}	POI list
比萨哪些酒店有店铺	{比萨=地理位置参数, 店铺=POI内部包含实体}	POI list
瑞士温特图尔哪些酒店有作品	{瑞士温特图尔=地理位置参数, 作品=POI内部包含实体}	POI list
欧登塞哪些酒店有大殿	{大殿=POI内部包含实体, 欧登塞=地理位置参数}	POI list
新西兰格林诺奇哪些酒店有牌坊	{牌坊=POI内部包含实体, 新西兰格林诺奇=地理位置参数}	POI list
菲律宾栋索尔哪些酒店有影城	{影城=POI内部包含实体, 菲律宾栋索尔=地理位置参数}	POI list
日本横滨哪些酒店有园林	{园林=POI内部包含实体, 日本横滨=地理位置参数}	POI list
圣克拉拉哪些酒店有餐厅	{圣克拉拉=地理位置参数, 餐厅=POI内部包含实体}	POI list
波哥大哪些酒店有藏品	{藏品=POI内部包含实体, 波哥大=地理位置参数}	POI list
伊纳里哪些酒店有宫墙	{宫墙=POI内部包含实体, 伊纳里=地理位置参数}	POI list
葡萄牙法蒂玛哪些酒店有游乐场	{游乐场=POI内部包含实体, 葡萄牙法蒂玛=地理位置参数}	POI list
俄罗斯新西伯利亚哪些酒店有玉佛	{俄罗斯新西伯利亚=地理位置参数, 玉佛=POI内部包含实体}	POI list
奥洛穆茨哪些酒店有艺术品	{奥洛穆茨=地理位置参数, 艺术品=POI内部包含实体}	POI list
德黑兰哪些酒店有柱子	{柱子=POI内部包含实体, 德黑兰=地理位置参数}	POI list
乌鲁班巴哪些酒店有草原	{草原=POI内部包含实体, 乌鲁班巴=地理位置参数}	POI list
比利时那慕尔哪些酒店有窗户	{比利时那慕尔=地理位置参数, 窗户=POI内部包含实体}	POI list
美国阿拉梅达哪些酒店有泰迪熊	{美国阿拉梅达=地理位置参数, 泰迪熊=POI内部包含实体}	POI list
日本佐贺哪些酒店有壁画	{壁画=POI内部包含实体, 日本佐贺=地理位置参数}	POI list
比雷埃夫斯哪些酒店有官邸	{比雷埃夫斯=地理位置参数, 官邸=POI内部包含实体}	POI list
俄罗斯基洛夫哪些酒店有魔方	{魔方=POI内部包含实体, 俄罗斯基洛夫=地理位置参数}	POI list
希腊雷斯蒙哪些酒店有筏子	{希腊雷斯蒙=地理位置参数, 筏子=POI内部包含实体}	POI list
中国新北哪些酒店有院子	{中国新北=地理位置参数, 院子=POI内部包含实体}	POI list
大阪哪些酒店有停车位	{大阪=地理位置参数, 停车位=POI内部包含实体}	POI list
拉哈尔哪些酒店有剧院	{剧院=POI内部包含实体, 拉哈尔=地理位置参数}	POI list
吉佐哪些酒店有沙丘	{沙丘=POI内部包含实体, 吉佐=地理位置参数}	POI list
匈牙利蒂豪尼哪些酒店有云彩	{云彩=POI内部包含实体, 匈牙利蒂豪尼=地理位置参数}	POI list
巴哈马拿骚哪些酒店有花园	{巴哈马拿骚=地理位置参数, 花园=POI内部包含实体}	POI list
新竹哪些酒店有足球场	{新竹=地理位置参数, 足球场=POI内部包含实体}	POI list
新竹哪些酒店有云海	{新竹=地理位置参数, 云海=POI内部包含实体}	POI list
丰盛港哪些酒店有红叶	{丰盛港=地理位置参数, 红叶=POI内部包含实体}	POI list
捷克玛丽亚温泉市哪些酒店有神社	{捷克玛丽亚温泉市=地理位置参数, 神社=POI内部包含实体}	POI list
美国棕榈泉哪些酒店有商场	{美国棕榈泉=地理位置参数, 商场=POI内部包含实体}	POI list
棉花堡哪些酒店有图书馆	{棉花堡=地理位置参数, 图书馆=POI内部包含实体}	POI list
英国利兹哪些酒店有园林	{园林=POI内部包含实体, 英国利兹=地理位置参数}	POI list
智利圣地亚哥哪些酒店有商铺	{智利圣地亚哥=地理位置参数, 商铺=POI内部包含实体}	POI list
老挝丰沙湾哪些酒店有钟表馆	{钟表馆=POI内部包含实体, 老挝丰沙湾=地理位置参数}	POI list
良瑞哪些酒店有卫生间	{卫生间=POI内部包含实体, 良瑞=地理位置参数}	POI list
埃及沙姆沙伊赫哪些酒店有华表	{华表=POI内部包含实体, 埃及沙姆沙伊赫=地理位置参数}	POI list
韩国江陵哪些酒店有卧佛	{韩国江陵=地理位置参数, 卧佛=POI内部包含实体}	POI list
埃及塔巴哪些酒店有樱花	{埃及塔巴=地理位置参数, 樱花=POI内部包含实体}	POI list
维亚纳堡哪些酒店有草原	{草原=POI内部包含实体, 维亚纳堡=地理位置参数}	POI list
马来西亚马六甲哪些酒店有大佛	{马来西亚马六甲=地理位置参数, 大佛=POI内部包含实体}	POI list
意大利锡耶纳哪些酒店有灯塔	{灯塔=POI内部包含实体, 意大利锡耶纳=地理位置参数}	POI list
西班牙阿维拉哪些酒店有浮雕	{西班牙阿维拉=地理位置参数, 浮雕=POI内部包含实体}	POI list
巴格达哪些酒店有卫生间	{卫生间=POI内部包含实体, 巴格达=地理位置参数}	POI list
京都哪些酒店有蜡像馆	{京都=地理位置参数, 蜡像馆=POI内部包含实体}	POI list
圣克拉拉哪些酒店有馆藏	{圣克拉拉=地理位置参数, 馆藏=POI内部包含实体}	POI list
芬兰埃斯波哪些酒店有海滩	{芬兰埃斯波=地理位置参数, 海滩=POI内部包含实体}	POI list
意大利比萨哪些酒店有探知馆	{意大利比萨=地理位置参数, 探知馆=POI内部包含实体}	POI list
密西沙加哪些酒店有文物	{密西沙加=地理位置参数, 文物=POI内部包含实体}	POI list
捷克泰尔奇哪些酒店有城堡	{捷克泰尔奇=地理位置参数, 城堡=POI内部包含实体}	POI list
格拉纳达哪些酒店有纪念碑	{纪念碑=POI内部包含实体, 格拉纳达=地理位置参数}	POI list
迈阿密哪些酒店有佛	{迈阿密=地理位置参数, 佛=POI内部包含实体}	POI list
孟加拉国朗布尔哪些酒店有停车场	{孟加拉国朗布尔=地理位置参数, 停车场=POI内部包含实体}	POI list
卢克索哪些酒店有赌场	{卢克索=地理位置参数, 赌场=POI内部包含实体}	POI list
瑞士萨能哪些酒店有台阶	{瑞士萨能=地理位置参数, 台阶=POI内部包含实体}	POI list
瑞士文根哪些酒店有岩石	{岩石=POI内部包含实体, 瑞士文根=地理位置参数}	POI list
希腊塞萨洛尼基哪些酒店有足球场	{希腊塞萨洛尼基=地理位置参数, 足球场=POI内部包含实体}	POI list
美国迈阿密哪些酒店有足球场	{美国迈阿密=地理位置参数, 足球场=POI内部包含实体}	POI list
曼彻斯特哪些酒店有海草	{曼彻斯特=地理位置参数, 海草=POI内部包含实体}	POI list
旭川哪些酒店有浮雕	{浮雕=POI内部包含实体, 旭川=地理位置参数}	POI list
德国柏林哪些酒店有桥	{桥=POI内部包含实体, 德国柏林=地理位置参数}	POI list
扎金索斯哪些酒店有藏品	{扎金索斯=地理位置参数, 藏品=POI内部包含实体}	POI list
意大利撒丁岛哪些酒店有艺术品	{意大利撒丁岛=地理位置参数, 艺术品=POI内部包含实体}	POI list
中国北京哪些酒店有商铺	{商铺=POI内部包含实体, 中国北京=地理位置参数}	POI list
帕劳科罗尔哪些酒店有摊位	{帕劳科罗尔=地理位置参数, 摊位=POI内部包含实体}	POI list
沙夫豪森哪些酒店有作品	{沙夫豪森=地理位置参数, 作品=POI内部包含实体}	POI list
象岛哪些酒店有壁画	{壁画=POI内部包含实体, 象岛=地理位置参数}	POI list
文根哪些酒店有舞厅	{舞厅=POI内部包含实体, 文根=地理位置参数}	POI list
高山哪些酒店有照片	{高山=地理位置参数, 照片=POI内部包含实体}	POI list
帕罗哪些酒店有宫殿	{帕罗=地理位置参数, 宫殿=POI内部包含实体}	POI list
秘鲁乌鲁班巴哪些酒店有沙石	{秘鲁乌鲁班巴=地理位置参数, 沙石=POI内部包含实体}	POI list
阿雷格里港哪些酒店有屋顶	{屋顶=POI内部包含实体, 阿雷格里港=地理位置参数}	POI list
日本高松哪些酒店设置复古	{设置=POI特性实体, 日本高松=地理位置参数, 复古=POI特性实体修饰}	POI list
意大利卢卡哪些酒店污染厉害	{厉害=POI特性实体修饰, 意大利卢卡=地理位置参数, 污染=POI特性实体}	POI list
秘鲁马丘比丘哪些酒店景致多的	{多的=POI特性实体修饰, 秘鲁马丘比丘=地理位置参数, 景致=POI特性实体}	POI list
加拿大萨斯卡通哪些酒店地热有名	{加拿大萨斯卡通=地理位置参数, 地热=POI特性实体, 有名=POI特性实体修饰}	POI list
瑞典延雪平哪些酒店互动性很好	{互动性=POI特性实体, 瑞典延雪平=地理位置参数, 很好=POI特性实体修饰}	POI list
金泽哪些酒店冷气不够	{冷气=POI特性实体, 不够=POI特性实体修饰, 金泽=地理位置参数}	POI list
比利时布鲁塞尔哪些酒店日落快的	{日落=POI特性实体, 快的=POI特性实体修饰, 比利时布鲁塞尔=地理位置参数}	POI list
图恩哪些酒店卫生整洁	{整洁=POI特性实体修饰, 图恩=地理位置参数, 卫生=POI特性实体}	POI list
匈牙利黑维兹哪些酒店名气小	{匈牙利黑维兹=地理位置参数, 名气=POI特性实体, 小=POI特性实体修饰}	POI list
斯帕哪些酒店视角清晰	{清晰=POI特性实体修饰, 斯帕=地理位置参数, 视角=POI特性实体}	POI list
大不里士哪些酒店污染多了	{多了=POI特性实体修饰, 大不里士=地理位置参数, 污染=POI特性实体}	POI list
马贝拉哪些酒店声势浩大	{浩大=POI特性实体修饰, 声势=POI特性实体, 马贝拉=地理位置参数}	POI list
南池市场哪些酒店景观破败	{南池市场=地理位置参数, 破败=POI特性实体修饰, 景观=POI特性实体}	POI list
日本广岛哪些酒店空间不够	{日本广岛=地理位置参数, 空间=POI特性实体, 不够=POI特性实体修饰}	POI list
荷兰福伦丹哪些酒店样式细腻	{荷兰福伦丹=地理位置参数, 样式=POI特性实体, 细腻=POI特性实体修饰}	POI list
新西兰凯库拉哪些酒店风水好	{风水=POI特性实体, 新西兰凯库拉=地理位置参数, 好=POI特性实体修饰}	POI list
意大利卡塔尼亚哪些酒店装备完好	{装备=POI特性实体, 意大利卡塔尼亚=地理位置参数, 完好=POI特性实体修饰}	POI list
罗斯基勒哪些酒店外观难看	{外观=POI特性实体, 罗斯基勒=地理位置参数, 难看=POI特性实体修饰}	POI list
日本静冈哪些酒店地面差	{日本静冈=地理位置参数, 地面=POI特性实体, 差=POI特性实体修饰}	POI list
汉密尔顿哪些酒店卫生好呀	{汉密尔顿=地理位置参数, 好呀=POI特性实体修饰, 卫生=POI特性实体}	POI list
印度尼西亚沙努尔哪些酒店道路宽广	{印度尼西亚沙努尔=地理位置参数, 宽广=POI特性实体修饰, 道路=POI特性实体}	POI list
达哈卜哪些酒店结构乱	{乱=POI特性实体修饰, 达哈卜=地理位置参数, 结构=POI特性实体}	POI list
法国南特哪些酒店灯火耀眼	{灯火=POI特性实体, 耀眼=POI特性实体修饰, 法国南特=地理位置参数}	POI list
蒙特利尔哪些酒店细节清清楚楚	{细节=POI特性实体, 蒙特利尔=地理位置参数, 清清楚楚=POI特性实体修饰}	POI list
古晋哪些酒店污染严重	{严重=POI特性实体修饰, 古晋=地理位置参数, 污染=POI特性实体}	POI list
哥伦比亚帕斯托哪些酒店夜生活不多	{不多=POI特性实体修饰, 夜生活=POI特性实体, 哥伦比亚帕斯托=地理位置参数}	POI list
加拿大温莎市哪些酒店名气小些	{加拿大温莎市=地理位置参数, 小些=POI特性实体修饰, 名气=POI特性实体}	POI list
土耳其伊兹密尔哪些酒店夜景腻	{夜景=POI特性实体, 腻=POI特性实体修饰, 土耳其伊兹密尔=地理位置参数}	POI list
施瓦茨哪些酒店构造错综复杂	{构造=POI特性实体, 施瓦茨=地理位置参数, 错综复杂=POI特性实体修饰}	POI list
新西兰蒂阿瑙哪些酒店底蕴厚	{底蕴=POI特性实体, 厚=POI特性实体修饰, 新西兰蒂阿瑙=地理位置参数}	POI list
库奥皮奥哪些酒店夜晚舒适	{舒适=POI特性实体修饰, 夜晚=POI特性实体, 库奥皮奥=地理位置参数}	POI list
锡基霍尔哪些酒店灯光醒目	{灯光=POI特性实体, 锡基霍尔=地理位置参数, 醒目=POI特性实体修饰}	POI list
埃武拉哪些酒店知名度过低	{埃武拉=地理位置参数, 知名度=POI特性实体, 过低=POI特性实体修饰}	POI list
阿德莱德哪些酒店体验超好	{体验=POI特性实体, 超好=POI特性实体修饰, 阿德莱德=地理位置参数}	POI list
马来西亚怡保哪些酒店布置简洁	{布置=POI特性实体, 马来西亚怡保=地理位置参数, 简洁=POI特性实体修饰}	POI list
海德堡哪些酒店卫生赞	{海德堡=地理位置参数, 卫生=POI特性实体, 赞=POI特性实体修饰}	POI list
澳大利亚悉尼哪些酒店秩序尚可	{澳大利亚悉尼=地理位置参数, 秩序=POI特性实体, 尚可=POI特性实体修饰}	POI list
加拿大坎莫尔哪些酒店细节清晰	{细节=POI特性实体, 清晰=POI特性实体修饰, 加拿大坎莫尔=地理位置参数}	POI list
意大利庞贝哪些酒店风水棒	{棒=POI特性实体修饰, 意大利庞贝=地理位置参数, 风水=POI特性实体}	POI list
瑞典阿比斯库哪些酒店设计精致	{设计=POI特性实体, 精致=POI特性实体修饰, 瑞典阿比斯库=地理位置参数}	POI list
阿利坎特哪些酒店清洁度不错	{清洁度=POI特性实体, 不错=POI特性实体修饰, 阿利坎特=地理位置参数}	POI list
葡萄牙吉马良斯哪些酒店景色还可以	{还可以=POI特性实体修饰, 葡萄牙吉马良斯=地理位置参数, 景色=POI特性实体}	POI list
胡阿希内岛哪些酒店冷气不足	{冷气=POI特性实体, 不足=POI特性实体修饰, 胡阿希内岛=地理位置参数}	POI list
埃及吉萨哪些酒店可游性强	{可游性=POI特性实体, 强=POI特性实体修饰, 埃及吉萨=地理位置参数}	POI list
斯里兰卡本托特哪些酒店安检厉害	{厉害=POI特性实体修饰, 安检=POI特性实体, 斯里兰卡本托特=地理位置参数}	POI list
韩国首尔哪些酒店构造错综复杂	{构造=POI特性实体, 韩国首尔=地理位置参数, 错综复杂=POI特性实体修饰}	POI list
瑞士米伦哪些酒店图案完整	{图案=POI特性实体, 瑞士米伦=地理位置参数, 完整=POI特性实体修饰}	POI list
阿维尼翁哪些酒店卫生干净	{干净=POI特性实体修饰, 卫生=POI特性实体, 阿维尼翁=地理位置参数}	POI list
意大利撒丁岛哪些酒店秩序尚可	{意大利撒丁岛=地理位置参数, 秩序=POI特性实体, 尚可=POI特性实体修饰}	POI list
碧瑶哪些酒店清洁度不错	{清洁度=POI特性实体, 碧瑶=地理位置参数, 不错=POI特性实体修饰}	POI list
美国圣路易奥比斯波哪些酒店气氛舒适	{舒适=POI特性实体修饰, 美国圣路易奥比斯波=地理位置参数, 气氛=POI特性实体}	POI list
奥地利施拉德明哪些酒店秩序井然	{井然=POI特性实体修饰, 秩序=POI特性实体, 奥地利施拉德明=地理位置参数}	POI list
捷克泰尔奇哪些酒店名气不高	{不高=POI特性实体修饰, 捷克泰尔奇=地理位置参数, 名气=POI特性实体}	POI list
英国布里斯托哪些酒店冷气不够	{英国布里斯托=地理位置参数, 冷气=POI特性实体, 不够=POI特性实体修饰}	POI list
麦地那哪些酒店设计了不起	{了不起=POI特性实体修饰, 设计=POI特性实体, 麦地那=地理位置参数}	POI list
知床半岛哪些酒店装饰夸张	{夸张=POI特性实体修饰, 装饰=POI特性实体, 知床半岛=地理位置参数}	POI list
毛里求斯贝尔马尔哪些酒店风势强烈	{风势=POI特性实体, 强烈=POI特性实体修饰, 毛里求斯贝尔马尔=地理位置参数}	POI list
伊萨菲厄泽哪些酒店创意特别	{伊萨菲厄泽=地理位置参数, 特别=POI特性实体修饰, 创意=POI特性实体}	POI list
法兰克福哪些酒店海拔高的	{海拔=POI特性实体, 法兰克福=地理位置参数, 高的=POI特性实体修饰}	POI list
蒲甘哪些酒店地貌有意思	{蒲甘=地理位置参数, 地貌=POI特性实体, 有意思=POI特性实体修饰}	POI list
新西兰皇后镇哪些酒店声势惊人	{声势=POI特性实体, 新西兰皇后镇=地理位置参数, 惊人=POI特性实体修饰}	POI list
日本鹿儿岛哪些酒店体验美妙	{日本鹿儿岛=地理位置参数, 体验=POI特性实体, 美妙=POI特性实体修饰}	POI list
日本静冈哪些酒店风水非常好	{非常好=POI特性实体修饰, 日本静冈=地理位置参数, 风水=POI特性实体}	POI list
法国阿讷西哪些酒店风势强劲	{风势=POI特性实体, 强劲=POI特性实体修饰, 法国阿讷西=地理位置参数}	POI list
比利时布鲁塞尔哪些酒店内饰简单	{内饰=POI特性实体, 简单=POI特性实体修饰, 比利时布鲁塞尔=地理位置参数}	POI list
图卢兹哪些酒店观赏性不足	{图卢兹=地理位置参数, 观赏性=POI特性实体, 不足=POI特性实体修饰}	POI list
卡尔加里哪些酒店设计大气	{设计=POI特性实体, 卡尔加里=地理位置参数, 大气=POI特性实体修饰}	POI list
荷兰莱顿哪些酒店晚霞美好	{美好=POI特性实体修饰, 荷兰莱顿=地理位置参数, 晚霞=POI特性实体}	POI list
日本钏路哪些酒店视觉好	{日本钏路=地理位置参数, 视觉=POI特性实体, 好=POI特性实体修饰}	POI list
嘉义哪些酒店气息小	{气息=POI特性实体, 嘉义=地理位置参数, 小=POI特性实体修饰}	POI list
澳大利亚墨尔本哪些酒店风力很大	{很大=POI特性实体修饰, 澳大利亚墨尔本=地理位置参数, 风力=POI特性实体}	POI list
塞维利亚哪些酒店音场烂	{烂=POI特性实体修饰, 音场=POI特性实体, 塞维利亚=地理位置参数}	POI list
巴西阿雷格里港哪些酒店灯光明显	{灯光=POI特性实体, 明显=POI特性实体修饰, 巴西阿雷格里港=地理位置参数}	POI list
挪威斯塔万格哪些酒店布置简洁	{布置=POI特性实体, 挪威斯塔万格=地理位置参数, 简洁=POI特性实体修饰}	POI list
撒丁岛哪些酒店夜生活不多	{不多=POI特性实体修饰, 夜生活=POI特性实体, 撒丁岛=地理位置参数}	POI list
马来西亚关丹哪些酒店落日棒	{棒=POI特性实体修饰, 落日=POI特性实体, 马来西亚关丹=地理位置参数}	POI list
昆卡哪些酒店气息少	{少=POI特性实体修饰, 气息=POI特性实体, 昆卡=地理位置参数}	POI list
缅甸卡劳哪些酒店体验好玩	{体验=POI特性实体, 好玩=POI特性实体修饰, 缅甸卡劳=地理位置参数}	POI list
斯里兰卡科伦坡哪些酒店绿化不错啊	{绿化=POI特性实体, 斯里兰卡科伦坡=地理位置参数, 不错啊=POI特性实体修饰}	POI list
萨斯卡通哪些酒店景色还可以	{还可以=POI特性实体修饰, 萨斯卡通=地理位置参数, 景色=POI特性实体}	POI list
泰国大城哪些酒店风力大	{泰国大城=地理位置参数, 大=POI特性实体修饰, 风力=POI特性实体}	POI list
韩国庆州哪些酒店视角一流	{一流=POI特性实体修饰, 韩国庆州=地理位置参数, 视角=POI特性实体}	POI list
美国里弗赛德哪些酒店安检认真	{美国里弗赛德=地理位置参数, 认真=POI特性实体修饰, 安检=POI特性实体}	POI list
美国圣迭戈哪些酒店景观光秃秃	{美国圣迭戈=地理位置参数, 光秃秃=POI特性实体修饰, 景观=POI特性实体}	POI list
巴西圣保罗哪些酒店名头响亮	{巴西圣保罗=地理位置参数, 响亮=POI特性实体修饰, 名头=POI特性实体}	POI list
意大利拉斯佩齐亚哪些酒店视角棒了	{意大利拉斯佩齐亚=地理位置参数, 棒了=POI特性实体修饰, 视角=POI特性实体}	POI list
韩国富川哪些酒店视角完美	{完美=POI特性实体修饰, 韩国富川=地理位置参数, 视角=POI特性实体}	POI list
韩国全州哪些酒店治安不错呀	{治安=POI特性实体, 不错呀=POI特性实体修饰, 韩国全州=地理位置参数}	POI list
卡劳哪些酒店视觉一流	{视觉=POI特性实体, 一流=POI特性实体修饰, 卡劳=地理位置参数}	POI list
特鲁希略哪些酒店底蕴丰富	{特鲁希略=地理位置参数, 底蕴=POI特性实体, 丰富=POI特性实体修饰}	POI list
英国伦敦哪些酒店秩序良好	{秩序=POI特性实体, 英国伦敦=地理位置参数, 良好=POI特性实体修饰}	POI list
采法特哪些酒店细节清楚	{细节=POI特性实体, 清楚=POI特性实体修饰, 采法特=地理位置参数}	POI list
胡阿希内岛哪些酒店视角一流	{一流=POI特性实体修饰, 视角=POI特性实体, 胡阿希内岛=地理位置参数}	POI list
别府哪些酒店结构乱	{乱=POI特性实体修饰, 别府=地理位置参数, 结构=POI特性实体}	POI list
菲律宾马卡蒂哪些酒店夜景一塌糊涂	{夜景=POI特性实体, 菲律宾马卡蒂=地理位置参数, 一塌糊涂=POI特性实体修饰}	POI list
菲律宾克拉克哪些酒店装修新	{新=POI特性实体修饰, 菲律宾克拉克=地理位置参数, 装修=POI特性实体}	POI list
蒙特勒哪些酒店地形低	{地形=POI特性实体, 蒙特勒=地理位置参数, 低=POI特性实体修饰}	POI list
琅多哪些酒店生态完整	{完整=POI特性实体修饰, 琅多=地理位置参数, 生态=POI特性实体}	POI list
孟加拉国拉杰沙希哪些酒店细节清清楚楚	{细节=POI特性实体, 孟加拉国拉杰沙希=地理位置参数, 清清楚楚=POI特性实体修饰}	POI list
叶卡捷琳堡哪些酒店地势平	{平=POI特性实体修饰, 地势=POI特性实体, 叶卡捷琳堡=地理位置参数}	POI list
我本地有什么含温泉的酒店	{本地=GPS, 温泉=POI内部包含实体}	POI list
我本地有什么含城墙的酒店	{城墙=POI内部包含实体, 本地=GPS}	POI list
我本地有什么含喷泉的酒店	{本地=GPS, 喷泉=POI内部包含实体}	POI list
我这里有什么含大厅的酒店	{这里=GPS, 大厅=POI内部包含实体}	POI list
我本地有什么含高台的酒店	{本地=GPS, 高台=POI内部包含实体}	POI list
我本地有什么含灯塔的酒店	{本地=GPS, 灯塔=POI内部包含实体}	POI list
我这儿有什么含风铃的酒店	{风铃=POI内部包含实体, 这儿=GPS}	POI list
我这儿有什么含雕像的酒店	{这儿=GPS, 雕像=POI内部包含实体}	POI list
我这儿有什么含筏子的酒店	{这儿=GPS, 筏子=POI内部包含实体}	POI list
我这儿有什么含井的酒店	{井=POI内部包含实体, 这儿=GPS}	POI list
我这儿有什么含楼梯的酒店	{这儿=GPS, 楼梯=POI内部包含实体}	POI list
我本地有什么含台阶的酒店	{本地=GPS, 台阶=POI内部包含实体}	POI list
我本地有什么含咖啡馆的酒店	{咖啡馆=POI内部包含实体, 本地=GPS}	POI list
我本地有什么含寺庙的酒店	{寺庙=POI内部包含实体, 本地=GPS}	POI list
我这里有什么含厕所的酒店	{厕所=POI内部包含实体, 这里=GPS}	POI list
我这里有什么含红杉树的酒店	{这里=GPS, 红杉树=POI内部包含实体}	POI list
我这里有什么含陈设的酒店	{这里=GPS, 陈设=POI内部包含实体}	POI list
我这里有什么含实验室的酒店	{这里=GPS, 实验室=POI内部包含实体}	POI list
我这里有什么含海湾的酒店	{这里=GPS, 海湾=POI内部包含实体}	POI list
我这儿有什么含水族馆的酒店	{这儿=GPS, 水族馆=POI内部包含实体}	POI list
我这儿有什么含纪念堂的酒店	{纪念堂=POI内部包含实体, 这儿=GPS}	POI list
我这里有什么含房屋的酒店	{房屋=POI内部包含实体, 这里=GPS}	POI list
我这儿有什么含温泉的酒店	{这儿=GPS, 温泉=POI内部包含实体}	POI list
我本地有什么含足球场的酒店	{本地=GPS, 足球场=POI内部包含实体}	POI list
我这儿有什么含柱子的酒店	{柱子=POI内部包含实体, 这儿=GPS}	POI list
我这儿有什么含沙子的酒店	{这儿=GPS, 沙子=POI内部包含实体}	POI list
我这里有什么含探知馆的酒店	{这里=GPS, 探知馆=POI内部包含实体}	POI list
我本地有什么含壁画的酒店	{壁画=POI内部包含实体, 本地=GPS}	POI list
我这里有什么含双人房的酒店	{这里=GPS, 双人房=POI内部包含实体}	POI list
我这儿有什么含沙滩的酒店	{这儿=GPS, 沙滩=POI内部包含实体}	POI list
我这里有什么含电梯的酒店	{这里=GPS, 电梯=POI内部包含实体}	POI list
我本地有什么含植物园的酒店	{本地=GPS, 植物园=POI内部包含实体}	POI list
我本地有什么含剧场的酒店	{本地=GPS, 剧场=POI内部包含实体}	POI list
我本地有什么含园林的酒店	{园林=POI内部包含实体, 本地=GPS}	POI list
我这儿有什么含浮雕的酒店	{这儿=GPS, 浮雕=POI内部包含实体}	POI list
我本地有什么含蜡像的酒店	{本地=GPS, 蜡像=POI内部包含实体}	POI list
我这里有什么含鸟巢的酒店	{鸟巢=POI内部包含实体, 这里=GPS}	POI list
我本地有什么含岩石的酒店	{岩石=POI内部包含实体, 本地=GPS}	POI list
我本地有什么含海滩的酒店	{本地=GPS, 海滩=POI内部包含实体}	POI list
我本地有什么含华表的酒店	{华表=POI内部包含实体, 本地=GPS}	POI list
我这里有什么含咖啡厅的酒店	{这里=GPS, 咖啡厅=POI内部包含实体}	POI list
我这里有什么含鲜花的酒店	{这里=GPS, 鲜花=POI内部包含实体}	POI list
我本地有什么含店铺的酒店	{本地=GPS, 店铺=POI内部包含实体}	POI list
我本地有什么含古城堡的酒店	{古城堡=POI内部包含实体, 本地=GPS}	POI list
我这里有什么含浮雕的酒店	{这里=GPS, 浮雕=POI内部包含实体}	POI list
我这儿有什么含足球场的酒店	{这儿=GPS, 足球场=POI内部包含实体}	POI list
我本地有什么含大殿的酒店	{大殿=POI内部包含实体, 本地=GPS}	POI list
我这儿有什么含扩音器的酒店	{这儿=GPS, 扩音器=POI内部包含实体}	POI list
我本地有什么含果树的酒店	{本地=GPS, 果树=POI内部包含实体}	POI list
我这里有什么含橱柜的酒店	{这里=GPS, 橱柜=POI内部包含实体}	POI list
我这里有什么含宫墙的酒店	{这里=GPS, 宫墙=POI内部包含实体}	POI list
我本地有什么含藏品的酒店	{藏品=POI内部包含实体, 本地=GPS}	POI list
我这里有什么含霓虹灯的酒店	{这里=GPS, 霓虹灯=POI内部包含实体}	POI list
我本地有什么含赌场的酒店	{本地=GPS, 赌场=POI内部包含实体}	POI list
我这儿有什么含庭院的酒店	{这儿=GPS, 庭院=POI内部包含实体}	POI list
我本地有什么含商场的酒店	{本地=GPS, 商场=POI内部包含实体}	POI list
我这里有什么含海滩的酒店	{这里=GPS, 海滩=POI内部包含实体}	POI list
我这里有什么含佛像的酒店	{这里=GPS, 佛像=POI内部包含实体}	POI list
我这儿有什么含古城堡的酒店	{古城堡=POI内部包含实体, 这儿=GPS}	POI list
我这里有什么含馆藏的酒店	{这里=GPS, 馆藏=POI内部包含实体}	POI list
我这儿有什么含赌场的酒店	{这儿=GPS, 赌场=POI内部包含实体}	POI list
我这里有什么含云彩的酒店	{云彩=POI内部包含实体, 这里=GPS}	POI list
我这里有什么含瀑布的酒店	{这里=GPS, 瀑布=POI内部包含实体}	POI list
我这里有什么含亭的酒店	{这里=GPS, 亭=POI内部包含实体}	POI list
我这儿有什么含海草的酒店	{这儿=GPS, 海草=POI内部包含实体}	POI list
我这里有什么含楼梯的酒店	{这里=GPS, 楼梯=POI内部包含实体}	POI list
我本地有什么含玉佛的酒店	{本地=GPS, 玉佛=POI内部包含实体}	POI list
我这儿有什么含纪念碑的酒店	{纪念碑=POI内部包含实体, 这儿=GPS}	POI list
我这儿有什么含城堡的酒店	{这儿=GPS, 城堡=POI内部包含实体}	POI list
我这儿有什么含钟表馆的酒店	{钟表馆=POI内部包含实体, 这儿=GPS}	POI list
我本地有什么含鸟巢的酒店	{鸟巢=POI内部包含实体, 本地=GPS}	POI list
我本地有什么含泰迪熊的酒店	{本地=GPS, 泰迪熊=POI内部包含实体}	POI list
我这里有什么含博物馆的酒店	{博物馆=POI内部包含实体, 这里=GPS}	POI list
我这里有什么含艺术品的酒店	{这里=GPS, 艺术品=POI内部包含实体}	POI list
我这里有什么含图书馆的酒店	{这里=GPS, 图书馆=POI内部包含实体}	POI list
我本地有什么含樱花的酒店	{本地=GPS, 樱花=POI内部包含实体}	POI list
我这儿有什么含植物园的酒店	{这儿=GPS, 植物园=POI内部包含实体}	POI list
我本地有什么含桥的酒店	{桥=POI内部包含实体, 本地=GPS}	POI list
我这儿有什么含汤池的酒店	{汤池=POI内部包含实体, 这儿=GPS}	POI list
我本地有什么含钟楼的酒店	{本地=GPS, 钟楼=POI内部包含实体}	POI list
我本地有什么含海报的酒店	{海报=POI内部包含实体, 本地=GPS}	POI list
我这儿有什么含饮食区的酒店	{这儿=GPS, 饮食区=POI内部包含实体}	POI list
我本地有什么含大门的酒店	{本地=GPS, 大门=POI内部包含实体}	POI list
我本地有什么含陈设的酒店	{陈设=POI内部包含实体, 本地=GPS}	POI list
我这里有什么含商铺的酒店	{这里=GPS, 商铺=POI内部包含实体}	POI list
我这儿有什么含房间的酒店	{这儿=GPS, 房间=POI内部包含实体}	POI list
我这里有什么含巷子的酒店	{这里=GPS, 巷子=POI内部包含实体}	POI list
我这儿有什么含温泉水的酒店	{这儿=GPS, 温泉水=POI内部包含实体}	POI list
我这儿有什么含服装的酒店	{服装=POI内部包含实体, 这儿=GPS}	POI list
我这里有什么含海草的酒店	{这里=GPS, 海草=POI内部包含实体}	POI list
我本地有什么含座位的酒店	{本地=GPS, 座位=POI内部包含实体}	POI list
我这里有什么含河灯的酒店	{河灯=POI内部包含实体, 这里=GPS}	POI list
我这儿有什么含寺庙的酒店	{寺庙=POI内部包含实体, 这儿=GPS}	POI list
我本地有什么含服装的酒店	{服装=POI内部包含实体, 本地=GPS}	POI list
我本地有什么含皇宫的酒店	{本地=GPS, 皇宫=POI内部包含实体}	POI list
我这里有什么含城墙的酒店	{城墙=POI内部包含实体, 这里=GPS}	POI list
我这里有什么含指示牌的酒店	{这里=GPS, 指示牌=POI内部包含实体}	POI list
我这里有什么含冷饮店的酒店	{这里=GPS, 冷饮店=POI内部包含实体}	POI list
我本地有什么含屋顶的酒店	{屋顶=POI内部包含实体, 本地=GPS}	POI list
我这里有什么含座位的酒店	{这里=GPS, 座位=POI内部包含实体}	POI list
我这儿有哪些含馆藏的酒店	{这儿=GPS, 馆藏=POI内部包含实体}	POI list
我这里有哪些含卫生间的酒店	{这里=GPS, 卫生间=POI内部包含实体}	POI list
我这里有哪些含足球场的酒店	{这里=GPS, 足球场=POI内部包含实体}	POI list
我本地有哪些含泳池的酒店	{泳池=POI内部包含实体, 本地=GPS}	POI list
我这里有哪些含井的酒店	{这里=GPS, 井=POI内部包含实体}	POI list
我这里有哪些含楼梯的酒店	{这里=GPS, 楼梯=POI内部包含实体}	POI list
我这里有哪些含风铃的酒店	{这里=GPS, 风铃=POI内部包含实体}	POI list
我这里有哪些含城堡的酒店	{这里=GPS, 城堡=POI内部包含实体}	POI list
我本地有哪些含窗户的酒店	{本地=GPS, 窗户=POI内部包含实体}	POI list
我这儿有哪些含沙子的酒店	{这儿=GPS, 沙子=POI内部包含实体}	POI list
我这儿有哪些含草原的酒店	{草原=POI内部包含实体, 这儿=GPS}	POI list
我这里有哪些含观景台的酒店	{这里=GPS, 观景台=POI内部包含实体}	POI list
我本地有哪些含亭的酒店	{本地=GPS, 亭=POI内部包含实体}	POI list
我这儿有哪些含沙丘的酒店	{沙丘=POI内部包含实体, 这儿=GPS}	POI list
我本地有哪些含鲜花的酒店	{鲜花=POI内部包含实体, 本地=GPS}	POI list
我这里有哪些含药房的酒店	{药房=POI内部包含实体, 这里=GPS}	POI list
我这儿有哪些含大殿的酒店	{大殿=POI内部包含实体, 这儿=GPS}	POI list
我本地有哪些含通道的酒店	{本地=GPS, 通道=POI内部包含实体}	POI list
我本地有哪些含喷泉的酒店	{本地=GPS, 喷泉=POI内部包含实体}	POI list
我这里有哪些含神社的酒店	{这里=GPS, 神社=POI内部包含实体}	POI list
我这里有哪些含画的酒店	{这里=GPS, 画=POI内部包含实体}	POI list
我这儿有哪些含商场的酒店	{这儿=GPS, 商场=POI内部包含实体}	POI list
我这儿有哪些含服装的酒店	{服装=POI内部包含实体, 这儿=GPS}	POI list
我这里有哪些含大殿的酒店	{这里=GPS, 大殿=POI内部包含实体}	POI list
我这儿有哪些含棺材的酒店	{这儿=GPS, 棺材=POI内部包含实体}	POI list
我这儿有哪些含珊瑚的酒店	{这儿=GPS, 珊瑚=POI内部包含实体}	POI list
我这儿有哪些含大佛的酒店	{这儿=GPS, 大佛=POI内部包含实体}	POI list
我这里有哪些含云彩的酒店	{云彩=POI内部包含实体, 这里=GPS}	POI list
我这里有哪些含岩石的酒店	{岩石=POI内部包含实体, 这里=GPS}	POI list
我本地有哪些含实验室的酒店	{本地=GPS, 实验室=POI内部包含实体}	POI list
我这里有哪些含酒吧的酒店	{这里=GPS, 酒吧=POI内部包含实体}	POI list
我这儿有哪些含海报的酒店	{海报=POI内部包含实体, 这儿=GPS}	POI list
我本地有哪些含探知馆的酒店	{探知馆=POI内部包含实体, 本地=GPS}	POI list
我这里有哪些含纪念堂的酒店	{纪念堂=POI内部包含实体, 这里=GPS}	POI list
我这里有哪些含陈设的酒店	{这里=GPS, 陈设=POI内部包含实体}	POI list
我这儿有哪些含藏品的酒店	{藏品=POI内部包含实体, 这儿=GPS}	POI list
我本地有哪些含云彩的酒店	{云彩=POI内部包含实体, 本地=GPS}	POI list
我这里有哪些含停车场的酒店	{这里=GPS, 停车场=POI内部包含实体}	POI list
我这里有哪些含鸟巢的酒店	{鸟巢=POI内部包含实体, 这里=GPS}	POI list
我这儿有哪些含佛的酒店	{这儿=GPS, 佛=POI内部包含实体}	POI list
我本地有哪些含神社的酒店	{本地=GPS, 神社=POI内部包含实体}	POI list
我本地有哪些含牌坊的酒店	{牌坊=POI内部包含实体, 本地=GPS}	POI list
我本地有哪些含屋顶的酒店	{屋顶=POI内部包含实体, 本地=GPS}	POI list
我这儿有哪些含地砖的酒店	{这儿=GPS, 地砖=POI内部包含实体}	POI list
我这儿有哪些含美术馆的酒店	{这儿=GPS, 美术馆=POI内部包含实体}	POI list
我这儿有哪些含雕像的酒店	{这儿=GPS, 雕像=POI内部包含实体}	POI list
我这儿有哪些含瀑布的酒店	{这儿=GPS, 瀑布=POI内部包含实体}	POI list
我本地有哪些含庭院的酒店	{本地=GPS, 庭院=POI内部包含实体}	POI list
我这儿有哪些含纪念碑的酒店	{纪念碑=POI内部包含实体, 这儿=GPS}	POI list
我这里有哪些含扩音器的酒店	{这里=GPS, 扩音器=POI内部包含实体}	POI list
我这里有哪些含灯塔的酒店	{这里=GPS, 灯塔=POI内部包含实体}	POI list
我本地有哪些含城墙的酒店	{城墙=POI内部包含实体, 本地=GPS}	POI list
我本地有哪些含咖啡厅的酒店	{咖啡厅=POI内部包含实体, 本地=GPS}	POI list
我本地有哪些含房间的酒店	{本地=GPS, 房间=POI内部包含实体}	POI list
我本地有哪些含华表的酒店	{华表=POI内部包含实体, 本地=GPS}	POI list
我本地有哪些含沙子的酒店	{本地=GPS, 沙子=POI内部包含实体}	POI list
我本地有哪些含壁画的酒店	{壁画=POI内部包含实体, 本地=GPS}	POI list
我这里有哪些含阶梯的酒店	{这里=GPS, 阶梯=POI内部包含实体}	POI list
我这儿有哪些含停车位的酒店	{这儿=GPS, 停车位=POI内部包含实体}	POI list
我本地有哪些含双人房的酒店	{双人房=POI内部包含实体, 本地=GPS}	POI list
我本地有哪些含灯塔的酒店	{本地=GPS, 灯塔=POI内部包含实体}	POI list
我这儿有哪些含画的酒店	{这儿=GPS, 画=POI内部包含实体}	POI list
我本地有哪些含沙石的酒店	{沙石=POI内部包含实体, 本地=GPS}	POI list
我本地有哪些含棺材的酒店	{本地=GPS, 棺材=POI内部包含实体}	POI list
我这儿有哪些含海湾的酒店	{这儿=GPS, 海湾=POI内部包含实体}	POI list
我本地有哪些含地砖的酒店	{本地=GPS, 地砖=POI内部包含实体}	POI list
我本地有哪些含大门的酒店	{本地=GPS, 大门=POI内部包含实体}	POI list
我本地有哪些含艺术品的酒店	{本地=GPS, 艺术品=POI内部包含实体}	POI list
我这儿有哪些含厕所的酒店	{厕所=POI内部包含实体, 这儿=GPS}	POI list
我本地有哪些含卧佛的酒店	{本地=GPS, 卧佛=POI内部包含实体}	POI list
我本地有哪些含影城的酒店	{影城=POI内部包含实体, 本地=GPS}	POI list
我这里有哪些含咖啡厅的酒店	{这里=GPS, 咖啡厅=POI内部包含实体}	POI list
我本地有哪些含观景台的酒店	{观景台=POI内部包含实体, 本地=GPS}	POI list
我这里有哪些含座位的酒店	{这里=GPS, 座位=POI内部包含实体}	POI list
我本地有哪些含温泉的酒店	{本地=GPS, 温泉=POI内部包含实体}	POI list
我这儿有哪些含高台的酒店	{这儿=GPS, 高台=POI内部包含实体}	POI list
我这里有哪些含塔的酒店	{这里=GPS, 塔=POI内部包含实体}	POI list
我本地有哪些含草坪的酒店	{草坪=POI内部包含实体, 本地=GPS}	POI list
我这儿有哪些含灯的酒店	{这儿=GPS, 灯=POI内部包含实体}	POI list
我这儿有哪些含探知馆的酒店	{探知馆=POI内部包含实体, 这儿=GPS}	POI list
我这儿有哪些含科技馆的酒店	{科技馆=POI内部包含实体, 这儿=GPS}	POI list
我本地有哪些含草原的酒店	{草原=POI内部包含实体, 本地=GPS}	POI list
我这儿有哪些含作品的酒店	{这儿=GPS, 作品=POI内部包含实体}	POI list
我这里有哪些含铁塔的酒店	{铁塔=POI内部包含实体, 这里=GPS}	POI list
我这儿有哪些含宫墙的酒店	{宫墙=POI内部包含实体, 这儿=GPS}	POI list
我这里有哪些含灯的酒店	{这里=GPS, 灯=POI内部包含实体}	POI list
我这儿有哪些含展品的酒店	{这儿=GPS, 展品=POI内部包含实体}	POI list
我这里有哪些含剧院的酒店	{剧院=POI内部包含实体, 这里=GPS}	POI list
我这里有哪些含大门的酒店	{这里=GPS, 大门=POI内部包含实体}	POI list
我这里有哪些含牌坊的酒店	{牌坊=POI内部包含实体, 这里=GPS}	POI list
我本地有哪些含作品的酒店	{本地=GPS, 作品=POI内部包含实体}	POI list
我这里有哪些含房间的酒店	{这里=GPS, 房间=POI内部包含实体}	POI list
我这里有哪些含海洋馆的酒店	{这里=GPS, 海洋馆=POI内部包含实体}	POI list
我这儿有哪些含泳池的酒店	{泳池=POI内部包含实体, 这儿=GPS}	POI list
我这里有哪些含商店的酒店	{这里=GPS, 商店=POI内部包含实体}	POI list
我这儿有哪些含楼梯的酒店	{这儿=GPS, 楼梯=POI内部包含实体}	POI list
我这里有哪些含蜡像的酒店	{这里=GPS, 蜡像=POI内部包含实体}	POI list
我本地有哪些含床铺的酒店	{本地=GPS, 床铺=POI内部包含实体}	POI list
我这儿有哪些含灯塔的酒店	{这儿=GPS, 灯塔=POI内部包含实体}	POI list
我这儿有哪些含筏子的酒店	{这儿=GPS, 筏子=POI内部包含实体}	POI list
我本地有哪些配置不够好的酒店	{配置=POI特性实体, 本地=GPS, 不够好=POI特性实体修饰}	POI list
我本地有哪些氛围宽松的酒店	{氛围=POI特性实体, 本地=GPS, 宽松=POI特性实体修饰}	POI list
我本地有哪些面积巨大的酒店	{巨大=POI特性实体修饰, 本地=GPS, 面积=POI特性实体}	POI list
我这儿有哪些互动性很强的酒店	{互动性=POI特性实体, 这儿=GPS, 很强=POI特性实体修饰}	POI list
我本地有哪些风格简练的酒店	{本地=GPS, 风格=POI特性实体, 简练=POI特性实体修饰}	POI list
我这儿有哪些风情好的酒店	{风情=POI特性实体, 这儿=GPS, 好=POI特性实体修饰}	POI list
我这儿有哪些温度越来越高的酒店	{温度=POI特性实体, 越来越高=POI特性实体修饰, 这儿=GPS}	POI list
我本地有哪些店面多的酒店	{店面=POI特性实体, 本地=GPS, 多=POI特性实体修饰}	POI list
我本地有哪些地貌有意思的酒店	{地貌=POI特性实体, 本地=GPS, 有意思=POI特性实体修饰}	POI list
我本地有哪些风力强劲的酒店	{强劲=POI特性实体修饰, 本地=GPS, 风力=POI特性实体}	POI list
我本地有哪些形象不同的酒店	{形象=POI特性实体, 不同=POI特性实体修饰, 本地=GPS}	POI list
我这里有哪些音场烂的酒店	{烂=POI特性实体修饰, 这里=GPS, 音场=POI特性实体}	POI list
我本地有哪些特点不明显的酒店	{本地=GPS, 不明显=POI特性实体修饰, 特点=POI特性实体}	POI list
我这儿有哪些特点不足的酒店	{这儿=GPS, 不足=POI特性实体修饰, 特点=POI特性实体}	POI list
我这儿有哪些历史感很强的酒店	{历史感=POI特性实体, 这儿=GPS, 很强=POI特性实体修饰}	POI list
我这里有哪些视野赞的酒店	{这里=GPS, 视野=POI特性实体, 赞=POI特性实体修饰}	POI list
我这里有哪些地热有名的酒店	{这里=GPS, 地热=POI特性实体, 有名=POI特性实体修饰}	POI list
我本地有哪些海景美的酒店	{海景=POI特性实体, 本地=GPS, 美=POI特性实体修饰}	POI list
我本地有哪些招牌破旧的酒店	{本地=GPS, 招牌=POI特性实体, 破旧=POI特性实体修饰}	POI list
我本地有哪些名声响的酒店	{本地=GPS, 名声=POI特性实体, 响=POI特性实体修饰}	POI list
我本地有哪些风格朴实的酒店	{朴实=POI特性实体修饰, 本地=GPS, 风格=POI特性实体}	POI list
我这儿有哪些氛围热闹的酒店	{热闹=POI特性实体修饰, 氛围=POI特性实体, 这儿=GPS}	POI list
我这里有哪些装饰夸张的酒店	{这里=GPS, 夸张=POI特性实体修饰, 装饰=POI特性实体}	POI list
我这里有哪些风势强劲的酒店	{这里=GPS, 风势=POI特性实体, 强劲=POI特性实体修饰}	POI list
我本地有哪些氛围良好的酒店	{氛围=POI特性实体, 本地=GPS, 良好=POI特性实体修饰}	POI list
我这儿有哪些装潢豪华的酒店	{豪华=POI特性实体修饰, 这儿=GPS, 装潢=POI特性实体}	POI list
我这里有哪些治安严格的酒店	{这里=GPS, 治安=POI特性实体, 严格=POI特性实体修饰}	POI list
我这里有哪些构造错综复杂的酒店	{构造=POI特性实体, 这里=GPS, 错综复杂=POI特性实体修饰}	POI list
我这里有哪些体验超好的酒店	{这里=GPS, 体验=POI特性实体, 超好=POI特性实体修饰}	POI list
我本地有哪些底蕴浓郁的酒店	{浓郁=POI特性实体修饰, 底蕴=POI特性实体, 本地=GPS}	POI list
我这儿有哪些乐趣少的酒店	{少=POI特性实体修饰, 这儿=GPS, 乐趣=POI特性实体}	POI list
我这里有哪些冷气不足的酒店	{这里=GPS, 冷气=POI特性实体, 不足=POI特性实体修饰}	POI list
我本地有哪些景观吓人的酒店	{本地=GPS, 吓人=POI特性实体修饰, 景观=POI特性实体}	POI list
我本地有哪些灯光醒目的酒店	{灯光=POI特性实体, 本地=GPS, 醒目=POI特性实体修饰}	POI list
我这儿有哪些设置别致的酒店	{设置=POI特性实体, 别致=POI特性实体修饰, 这儿=GPS}	POI list
我本地有哪些灯火灿烂的酒店	{灯火=POI特性实体, 本地=GPS, 灿烂=POI特性实体修饰}	POI list
我这里有哪些入口秀气的酒店	{这里=GPS, 入口=POI特性实体, 秀气=POI特性实体修饰}	POI list
我本地有哪些结构差的酒店	{本地=GPS, 结构=POI特性实体, 差=POI特性实体修饰}	POI list
我这儿有哪些形态凶猛的酒店	{形态=POI特性实体, 这儿=GPS, 凶猛=POI特性实体修饰}	POI list
我这里有哪些设计聪明的酒店	{设计=POI特性实体, 这里=GPS, 聪明=POI特性实体修饰}	POI list
我这儿有哪些音场烂的酒店	{烂=POI特性实体修饰, 音场=POI特性实体, 这儿=GPS}	POI list
我这里有哪些设计惊艳了的酒店	{设计=POI特性实体, 这里=GPS, 惊艳了=POI特性实体修饰}	POI list
我这儿有哪些互动性强的的酒店	{互动性=POI特性实体, 强的=POI特性实体修饰, 这儿=GPS}	POI list
我这儿有哪些构造复杂的酒店	{构造=POI特性实体, 这儿=GPS, 复杂=POI特性实体修饰}	POI list
我这儿有哪些外观显旧的酒店	{显旧=POI特性实体修饰, 外观=POI特性实体, 这儿=GPS}	POI list
我这里有哪些外表特别的酒店	{这里=GPS, 外表=POI特性实体, 特别=POI特性实体修饰}	POI list
我本地有哪些内饰寒酸的酒店	{内饰=POI特性实体, 本地=GPS, 寒酸=POI特性实体修饰}	POI list
我本地有哪些布局紧凑的酒店	{紧凑=POI特性实体修饰, 布局=POI特性实体, 本地=GPS}	POI list
我这儿有哪些格局不错的酒店	{不错=POI特性实体修饰, 这儿=GPS, 格局=POI特性实体}	POI list
我本地有哪些形态凶猛的酒店	{形态=POI特性实体, 本地=GPS, 凶猛=POI特性实体修饰}	POI list
我本地有哪些设置完备的酒店	{完备=POI特性实体修饰, 设置=POI特性实体, 本地=GPS}	POI list
我本地有哪些光线迷人的酒店	{迷人=POI特性实体修饰, 本地=GPS, 光线=POI特性实体}	POI list
我本地有哪些风格精简的酒店	{本地=GPS, 风格=POI特性实体, 精简=POI特性实体修饰}	POI list
我这里有哪些乐趣更少的酒店	{更少=POI特性实体修饰, 这里=GPS, 乐趣=POI特性实体}	POI list
我这里有哪些风水不错的酒店	{这里=GPS, 风水=POI特性实体, 不错=POI特性实体修饰}	POI list
我这里有哪些日落较快的酒店	{这里=GPS, 日落=POI特性实体, 较快=POI特性实体修饰}	POI list
我这儿有哪些景致多样的酒店	{多样=POI特性实体修饰, 这儿=GPS, 景致=POI特性实体}	POI list
我这儿有哪些装饰突兀的酒店	{突兀=POI特性实体修饰, 这儿=GPS, 装饰=POI特性实体}	POI list
我本地有哪些景色还可以的酒店	{还可以=POI特性实体修饰, 本地=GPS, 景色=POI特性实体}	POI list
我这儿有哪些声势惊人的酒店	{声势=POI特性实体, 这儿=GPS, 惊人=POI特性实体修饰}	POI list
我这里有哪些空间不算大的酒店	{这里=GPS, 空间=POI特性实体, 不算大=POI特性实体修饰}	POI list
我这里有哪些装备齐备的酒店	{装备=POI特性实体, 这里=GPS, 齐备=POI特性实体修饰}	POI list
我这里有哪些设置别出心裁的酒店	{设置=POI特性实体, 这里=GPS, 别出心裁=POI特性实体修饰}	POI list
我这里有哪些卫生棒的酒店	{棒=POI特性实体修饰, 这里=GPS, 卫生=POI特性实体}	POI list
我本地有哪些夜晚恬静的酒店	{恬静=POI特性实体修饰, 夜晚=POI特性实体, 本地=GPS}	POI list
我本地有哪些特点少见的酒店	{本地=GPS, 少见=POI特性实体修饰, 特点=POI特性实体}	POI list
我这儿有哪些细节清楚的酒店	{细节=POI特性实体, 这儿=GPS, 清楚=POI特性实体修饰}	POI list
我本地有哪些风势大的酒店	{风势=POI特性实体, 大=POI特性实体修饰, 本地=GPS}	POI list
我这里有哪些名声大的酒店	{这里=GPS, 大=POI特性实体修饰, 名声=POI特性实体}	POI list
我这里有哪些香火不断的酒店	{香火=POI特性实体, 这里=GPS, 不断=POI特性实体修饰}	POI list
我这儿有哪些现代感十足的酒店	{现代感=POI特性实体, 这儿=GPS, 十足=POI特性实体修饰}	POI list
我这里有哪些场景逗趣的酒店	{这里=GPS, 逗趣=POI特性实体修饰, 场景=POI特性实体}	POI list
我这儿有哪些名气不高的酒店	{不高=POI特性实体修饰, 这儿=GPS, 名气=POI特性实体}	POI list
我这儿有哪些气息小的酒店	{气息=POI特性实体, 这儿=GPS, 小=POI特性实体修饰}	POI list
我本地有哪些夜景差的酒店	{夜景=POI特性实体, 本地=GPS, 差=POI特性实体修饰}	POI list
我这儿有哪些店面不少的酒店	{店面=POI特性实体, 这儿=GPS, 不少=POI特性实体修饰}	POI list
我本地有哪些安检安全的酒店	{安全=POI特性实体修饰, 本地=GPS, 安检=POI特性实体}	POI list
我这里有哪些装饰浮夸的酒店	{这里=GPS, 浮夸=POI特性实体修饰, 装饰=POI特性实体}	POI list
我本地有哪些氛围吸引人的酒店	{氛围=POI特性实体, 本地=GPS, 吸引人=POI特性实体修饰}	POI list
我本地有哪些环境别致的酒店	{别致=POI特性实体修饰, 本地=GPS, 环境=POI特性实体}	POI list
我本地有哪些乐趣少的酒店	{少=POI特性实体修饰, 本地=GPS, 乐趣=POI特性实体}	POI list
我这儿有哪些卫生不错的酒店	{不错=POI特性实体修饰, 这儿=GPS, 卫生=POI特性实体}	POI list
我本地有哪些道路宽的酒店	{本地=GPS, 宽=POI特性实体修饰, 道路=POI特性实体}	POI list
我这里有哪些清洁度高的酒店	{清洁度=POI特性实体, 这里=GPS, 高=POI特性实体修饰}	POI list
我本地有哪些晚霞棒的酒店	{棒=POI特性实体修饰, 晚霞=POI特性实体, 本地=GPS}	POI list
我这里有哪些情节很好的酒店	{情节=POI特性实体, 这里=GPS, 很好=POI特性实体修饰}	POI list
我这儿有哪些晚霞赞的酒店	{这儿=GPS, 晚霞=POI特性实体, 赞=POI特性实体修饰}	POI list
我本地有哪些构造错综复杂的酒店	{构造=POI特性实体, 错综复杂=POI特性实体修饰, 本地=GPS}	POI list
我本地有哪些光线看得清的酒店	{看得清=POI特性实体修饰, 本地=GPS, 光线=POI特性实体}	POI list
我这里有哪些人气小的酒店	{这里=GPS, 人气=POI特性实体, 小=POI特性实体修饰}	POI list
我这里有哪些风势较大的酒店	{这里=GPS, 风势=POI特性实体, 较大=POI特性实体修饰}	POI list
我这里有哪些风情棒的酒店	{棒=POI特性实体修饰, 这里=GPS, 风情=POI特性实体}	POI list
我这里有哪些治安好好的酒店	{这里=GPS, 治安=POI特性实体, 好好=POI特性实体修饰}	POI list
我本地有哪些外表体面的酒店	{体面=POI特性实体修饰, 本地=GPS, 外表=POI特性实体}	POI list
我本地有哪些光线最佳的酒店	{本地=GPS, 光线=POI特性实体, 最佳=POI特性实体修饰}	POI list
我这儿有哪些外表低调的酒店	{这儿=GPS, 外表=POI特性实体, 低调=POI特性实体修饰}	POI list
我本地有哪些知名度一般的酒店	{知名度=POI特性实体, 一般=POI特性实体修饰, 本地=GPS}	POI list
我本地有哪些地形低的酒店	{地形=POI特性实体, 本地=GPS, 低=POI特性实体修饰}	POI list
我这里有哪些结构老旧的酒店	{这里=GPS, 老旧=POI特性实体修饰, 结构=POI特性实体}	POI list
我本地有哪些装潢贵气的酒店	{本地=GPS, 装潢=POI特性实体, 贵气=POI特性实体修饰}	POI list
介绍一下猴庙的景观情况	{猴庙=POI名称, 景观=POI特性实体}	[POI特性实体修饰
介绍一下卢浮宫的布置情况	{布置=POI特性实体, 卢浮宫=POI名称}	[POI特性实体修饰
介绍一下红树的氛围情况	{红树=POI名称, 氛围=POI特性实体}	[POI特性实体修饰
介绍一下九寨沟的知名度情况	{知名度=POI特性实体, 九寨沟=POI名称}	[POI特性实体修饰
介绍一下路易港的店面情况	{店面=POI特性实体, 路易港=POI名称}	[POI特性实体修饰
介绍一下马穆提岛的风力情况	{马穆提岛=POI名称, 风力=POI特性实体}	[POI特性实体修饰
介绍一下芬兰堡的形象情况	{形象=POI特性实体, 芬兰堡=POI名称}	[POI特性实体修饰
介绍一下鼓浪屿的布置情况	{布置=POI特性实体, 鼓浪屿=POI名称}	[POI特性实体修饰
介绍一下路易港的地势情况	{地势=POI特性实体, 路易港=POI名称}	[POI特性实体修饰
介绍一下密歇根湖的出口情况	{出口=POI特性实体, 密歇根湖=POI名称}	[POI特性实体修饰
介绍一下路易港的地热情况	{地热=POI特性实体, 路易港=POI名称}	[POI特性实体修饰
介绍一下景福宫的场景情况	{景福宫=POI名称, 场景=POI特性实体}	[POI特性实体修饰
介绍一下迪斯尼的生态情况	{生态=POI特性实体, 迪斯尼=POI名称}	[POI特性实体修饰
介绍一下莱茵河的风势情况	{莱茵河=POI名称, 风势=POI特性实体}	[POI特性实体修饰
介绍一下金阁寺的日出情况	{日出=POI特性实体, 金阁寺=POI名称}	[POI特性实体修饰
介绍一下青莲院的乐趣情况	{乐趣=POI特性实体, 青莲院=POI名称}	[POI特性实体修饰
介绍一下金阁寺的面积情况	{金阁寺=POI名称, 面积=POI特性实体}	[POI特性实体修饰
介绍一下路易港的风力情况	{路易港=POI名称, 风力=POI特性实体}	[POI特性实体修饰
介绍一下卢浮宫的可游性情况	{可游性=POI特性实体, 卢浮宫=POI名称}	[POI特性实体修饰
介绍一下唐人街的海景情况	{唐人街=POI名称, 海景=POI特性实体}	[POI特性实体修饰
介绍一下莱茵河的设置情况	{莱茵河=POI名称, 设置=POI特性实体}	[POI特性实体修饰
介绍一下青莲院的落日情况	{落日=POI特性实体, 青莲院=POI名称}	[POI特性实体修饰
介绍一下猴庙的内饰情况	{内饰=POI特性实体, 猴庙=POI名称}	[POI特性实体修饰
介绍一下维多利亚港的地势情况	{地势=POI特性实体, 维多利亚港=POI名称}	[POI特性实体修饰
介绍一下芬兰堡的设备情况	{设备=POI特性实体, 芬兰堡=POI名称}	[POI特性实体修饰
介绍一下唐人街的道路情况	{唐人街=POI名称, 道路=POI特性实体}	[POI特性实体修饰
介绍一下荣军院的色彩情况	{色彩=POI特性实体, 荣军院=POI名称}	[POI特性实体修饰
介绍一下青莲院的入口情况	{入口=POI特性实体, 青莲院=POI名称}	[POI特性实体修饰
介绍一下全聚德的外墙情况	{全聚德=POI名称, 外墙=POI特性实体}	[POI特性实体修饰
介绍一下迪斯尼的安检情况	{安检=POI特性实体, 迪斯尼=POI名称}	[POI特性实体修饰
介绍一下维港的海拔情况	{海拔=POI特性实体, 维港=POI名称}	[POI特性实体修饰
介绍一下大夏宫的温度情况	{温度=POI特性实体, 大夏宫=POI名称}	[POI特性实体修饰
介绍一下密歇根湖的光线情况	{密歇根湖=POI名称, 光线=POI特性实体}	[POI特性实体修饰
介绍一下迪士尼的情节情况	{情节=POI特性实体, 迪士尼=POI名称}	[POI特性实体修饰
介绍一下维多利亚港的人气情况	{人气=POI特性实体, 维多利亚港=POI名称}	[POI特性实体修饰
介绍一下大夏宫的形态情况	{形态=POI特性实体, 大夏宫=POI名称}	[POI特性实体修饰
介绍一下猴庙的名头情况	{猴庙=POI名称, 名头=POI特性实体}	[POI特性实体修饰
介绍一下托普卡帕宫的互动性情况	{互动性=POI特性实体, 托普卡帕宫=POI名称}	[POI特性实体修饰
介绍一下猴庙的视觉情况	{视觉=POI特性实体, 猴庙=POI名称}	[POI特性实体修饰
介绍一下全聚德的设置情况	{设置=POI特性实体, 全聚德=POI名称}	[POI特性实体修饰
介绍一下凯旋门的历史感情况	{历史感=POI特性实体, 凯旋门=POI名称}	[POI特性实体修饰
介绍一下路易港的构造情况	{构造=POI特性实体, 路易港=POI名称}	[POI特性实体修饰
介绍一下全聚德的知名度情况	{知名度=POI特性实体, 全聚德=POI名称}	[POI特性实体修饰
介绍一下迪斯尼的配置情况	{配置=POI特性实体, 迪斯尼=POI名称}	[POI特性实体修饰
介绍一下凯旋门的意义情况	{意义=POI特性实体, 凯旋门=POI名称}	[POI特性实体修饰
介绍一下鼓浪屿的清洁度情况	{清洁度=POI特性实体, 鼓浪屿=POI名称}	[POI特性实体修饰
介绍一下凯旋门的风势情况	{风势=POI特性实体, 凯旋门=POI名称}	[POI特性实体修饰
介绍一下青莲院的细节情况	{细节=POI特性实体, 青莲院=POI名称}	[POI特性实体修饰
介绍一下新加坡河的装饰情况	{新加坡河=POI名称, 装饰=POI特性实体}	[POI特性实体修饰
介绍一下阿尔法玛的夜生活情况	{夜生活=POI特性实体, 阿尔法玛=POI名称}	[POI特性实体修饰
介绍一下莱茵河的色彩情况	{莱茵河=POI名称, 色彩=POI特性实体}	[POI特性实体修饰
介绍一下马穆提岛的意义情况	{意义=POI特性实体, 马穆提岛=POI名称}	[POI特性实体修饰
介绍一下全聚德的气温情况	{全聚德=POI名称, 气温=POI特性实体}	[POI特性实体修饰
介绍一下路易港的气温情况	{气温=POI特性实体, 路易港=POI名称}	[POI特性实体修饰
介绍一下芬兰堡的地貌情况	{地貌=POI特性实体, 芬兰堡=POI名称}	[POI特性实体修饰
介绍一下猴庙的环境情况	{环境=POI特性实体, 猴庙=POI名称}	[POI特性实体修饰
介绍一下荣军院的风势情况	{风势=POI特性实体, 荣军院=POI名称}	[POI特性实体修饰
介绍一下景福宫的治安情况	{治安=POI特性实体, 景福宫=POI名称}	[POI特性实体修饰
介绍一下迪斯尼的夕阳情况	{夕阳=POI特性实体, 迪斯尼=POI名称}	[POI特性实体修饰
介绍一下迪斯尼的风水情况	{风水=POI特性实体, 迪斯尼=POI名称}	[POI特性实体修饰
介绍一下红树的结构情况	{红树=POI名称, 结构=POI特性实体}	[POI特性实体修饰
介绍一下九寨沟的风情情况	{九寨沟=POI名称, 风情=POI特性实体}	[POI特性实体修饰
介绍一下九寨沟的底蕴情况	{底蕴=POI特性实体, 九寨沟=POI名称}	[POI特性实体修饰
介绍一下新加坡河的设置情况	{设置=POI特性实体, 新加坡河=POI名称}	[POI特性实体修饰
介绍一下莱茵河的可游性情况	{莱茵河=POI名称, 可游性=POI特性实体}	[POI特性实体修饰
介绍一下莱茵河的噪声情况	{莱茵河=POI名称, 噪声=POI特性实体}	[POI特性实体修饰
介绍一下日月潭的结构情况	{日月潭=POI名称, 结构=POI特性实体}	[POI特性实体修饰
介绍一下维多利亚港的色彩情况	{维多利亚港=POI名称, 色彩=POI特性实体}	[POI特性实体修饰
介绍一下白沙滩的情节情况	{情节=POI特性实体, 白沙滩=POI名称}	[POI特性实体修饰
介绍一下马穆提岛的声势情况	{声势=POI特性实体, 马穆提岛=POI名称}	[POI特性实体修饰
介绍一下鼓浪屿的风势情况	{风势=POI特性实体, 鼓浪屿=POI名称}	[POI特性实体修饰
介绍一下荣军院的日出情况	{日出=POI特性实体, 荣军院=POI名称}	[POI特性实体修饰
介绍一下红树的香火情况	{红树=POI名称, 香火=POI特性实体}	[POI特性实体修饰
介绍一下迪士尼的设计情况	{设计=POI特性实体, 迪士尼=POI名称}	[POI特性实体修饰
介绍一下玛黑区的海景情况	{玛黑区=POI名称, 海景=POI特性实体}	[POI特性实体修饰
介绍一下密歇根湖的装修情况	{密歇根湖=POI名称, 装修=POI特性实体}	[POI特性实体修饰
介绍一下托普卡帕宫的海景情况	{海景=POI特性实体, 托普卡帕宫=POI名称}	[POI特性实体修饰
介绍一下孚日宫的构造情况	{构造=POI特性实体, 孚日宫=POI名称}	[POI特性实体修饰
介绍一下卢浮宫的现代感情况	{现代感=POI特性实体, 卢浮宫=POI名称}	[POI特性实体修饰
介绍一下孚日宫的景致情况	{孚日宫=POI名称, 景致=POI特性实体}	[POI特性实体修饰
介绍一下马穆提岛的流线情况	{流线=POI特性实体, 马穆提岛=POI名称}	[POI特性实体修饰
介绍一下莱茵河的样式情况	{莱茵河=POI名称, 样式=POI特性实体}	[POI特性实体修饰
介绍一下维港的地热情况	{维港=POI名称, 地热=POI特性实体}	[POI特性实体修饰
介绍一下多瑙河的店面情况	{店面=POI特性实体, 多瑙河=POI名称}	[POI特性实体修饰
介绍一下阿尔法玛的人气情况	{人气=POI特性实体, 阿尔法玛=POI名称}	[POI特性实体修饰
介绍一下青莲院的底蕴情况	{底蕴=POI特性实体, 青莲院=POI名称}	[POI特性实体修饰
介绍一下景福宫的绿化情况	{景福宫=POI名称, 绿化=POI特性实体}	[POI特性实体修饰
介绍一下唐人街的意义情况	{唐人街=POI名称, 意义=POI特性实体}	[POI特性实体修饰
介绍一下维港的招牌情况	{维港=POI名称, 招牌=POI特性实体}	[POI特性实体修饰
介绍一下唐人街的流线情况	{流线=POI特性实体, 唐人街=POI名称}	[POI特性实体修饰
介绍一下维港的道路情况	{维港=POI名称, 道路=POI特性实体}	[POI特性实体修饰
介绍一下托普卡帕宫的规模情况	{规模=POI特性实体, 托普卡帕宫=POI名称}	[POI特性实体修饰
介绍一下维多利亚港的风力情况	{维多利亚港=POI名称, 风力=POI特性实体}	[POI特性实体修饰
介绍一下托普卡帕宫的人气情况	{人气=POI特性实体, 托普卡帕宫=POI名称}	[POI特性实体修饰
介绍一下迪斯尼的灯火情况	{灯火=POI特性实体, 迪斯尼=POI名称}	[POI特性实体修饰
介绍一下阿尔法玛的落日情况	{阿尔法玛=POI名称, 落日=POI特性实体}	[POI特性实体修饰
介绍一下青莲院的污染情况	{青莲院=POI名称, 污染=POI特性实体}	[POI特性实体修饰
介绍一下卢浮宫的形象情况	{形象=POI特性实体, 卢浮宫=POI名称}	[POI特性实体修饰
介绍一下多瑙河的氛围情况	{氛围=POI特性实体, 多瑙河=POI名称}	[POI特性实体修饰
介绍一下光明寺的外表情况	{光明寺=POI名称, 外表=POI特性实体}	[POI特性实体修饰
多瑙河的结构怎么样	{多瑙河=POI名称, 结构=POI特性实体}	[POI特性实体修饰
全聚德的清洁度怎么样	{清洁度=POI特性实体, 全聚德=POI名称}	[POI特性实体修饰
阿尔法玛的夜晚怎么样	{夜晚=POI特性实体, 阿尔法玛=POI名称}	[POI特性实体修饰
玛黑区的形象怎么样	{玛黑区=POI名称, 形象=POI特性实体}	[POI特性实体修饰
阿尔法玛的夜生活怎么样	{夜生活=POI特性实体, 阿尔法玛=POI名称}	[POI特性实体修饰
马穆提岛的人气怎么样	{人气=POI特性实体, 马穆提岛=POI名称}	[POI特性实体修饰
迪士尼的卫生怎么样	{迪士尼=POI名称, 卫生=POI特性实体}	[POI特性实体修饰
维港的夕阳怎么样	{维港=POI名称, 夕阳=POI特性实体}	[POI特性实体修饰
卢浮宫的地形怎么样	{地形=POI特性实体, 卢浮宫=POI名称}	[POI特性实体修饰
全聚德的安检怎么样	{全聚德=POI名称, 安检=POI特性实体}	[POI特性实体修饰
阿尔法玛的音场怎么样	{音场=POI特性实体, 阿尔法玛=POI名称}	[POI特性实体修饰
密歇根湖的外表怎么样	{密歇根湖=POI名称, 外表=POI特性实体}	[POI特性实体修饰
红树的声势怎么样	{红树=POI名称, 声势=POI特性实体}	[POI特性实体修饰
卢浮宫的安检怎么样	{卢浮宫=POI名称, 安检=POI特性实体}	[POI特性实体修饰
光明寺的结构怎么样	{光明寺=POI名称, 结构=POI特性实体}	[POI特性实体修饰
鼓浪屿的图案怎么样	{图案=POI特性实体, 鼓浪屿=POI名称}	[POI特性实体修饰
阿尔法玛的景致怎么样	{阿尔法玛=POI名称, 景致=POI特性实体}	[POI特性实体修饰
日月潭的名头怎么样	{日月潭=POI名称, 名头=POI特性实体}	[POI特性实体修饰
托普卡帕宫的声势怎么样	{声势=POI特性实体, 托普卡帕宫=POI名称}	[POI特性实体修饰
荣军院的设置怎么样	{设置=POI特性实体, 荣军院=POI名称}	[POI特性实体修饰
玛黑区的知名度怎么样	{玛黑区=POI名称, 知名度=POI特性实体}	[POI特性实体修饰
猴庙的噪声怎么样	{猴庙=POI名称, 噪声=POI特性实体}	[POI特性实体修饰
莱茵河的风情怎么样	{莱茵河=POI名称, 风情=POI特性实体}	[POI特性实体修饰
日月潭的气氛怎么样	{日月潭=POI名称, 气氛=POI特性实体}	[POI特性实体修饰
光明寺的门面怎么样	{光明寺=POI名称, 门面=POI特性实体}	[POI特性实体修饰
孚日宫的形象怎么样	{孚日宫=POI名称, 形象=POI特性实体}	[POI特性实体修饰
鼓浪屿的外观怎么样	{外观=POI特性实体, 鼓浪屿=POI名称}	[POI特性实体修饰
猴庙的样式怎么样	{样式=POI特性实体, 猴庙=POI名称}	[POI特性实体修饰
荣军院的观赏性怎么样	{观赏性=POI特性实体, 荣军院=POI名称}	[POI特性实体修饰
景福宫的装饰怎么样	{景福宫=POI名称, 装饰=POI特性实体}	[POI特性实体修饰
红树的名声怎么样	{红树=POI名称, 名声=POI特性实体}	[POI特性实体修饰
白沙滩的日落怎么样	{日落=POI特性实体, 白沙滩=POI名称}	[POI特性实体修饰
鼓浪屿的装潢怎么样	{鼓浪屿=POI名称, 装潢=POI特性实体}	[POI特性实体修饰
景福宫的设置怎么样	{设置=POI特性实体, 景福宫=POI名称}	[POI特性实体修饰
大夏宫的情节怎么样	{情节=POI特性实体, 大夏宫=POI名称}	[POI特性实体修饰
红树的名气怎么样	{红树=POI名称, 名气=POI特性实体}	[POI特性实体修饰
芬兰堡的气息怎么样	{气息=POI特性实体, 芬兰堡=POI名称}	[POI特性实体修饰
白沙滩的冷气怎么样	{白沙滩=POI名称, 冷气=POI特性实体}	[POI特性实体修饰
莱茵河的夕阳怎么样	{莱茵河=POI名称, 夕阳=POI特性实体}	[POI特性实体修饰
维多利亚港的气势怎么样	{气势=POI特性实体, 维多利亚港=POI名称}	[POI特性实体修饰
日月潭的样式怎么样	{日月潭=POI名称, 样式=POI特性实体}	[POI特性实体修饰
日月潭的民风怎么样	{民风=POI特性实体, 日月潭=POI名称}	[POI特性实体修饰
凯旋门的装饰怎么样	{装饰=POI特性实体, 凯旋门=POI名称}	[POI特性实体修饰
荣军院的景致怎么样	{景致=POI特性实体, 荣军院=POI名称}	[POI特性实体修饰
多瑙河的互动性怎么样	{互动性=POI特性实体, 多瑙河=POI名称}	[POI特性实体修饰
托普卡帕宫的历史感怎么样	{历史感=POI特性实体, 托普卡帕宫=POI名称}	[POI特性实体修饰
光明寺的装潢怎么样	{光明寺=POI名称, 装潢=POI特性实体}	[POI特性实体修饰
托普卡帕宫的格局怎么样	{格局=POI特性实体, 托普卡帕宫=POI名称}	[POI特性实体修饰
迪斯尼的风力怎么样	{迪斯尼=POI名称, 风力=POI特性实体}	[POI特性实体修饰
维港的场景怎么样	{维港=POI名称, 场景=POI特性实体}	[POI特性实体修饰
维港的招牌怎么样	{维港=POI名称, 招牌=POI特性实体}	[POI特性实体修饰
多瑙河的底蕴怎么样	{底蕴=POI特性实体, 多瑙河=POI名称}	[POI特性实体修饰
托普卡帕宫的名头怎么样	{托普卡帕宫=POI名称, 名头=POI特性实体}	[POI特性实体修饰
九寨沟的外墙怎么样	{九寨沟=POI名称, 外墙=POI特性实体}	[POI特性实体修饰
迪士尼的夕阳怎么样	{夕阳=POI特性实体, 迪士尼=POI名称}	[POI特性实体修饰
托普卡帕宫的风力怎么样	{托普卡帕宫=POI名称, 风力=POI特性实体}	[POI特性实体修饰
金阁寺的日出怎么样	{日出=POI特性实体, 金阁寺=POI名称}	[POI特性实体修饰
路易港的晚霞怎么样	{晚霞=POI特性实体, 路易港=POI名称}	[POI特性实体修饰
迪斯尼的互动性怎么样	{互动性=POI特性实体, 迪斯尼=POI名称}	[POI特性实体修饰
迪士尼的风水怎么样	{风水=POI特性实体, 迪士尼=POI名称}	[POI特性实体修饰
芬兰堡的知名度怎么样	{知名度=POI特性实体, 芬兰堡=POI名称}	[POI特性实体修饰
红树的治安怎么样	{红树=POI名称, 治安=POI特性实体}	[POI特性实体修饰
新加坡河的细节怎么样	{细节=POI特性实体, 新加坡河=POI名称}	[POI特性实体修饰
猴庙的地热怎么样	{地热=POI特性实体, 猴庙=POI名称}	[POI特性实体修饰
鼓浪屿的门面怎么样	{门面=POI特性实体, 鼓浪屿=POI名称}	[POI特性实体修饰
荣军院的视角怎么样	{荣军院=POI名称, 视角=POI特性实体}	[POI特性实体修饰
卢浮宫的夜生活怎么样	{夜生活=POI特性实体, 卢浮宫=POI名称}	[POI特性实体修饰
孚日宫的气温怎么样	{孚日宫=POI名称, 气温=POI特性实体}	[POI特性实体修饰
孚日宫的绿化怎么样	{孚日宫=POI名称, 绿化=POI特性实体}	[POI特性实体修饰
景福宫的互动性怎么样	{互动性=POI特性实体, 景福宫=POI名称}	[POI特性实体修饰
迪斯尼的特点怎么样	{特点=POI特性实体, 迪斯尼=POI名称}	[POI特性实体修饰
金阁寺的布局怎么样	{布局=POI特性实体, 金阁寺=POI名称}	[POI特性实体修饰
荣军院的互动性怎么样	{互动性=POI特性实体, 荣军院=POI名称}	[POI特性实体修饰
迪斯尼的日出怎么样	{日出=POI特性实体, 迪斯尼=POI名称}	[POI特性实体修饰
迪士尼的气温怎么样	{气温=POI特性实体, 迪士尼=POI名称}	[POI特性实体修饰
迪斯尼的可游性怎么样	{可游性=POI特性实体, 迪斯尼=POI名称}	[POI特性实体修饰
大夏宫的景致怎么样	{景致=POI特性实体, 大夏宫=POI名称}	[POI特性实体修饰
多瑙河的落日怎么样	{多瑙河=POI名称, 落日=POI特性实体}	[POI特性实体修饰
维港的气氛怎么样	{维港=POI名称, 气氛=POI特性实体}	[POI特性实体修饰
阿尔法玛的流线怎么样	{流线=POI特性实体, 阿尔法玛=POI名称}	[POI特性实体修饰
多瑙河的外墙怎么样	{多瑙河=POI名称, 外墙=POI特性实体}	[POI特性实体修饰
玛黑区的视角怎么样	{玛黑区=POI名称, 视角=POI特性实体}	[POI特性实体修饰
金阁寺的落日怎么样	{落日=POI特性实体, 金阁寺=POI名称}	[POI特性实体修饰
日月潭的色彩怎么样	{日月潭=POI名称, 色彩=POI特性实体}	[POI特性实体修饰
大夏宫的装潢怎么样	{大夏宫=POI名称, 装潢=POI特性实体}	[POI特性实体修饰
托普卡帕宫的装潢怎么样	{托普卡帕宫=POI名称, 装潢=POI特性实体}	[POI特性实体修饰
阿尔法玛的内饰怎么样	{内饰=POI特性实体, 阿尔法玛=POI名称}	[POI特性实体修饰
金阁寺的样式怎么样	{样式=POI特性实体, 金阁寺=POI名称}	[POI特性实体修饰
新加坡河的香火怎么样	{香火=POI特性实体, 新加坡河=POI名称}	[POI特性实体修饰
鼓浪屿的构造怎么样	{构造=POI特性实体, 鼓浪屿=POI名称}	[POI特性实体修饰
维多利亚港的海景怎么样	{海景=POI特性实体, 维多利亚港=POI名称}	[POI特性实体修饰
马穆提岛的风水怎么样	{风水=POI特性实体, 马穆提岛=POI名称}	[POI特性实体修饰
荣军院的夜晚怎么样	{夜晚=POI特性实体, 荣军院=POI名称}	[POI特性实体修饰
芬兰堡的设计怎么样	{设计=POI特性实体, 芬兰堡=POI名称}	[POI特性实体修饰
凯旋门的设计怎么样	{设计=POI特性实体, 凯旋门=POI名称}	[POI特性实体修饰
景福宫的门面怎么样	{景福宫=POI名称, 门面=POI特性实体}	[POI特性实体修饰
金阁寺的外观怎么样	{外观=POI特性实体, 金阁寺=POI名称}	[POI特性实体修饰
金阁寺的日落怎么样	{日落=POI特性实体, 金阁寺=POI名称}	[POI特性实体修饰
九寨沟的景观怎么样	{九寨沟=POI名称, 景观=POI特性实体}	[POI特性实体修饰
鼓浪屿的地貌怎么样	{地貌=POI特性实体, 鼓浪屿=POI名称}	[POI特性实体修饰
迪士尼的噪声好吗	{迪士尼=POI名称, 噪声=POI特性实体}	[POI特性实体修饰
新加坡河的内饰好吗	{内饰=POI特性实体, 新加坡河=POI名称}	[POI特性实体修饰
阿尔法玛的气温好吗	{阿尔法玛=POI名称, 气温=POI特性实体}	[POI特性实体修饰
密歇根湖的形态好吗	{形态=POI特性实体, 密歇根湖=POI名称}	[POI特性实体修饰
景福宫的装潢好吗	{景福宫=POI名称, 装潢=POI特性实体}	[POI特性实体修饰
大夏宫的招牌好吗	{大夏宫=POI名称, 招牌=POI特性实体}	[POI特性实体修饰
光明寺的情节好吗	{情节=POI特性实体, 光明寺=POI名称}	[POI特性实体修饰
阿尔法玛的名气好吗	{阿尔法玛=POI名称, 名气=POI特性实体}	[POI特性实体修饰
卢浮宫的出口好吗	{出口=POI特性实体, 卢浮宫=POI名称}	[POI特性实体修饰
鼓浪屿的污染好吗	{鼓浪屿=POI名称, 污染=POI特性实体}	[POI特性实体修饰
多瑙河的海拔好吗	{海拔=POI特性实体, 多瑙河=POI名称}	[POI特性实体修饰
芬兰堡的景致好吗	{芬兰堡=POI名称, 景致=POI特性实体}	[POI特性实体修饰
维港的现代感好吗	{现代感=POI特性实体, 维港=POI名称}	[POI特性实体修饰
迪斯尼的外墙好吗	{外墙=POI特性实体, 迪斯尼=POI名称}	[POI特性实体修饰
路易港的设施好吗	{路易港=POI名称, 设施=POI特性实体}	[POI特性实体修饰
迪士尼的日落好吗	{日落=POI特性实体, 迪士尼=POI名称}	[POI特性实体修饰
玛黑区的名头好吗	{玛黑区=POI名称, 名头=POI特性实体}	[POI特性实体修饰
猴庙的海景好吗	{海景=POI特性实体, 猴庙=POI名称}	[POI特性实体修饰
多瑙河的卫生好吗	{多瑙河=POI名称, 卫生=POI特性实体}	[POI特性实体修饰
阿尔法玛的日出好吗	{阿尔法玛=POI名称, 日出=POI特性实体}	[POI特性实体修饰
迪士尼的海景好吗	{海景=POI特性实体, 迪士尼=POI名称}	[POI特性实体修饰
青莲院的意义好吗	{意义=POI特性实体, 青莲院=POI名称}	[POI特性实体修饰
卢浮宫的民风好吗	{民风=POI特性实体, 卢浮宫=POI名称}	[POI特性实体修饰
鼓浪屿的地热好吗	{地热=POI特性实体, 鼓浪屿=POI名称}	[POI特性实体修饰
迪士尼的卫生好吗	{迪士尼=POI名称, 卫生=POI特性实体}	[POI特性实体修饰
荣军院的设备好吗	{设备=POI特性实体, 荣军院=POI名称}	[POI特性实体修饰
玛黑区的构造好吗	{玛黑区=POI名称, 构造=POI特性实体}	[POI特性实体修饰
猴庙的观赏性好吗	{猴庙=POI名称, 观赏性=POI特性实体}	[POI特性实体修饰
路易港的规模好吗	{路易港=POI名称, 规模=POI特性实体}	[POI特性实体修饰
孚日宫的风势好吗	{孚日宫=POI名称, 风势=POI特性实体}	[POI特性实体修饰
多瑙河的形态好吗	{形态=POI特性实体, 多瑙河=POI名称}	[POI特性实体修饰
景福宫的配置好吗	{配置=POI特性实体, 景福宫=POI名称}	[POI特性实体修饰
托普卡帕宫的名头好吗	{托普卡帕宫=POI名称, 名头=POI特性实体}	[POI特性实体修饰
金阁寺的视觉好吗	{视觉=POI特性实体, 金阁寺=POI名称}	[POI特性实体修饰
荣军院的构造好吗	{构造=POI特性实体, 荣军院=POI名称}	[POI特性实体修饰
青莲院的日落好吗	{日落=POI特性实体, 青莲院=POI名称}	[POI特性实体修饰
大夏宫的治安好吗	{治安=POI特性实体, 大夏宫=POI名称}	[POI特性实体修饰
白沙滩的出口好吗	{出口=POI特性实体, 白沙滩=POI名称}	[POI特性实体修饰
青莲院的细节好吗	{细节=POI特性实体, 青莲院=POI名称}	[POI特性实体修饰
青莲院的清洁度好吗	{清洁度=POI特性实体, 青莲院=POI名称}	[POI特性实体修饰
金阁寺的冷气好吗	{冷气=POI特性实体, 金阁寺=POI名称}	[POI特性实体修饰
迪士尼的体验好吗	{体验=POI特性实体, 迪士尼=POI名称}	[POI特性实体修饰
马穆提岛的流线好吗	{流线=POI特性实体, 马穆提岛=POI名称}	[POI特性实体修饰
孚日宫的景象好吗	{孚日宫=POI名称, 景象=POI特性实体}	[POI特性实体修饰
金阁寺的风力好吗	{金阁寺=POI名称, 风力=POI特性实体}	[POI特性实体修饰
大夏宫的门面好吗	{门面=POI特性实体, 大夏宫=POI名称}	[POI特性实体修饰
莱茵河的夕阳好吗	{莱茵河=POI名称, 夕阳=POI特性实体}	[POI特性实体修饰
卢浮宫的污染好吗	{卢浮宫=POI名称, 污染=POI特性实体}	[POI特性实体修饰
迪斯尼的特点好吗	{特点=POI特性实体, 迪斯尼=POI名称}	[POI特性实体修饰
日月潭的可游性好吗	{日月潭=POI名称, 可游性=POI特性实体}	[POI特性实体修饰
全聚德的氛围好吗	{全聚德=POI名称, 氛围=POI特性实体}	[POI特性实体修饰
猴庙的景致好吗	{景致=POI特性实体, 猴庙=POI名称}	[POI特性实体修饰
景福宫的样式好吗	{景福宫=POI名称, 样式=POI特性实体}	[POI特性实体修饰
九寨沟的风格好吗	{九寨沟=POI名称, 风格=POI特性实体}	[POI特性实体修饰
迪斯尼的名声好吗	{名声=POI特性实体, 迪斯尼=POI名称}	[POI特性实体修饰
密歇根湖的民风好吗	{民风=POI特性实体, 密歇根湖=POI名称}	[POI特性实体修饰
红树的香火好吗	{红树=POI名称, 香火=POI特性实体}	[POI特性实体修饰
大夏宫的气温好吗	{气温=POI特性实体, 大夏宫=POI名称}	[POI特性实体修饰
猴庙的可游性好吗	{可游性=POI特性实体, 猴庙=POI名称}	[POI特性实体修饰
日月潭的噪声好吗	{日月潭=POI名称, 噪声=POI特性实体}	[POI特性实体修饰
凯旋门的景色好吗	{凯旋门=POI名称, 景色=POI特性实体}	[POI特性实体修饰
金阁寺的温度好吗	{温度=POI特性实体, 金阁寺=POI名称}	[POI特性实体修饰
九寨沟的店面好吗	{九寨沟=POI名称, 店面=POI特性实体}	[POI特性实体修饰
红树的景色好吗	{红树=POI名称, 景色=POI特性实体}	[POI特性实体修饰
日月潭的晚霞好吗	{日月潭=POI名称, 晚霞=POI特性实体}	[POI特性实体修饰
猴庙的绿化好吗	{绿化=POI特性实体, 猴庙=POI名称}	[POI特性实体修饰
九寨沟的日落好吗	{日落=POI特性实体, 九寨沟=POI名称}	[POI特性实体修饰
金阁寺的规模好吗	{规模=POI特性实体, 金阁寺=POI名称}	[POI特性实体修饰
维港的风情好吗	{维港=POI名称, 风情=POI特性实体}	[POI特性实体修饰
卢浮宫的色彩好吗	{色彩=POI特性实体, 卢浮宫=POI名称}	[POI特性实体修饰
鼓浪屿的乐趣好吗	{乐趣=POI特性实体, 鼓浪屿=POI名称}	[POI特性实体修饰
密歇根湖的日出好吗	{密歇根湖=POI名称, 日出=POI特性实体}	[POI特性实体修饰
金阁寺的内饰好吗	{内饰=POI特性实体, 金阁寺=POI名称}	[POI特性实体修饰
卢浮宫的形态好吗	{形态=POI特性实体, 卢浮宫=POI名称}	[POI特性实体修饰
莱茵河的香火好吗	{莱茵河=POI名称, 香火=POI特性实体}	[POI特性实体修饰
九寨沟的地面好吗	{九寨沟=POI名称, 地面=POI特性实体}	[POI特性实体修饰
维多利亚港的民风好吗	{民风=POI特性实体, 维多利亚港=POI名称}	[POI特性实体修饰
凯旋门的门面好吗	{门面=POI特性实体, 凯旋门=POI名称}	[POI特性实体修饰
托普卡帕宫的夜景好吗	{夜景=POI特性实体, 托普卡帕宫=POI名称}	[POI特性实体修饰
迪士尼的布局好吗	{布局=POI特性实体, 迪士尼=POI名称}	[POI特性实体修饰
托普卡帕宫的景色好吗	{托普卡帕宫=POI名称, 景色=POI特性实体}	[POI特性实体修饰
猴庙的风格好吗	{猴庙=POI名称, 风格=POI特性实体}	[POI特性实体修饰
凯旋门的音场好吗	{音场=POI特性实体, 凯旋门=POI名称}	[POI特性实体修饰
青莲院的设备好吗	{设备=POI特性实体, 青莲院=POI名称}	[POI特性实体修饰
阿尔法玛的图案好吗	{图案=POI特性实体, 阿尔法玛=POI名称}	[POI特性实体修饰
马穆提岛的名气好吗	{马穆提岛=POI名称, 名气=POI特性实体}	[POI特性实体修饰
路易港的装备好吗	{装备=POI特性实体, 路易港=POI名称}	[POI特性实体修饰
多瑙河的清洁度好吗	{清洁度=POI特性实体, 多瑙河=POI名称}	[POI特性实体修饰
迪士尼的景观好吗	{迪士尼=POI名称, 景观=POI特性实体}	[POI特性实体修饰
全聚德的出口好吗	{出口=POI特性实体, 全聚德=POI名称}	[POI特性实体修饰
荣军院的秩序好吗	{秩序=POI特性实体, 荣军院=POI名称}	[POI特性实体修饰
马穆提岛的规模好吗	{马穆提岛=POI名称, 规模=POI特性实体}	[POI特性实体修饰
卢浮宫的细节好吗	{细节=POI特性实体, 卢浮宫=POI名称}	[POI特性实体修饰
玛黑区的景观好吗	{玛黑区=POI名称, 景观=POI特性实体}	[POI特性实体修饰
玛黑区的景象好吗	{玛黑区=POI名称, 景象=POI特性实体}	[POI特性实体修饰
红树的环境好吗	{红树=POI名称, 环境=POI特性实体}	[POI特性实体修饰
托普卡帕宫的招牌好吗	{托普卡帕宫=POI名称, 招牌=POI特性实体}	[POI特性实体修饰
全聚德的场景好吗	{全聚德=POI名称, 场景=POI特性实体}	[POI特性实体修饰
红树的秩序好吗	{红树=POI名称, 秩序=POI特性实体}	[POI特性实体修饰
迪士尼的空间好吗	{空间=POI特性实体, 迪士尼=POI名称}	[POI特性实体修饰
荣军院的名头如何	{荣军院=POI名称, 名头=POI特性实体}	[POI特性实体修饰
维港的结构如何	{维港=POI名称, 结构=POI特性实体}	[POI特性实体修饰
唐人街的特点如何	{唐人街=POI名称, 特点=POI特性实体}	[POI特性实体修饰
唐人街的绿化如何	{唐人街=POI名称, 绿化=POI特性实体}	[POI特性实体修饰
白沙滩的可游性如何	{可游性=POI特性实体, 白沙滩=POI名称}	[POI特性实体修饰
多瑙河的治安如何	{治安=POI特性实体, 多瑙河=POI名称}	[POI特性实体修饰
新加坡河的名气如何	{新加坡河=POI名称, 名气=POI特性实体}	[POI特性实体修饰
维多利亚港的观赏性如何	{维多利亚港=POI名称, 观赏性=POI特性实体}	[POI特性实体修饰
迪斯尼的装备如何	{装备=POI特性实体, 迪斯尼=POI名称}	[POI特性实体修饰
孚日宫的意义如何	{孚日宫=POI名称, 意义=POI特性实体}	[POI特性实体修饰
猴庙的设备如何	{设备=POI特性实体, 猴庙=POI名称}	[POI特性实体修饰
白沙滩的声势如何	{声势=POI特性实体, 白沙滩=POI名称}	[POI特性实体修饰
凯旋门的色彩如何	{色彩=POI特性实体, 凯旋门=POI名称}	[POI特性实体修饰
日月潭的设备如何	{日月潭=POI名称, 设备=POI特性实体}	[POI特性实体修饰
莱茵河的海拔如何	{海拔=POI特性实体, 莱茵河=POI名称}	[POI特性实体修饰
马穆提岛的名气如何	{马穆提岛=POI名称, 名气=POI特性实体}	[POI特性实体修饰
芬兰堡的景观如何	{芬兰堡=POI名称, 景观=POI特性实体}	[POI特性实体修饰
托普卡帕宫的景色如何	{托普卡帕宫=POI名称, 景色=POI特性实体}	[POI特性实体修饰
唐人街的噪声如何	{唐人街=POI名称, 噪声=POI特性实体}	[POI特性实体修饰
密歇根湖的场景如何	{密歇根湖=POI名称, 场景=POI特性实体}	[POI特性实体修饰
新加坡河的夜晚如何	{夜晚=POI特性实体, 新加坡河=POI名称}	[POI特性实体修饰
日月潭的布置如何	{布置=POI特性实体, 日月潭=POI名称}	[POI特性实体修饰
白沙滩的门面如何	{白沙滩=POI名称, 门面=POI特性实体}	[POI特性实体修饰
景福宫的场景如何	{景福宫=POI名称, 场景=POI特性实体}	[POI特性实体修饰
密歇根湖的景致如何	{密歇根湖=POI名称, 景致=POI特性实体}	[POI特性实体修饰
阿尔法玛的生态如何	{阿尔法玛=POI名称, 生态=POI特性实体}	[POI特性实体修饰
光明寺的海拔如何	{海拔=POI特性实体, 光明寺=POI名称}	[POI特性实体修饰
多瑙河的细节如何	{细节=POI特性实体, 多瑙河=POI名称}	[POI特性实体修饰
景福宫的污染如何	{景福宫=POI名称, 污染=POI特性实体}	[POI特性实体修饰
莱茵河的夜景如何	{莱茵河=POI名称, 夜景=POI特性实体}	[POI特性实体修饰
唐人街的底蕴如何	{唐人街=POI名称, 底蕴=POI特性实体}	[POI特性实体修饰
新加坡河的安检如何	{新加坡河=POI名称, 安检=POI特性实体}	[POI特性实体修饰
马穆提岛的布局如何	{布局=POI特性实体, 马穆提岛=POI名称}	[POI特性实体修饰
鼓浪屿的图案如何	{图案=POI特性实体, 鼓浪屿=POI名称}	[POI特性实体修饰
荣军院的风情如何	{风情=POI特性实体, 荣军院=POI名称}	[POI特性实体修饰
维港的灯火如何	{灯火=POI特性实体, 维港=POI名称}	[POI特性实体修饰
荣军院的景观如何	{荣军院=POI名称, 景观=POI特性实体}	[POI特性实体修饰
新加坡河的夕阳如何	{夕阳=POI特性实体, 新加坡河=POI名称}	[POI特性实体修饰
鼓浪屿的入口如何	{入口=POI特性实体, 鼓浪屿=POI名称}	[POI特性实体修饰
红树的历史感如何	{红树=POI名称, 历史感=POI特性实体}	[POI特性实体修饰
密歇根湖的特点如何	{密歇根湖=POI名称, 特点=POI特性实体}	[POI特性实体修饰
金阁寺的地热如何	{地热=POI特性实体, 金阁寺=POI名称}	[POI特性实体修饰
九寨沟的装潢如何	{九寨沟=POI名称, 装潢=POI特性实体}	[POI特性实体修饰
荣军院的格局如何	{格局=POI特性实体, 荣军院=POI名称}	[POI特性实体修饰
阿尔法玛的细节如何	{细节=POI特性实体, 阿尔法玛=POI名称}	[POI特性实体修饰
卢浮宫的环境如何	{卢浮宫=POI名称, 环境=POI特性实体}	[POI特性实体修饰
卢浮宫的装修如何	{卢浮宫=POI名称, 装修=POI特性实体}	[POI特性实体修饰
迪士尼的流线如何	{流线=POI特性实体, 迪士尼=POI名称}	[POI特性实体修饰
多瑙河的观赏性如何	{多瑙河=POI名称, 观赏性=POI特性实体}	[POI特性实体修饰
路易港的清洁度如何	{清洁度=POI特性实体, 路易港=POI名称}	[POI特性实体修饰
孚日宫的夜生活如何	{孚日宫=POI名称, 夜生活=POI特性实体}	[POI特性实体修饰
多瑙河的色彩如何	{色彩=POI特性实体, 多瑙河=POI名称}	[POI特性实体修饰
阿尔法玛的绿化如何	{阿尔法玛=POI名称, 绿化=POI特性实体}	[POI特性实体修饰
景福宫的灯火如何	{灯火=POI特性实体, 景福宫=POI名称}	[POI特性实体修饰
迪斯尼的夜晚如何	{夜晚=POI特性实体, 迪斯尼=POI名称}	[POI特性实体修饰
日月潭的噪声如何	{日月潭=POI名称, 噪声=POI特性实体}	[POI特性实体修饰
迪士尼的绿化如何	{绿化=POI特性实体, 迪士尼=POI名称}	[POI特性实体修饰
荣军院的夜晚如何	{夜晚=POI特性实体, 荣军院=POI名称}	[POI特性实体修饰
凯旋门的日出如何	{日出=POI特性实体, 凯旋门=POI名称}	[POI特性实体修饰
多瑙河的构造如何	{构造=POI特性实体, 多瑙河=POI名称}	[POI特性实体修饰
维多利亚港的地势如何	{地势=POI特性实体, 维多利亚港=POI名称}	[POI特性实体修饰
红树的冷气如何	{红树=POI名称, 冷气=POI特性实体}	[POI特性实体修饰
荣军院的绿化如何	{绿化=POI特性实体, 荣军院=POI名称}	[POI特性实体修饰
托普卡帕宫的温度如何	{温度=POI特性实体, 托普卡帕宫=POI名称}	[POI特性实体修饰
马穆提岛的气息如何	{气息=POI特性实体, 马穆提岛=POI名称}	[POI特性实体修饰
全聚德的光线如何	{全聚德=POI名称, 光线=POI特性实体}	[POI特性实体修饰
猴庙的灯光如何	{灯光=POI特性实体, 猴庙=POI名称}	[POI特性实体修饰
唐人街的灯光如何	{唐人街=POI名称, 灯光=POI特性实体}	[POI特性实体修饰
大夏宫的风水如何	{风水=POI特性实体, 大夏宫=POI名称}	[POI特性实体修饰
多瑙河的出口如何	{出口=POI特性实体, 多瑙河=POI名称}	[POI特性实体修饰
红树的视野如何	{红树=POI名称, 视野=POI特性实体}	[POI特性实体修饰
玛黑区的温度如何	{温度=POI特性实体, 玛黑区=POI名称}	[POI特性实体修饰
密歇根湖的知名度如何	{知名度=POI特性实体, 密歇根湖=POI名称}	[POI特性实体修饰
托普卡帕宫的夜晚如何	{夜晚=POI特性实体, 托普卡帕宫=POI名称}	[POI特性实体修饰
荣军院的图案如何	{图案=POI特性实体, 荣军院=POI名称}	[POI特性实体修饰
莱茵河的面积如何	{莱茵河=POI名称, 面积=POI特性实体}	[POI特性实体修饰
景福宫的道路如何	{景福宫=POI名称, 道路=POI特性实体}	[POI特性实体修饰
猴庙的景致如何	{景致=POI特性实体, 猴庙=POI名称}	[POI特性实体修饰
金阁寺的安检如何	{安检=POI特性实体, 金阁寺=POI名称}	[POI特性实体修饰
迪斯尼的地形如何	{地形=POI特性实体, 迪斯尼=POI名称}	[POI特性实体修饰
凯旋门的氛围如何	{氛围=POI特性实体, 凯旋门=POI名称}	[POI特性实体修饰
密歇根湖的景象如何	{密歇根湖=POI名称, 景象=POI特性实体}	[POI特性实体修饰
莱茵河的设计如何	{莱茵河=POI名称, 设计=POI特性实体}	[POI特性实体修饰
维多利亚港的意义如何	{意义=POI特性实体, 维多利亚港=POI名称}	[POI特性实体修饰
芬兰堡的设置如何	{设置=POI特性实体, 芬兰堡=POI名称}	[POI特性实体修饰
路易港的装备如何	{装备=POI特性实体, 路易港=POI名称}	[POI特性实体修饰
红树的设计如何	{红树=POI名称, 设计=POI特性实体}	[POI特性实体修饰
维港的名声如何	{维港=POI名称, 名声=POI特性实体}	[POI特性实体修饰
日月潭的风格如何	{日月潭=POI名称, 风格=POI特性实体}	[POI特性实体修饰
路易港的知名度如何	{知名度=POI特性实体, 路易港=POI名称}	[POI特性实体修饰
日月潭的污染如何	{日月潭=POI名称, 污染=POI特性实体}	[POI特性实体修饰
马穆提岛的夕阳如何	{夕阳=POI特性实体, 马穆提岛=POI名称}	[POI特性实体修饰
青莲院的构造如何	{构造=POI特性实体, 青莲院=POI名称}	[POI特性实体修饰
大夏宫的噪声如何	{大夏宫=POI名称, 噪声=POI特性实体}	[POI特性实体修饰
凯旋门的外墙如何	{外墙=POI特性实体, 凯旋门=POI名称}	[POI特性实体修饰
托普卡帕宫的生态如何	{生态=POI特性实体, 托普卡帕宫=POI名称}	[POI特性实体修饰
光明寺的安检如何	{光明寺=POI名称, 安检=POI特性实体}	[POI特性实体修饰
孚日宫的规模如何	{孚日宫=POI名称, 规模=POI特性实体}	[POI特性实体修饰
马穆提岛的灯光如何	{灯光=POI特性实体, 马穆提岛=POI名称}	[POI特性实体修饰
卢浮宫的装饰如何	{卢浮宫=POI名称, 装饰=POI特性实体}	[POI特性实体修饰
马穆提岛的设计好不好	{设计=POI特性实体, 马穆提岛=POI名称}	[POI特性实体修饰
维港的流线好不好	{流线=POI特性实体, 维港=POI名称}	[POI特性实体修饰
马穆提岛的景色好不好	{马穆提岛=POI名称, 景色=POI特性实体}	[POI特性实体修饰
马穆提岛的面积好不好	{马穆提岛=POI名称, 面积=POI特性实体}	[POI特性实体修饰
全聚德的声势好不好	{全聚德=POI名称, 声势=POI特性实体}	[POI特性实体修饰
红树的风力好不好	{红树=POI名称, 风力=POI特性实体}	[POI特性实体修饰
红树的现代感好不好	{红树=POI名称, 现代感=POI特性实体}	[POI特性实体修饰
猴庙的装潢好不好	{猴庙=POI名称, 装潢=POI特性实体}	[POI特性实体修饰
新加坡河的名声好不好	{新加坡河=POI名称, 名声=POI特性实体}	[POI特性实体修饰
景福宫的装潢好不好	{景福宫=POI名称, 装潢=POI特性实体}	[POI特性实体修饰
鼓浪屿的店面好不好	{店面=POI特性实体, 鼓浪屿=POI名称}	[POI特性实体修饰
白沙滩的安检好不好	{白沙滩=POI名称, 安检=POI特性实体}	[POI特性实体修饰
玛黑区的互动性好不好	{互动性=POI特性实体, 玛黑区=POI名称}	[POI特性实体修饰
芬兰堡的视觉好不好	{视觉=POI特性实体, 芬兰堡=POI名称}	[POI特性实体修饰
芬兰堡的样式好不好	{样式=POI特性实体, 芬兰堡=POI名称}	[POI特性实体修饰
迪士尼的特点好不好	{迪士尼=POI名称, 特点=POI特性实体}	[POI特性实体修饰
托普卡帕宫的音场好不好	{音场=POI特性实体, 托普卡帕宫=POI名称}	[POI特性实体修饰
芬兰堡的海景好不好	{海景=POI特性实体, 芬兰堡=POI名称}	[POI特性实体修饰
唐人街的夜景好不好	{唐人街=POI名称, 夜景=POI特性实体}	[POI特性实体修饰
玛黑区的污染好不好	{玛黑区=POI名称, 污染=POI特性实体}	[POI特性实体修饰
鼓浪屿的情节好不好	{情节=POI特性实体, 鼓浪屿=POI名称}	[POI特性实体修饰
托普卡帕宫的卫生好不好	{托普卡帕宫=POI名称, 卫生=POI特性实体}	[POI特性实体修饰
唐人街的声势好不好	{唐人街=POI名称, 声势=POI特性实体}	[POI特性实体修饰
路易港的构造好不好	{构造=POI特性实体, 路易港=POI名称}	[POI特性实体修饰
维港的观赏性好不好	{维港=POI名称, 观赏性=POI特性实体}	[POI特性实体修饰
全聚德的气温好不好	{全聚德=POI名称, 气温=POI特性实体}	[POI特性实体修饰
红树的流线好不好	{红树=POI名称, 流线=POI特性实体}	[POI特性实体修饰
新加坡河的配置好不好	{配置=POI特性实体, 新加坡河=POI名称}	[POI特性实体修饰
路易港的观赏性好不好	{路易港=POI名称, 观赏性=POI特性实体}	[POI特性实体修饰
全聚德的海拔好不好	{海拔=POI特性实体, 全聚德=POI名称}	[POI特性实体修饰
托普卡帕宫的灯火好不好	{灯火=POI特性实体, 托普卡帕宫=POI名称}	[POI特性实体修饰
维港的视角好不好	{维港=POI名称, 视角=POI特性实体}	[POI特性实体修饰
红树的细节好不好	{红树=POI名称, 细节=POI特性实体}	[POI特性实体修饰
新加坡河的安检好不好	{新加坡河=POI名称, 安检=POI特性实体}	[POI特性实体修饰
玛黑区的特点好不好	{玛黑区=POI名称, 特点=POI特性实体}	[POI特性实体修饰
青莲院的情节好不好	{情节=POI特性实体, 青莲院=POI名称}	[POI特性实体修饰
红树的门面好不好	{红树=POI名称, 门面=POI特性实体}	[POI特性实体修饰
阿尔法玛的海拔好不好	{海拔=POI特性实体, 阿尔法玛=POI名称}	[POI特性实体修饰
猴庙的夜晚好不好	{夜晚=POI特性实体, 猴庙=POI名称}	[POI特性实体修饰
光明寺的生态好不好	{光明寺=POI名称, 生态=POI特性实体}	[POI特性实体修饰
荣军院的道路好不好	{荣军院=POI名称, 道路=POI特性实体}	[POI特性实体修饰
日月潭的趣味好不好	{日月潭=POI名称, 趣味=POI特性实体}	[POI特性实体修饰
日月潭的可游性好不好	{日月潭=POI名称, 可游性=POI特性实体}	[POI特性实体修饰
玛黑区的风格好不好	{玛黑区=POI名称, 风格=POI特性实体}	[POI特性实体修饰
猴庙的氛围好不好	{氛围=POI特性实体, 猴庙=POI名称}	[POI特性实体修饰
密歇根湖的氛围好不好	{氛围=POI特性实体, 密歇根湖=POI名称}	[POI特性实体修饰
白沙滩的地势好不好	{地势=POI特性实体, 白沙滩=POI名称}	[POI特性实体修饰
多瑙河的景观好不好	{多瑙河=POI名称, 景观=POI特性实体}	[POI特性实体修饰
玛黑区的布局好不好	{玛黑区=POI名称, 布局=POI特性实体}	[POI特性实体修饰
日月潭的设计好不好	{日月潭=POI名称, 设计=POI特性实体}	[POI特性实体修饰
红树的民风好不好	{红树=POI名称, 民风=POI特性实体}	[POI特性实体修饰
白沙滩的色彩好不好	{白沙滩=POI名称, 色彩=POI特性实体}	[POI特性实体修饰
玛黑区的设施好不好	{玛黑区=POI名称, 设施=POI特性实体}	[POI特性实体修饰
玛黑区的面积好不好	{玛黑区=POI名称, 面积=POI特性实体}	[POI特性实体修饰
孚日宫的人气好不好	{孚日宫=POI名称, 人气=POI特性实体}	[POI特性实体修饰
玛黑区的细节好不好	{玛黑区=POI名称, 细节=POI特性实体}	[POI特性实体修饰
青莲院的知名度好不好	{知名度=POI特性实体, 青莲院=POI名称}	[POI特性实体修饰
光明寺的视野好不好	{光明寺=POI名称, 视野=POI特性实体}	[POI特性实体修饰
路易港的海景好不好	{海景=POI特性实体, 路易港=POI名称}	[POI特性实体修饰
日月潭的卫生好不好	{日月潭=POI名称, 卫生=POI特性实体}	[POI特性实体修饰
鼓浪屿的气氛好不好	{鼓浪屿=POI名称, 气氛=POI特性实体}	[POI特性实体修饰
玛黑区的噪声好不好	{玛黑区=POI名称, 噪声=POI特性实体}	[POI特性实体修饰
青莲院的道路好不好	{青莲院=POI名称, 道路=POI特性实体}	[POI特性实体修饰
荣军院的音场好不好	{音场=POI特性实体, 荣军院=POI名称}	[POI特性实体修饰
维多利亚港的知名度好不好	{知名度=POI特性实体, 维多利亚港=POI名称}	[POI特性实体修饰
托普卡帕宫的场景好不好	{托普卡帕宫=POI名称, 场景=POI特性实体}	[POI特性实体修饰
莱茵河的视觉好不好	{莱茵河=POI名称, 视觉=POI特性实体}	[POI特性实体修饰
芬兰堡的风情好不好	{风情=POI特性实体, 芬兰堡=POI名称}	[POI特性实体修饰
猴庙的夜生活好不好	{夜生活=POI特性实体, 猴庙=POI名称}	[POI特性实体修饰
猴庙的卫生好不好	{猴庙=POI名称, 卫生=POI特性实体}	[POI特性实体修饰
金阁寺的光线好不好	{光线=POI特性实体, 金阁寺=POI名称}	[POI特性实体修饰
白沙滩的灯火好不好	{灯火=POI特性实体, 白沙滩=POI名称}	[POI特性实体修饰
光明寺的装饰好不好	{光明寺=POI名称, 装饰=POI特性实体}	[POI特性实体修饰
托普卡帕宫的光线好不好	{光线=POI特性实体, 托普卡帕宫=POI名称}	[POI特性实体修饰
九寨沟的形象好不好	{形象=POI特性实体, 九寨沟=POI名称}	[POI特性实体修饰
密歇根湖的灯火好不好	{灯火=POI特性实体, 密歇根湖=POI名称}	[POI特性实体修饰
金阁寺的清洁度好不好	{清洁度=POI特性实体, 金阁寺=POI名称}	[POI特性实体修饰
白沙滩的互动性好不好	{互动性=POI特性实体, 白沙滩=POI名称}	[POI特性实体修饰
全聚德的视野好不好	{全聚德=POI名称, 视野=POI特性实体}	[POI特性实体修饰
凯旋门的气息好不好	{气息=POI特性实体, 凯旋门=POI名称}	[POI特性实体修饰
凯旋门的情节好不好	{情节=POI特性实体, 凯旋门=POI名称}	[POI特性实体修饰
多瑙河的安检好不好	{多瑙河=POI名称, 安检=POI特性实体}	[POI特性实体修饰
芬兰堡的色彩好不好	{色彩=POI特性实体, 芬兰堡=POI名称}	[POI特性实体修饰
托普卡帕宫的氛围好不好	{氛围=POI特性实体, 托普卡帕宫=POI名称}	[POI特性实体修饰
马穆提岛的互动性好不好	{互动性=POI特性实体, 马穆提岛=POI名称}	[POI特性实体修饰
猴庙的地貌好不好	{地貌=POI特性实体, 猴庙=POI名称}	[POI特性实体修饰
维多利亚港的外表好不好	{维多利亚港=POI名称, 外表=POI特性实体}	[POI特性实体修饰
卢浮宫的可游性好不好	{可游性=POI特性实体, 卢浮宫=POI名称}	[POI特性实体修饰
荣军院的内饰好不好	{内饰=POI特性实体, 荣军院=POI名称}	[POI特性实体修饰
孚日宫的灯火好不好	{灯火=POI特性实体, 孚日宫=POI名称}	[POI特性实体修饰
阿尔法玛的空间好不好	{空间=POI特性实体, 阿尔法玛=POI名称}	[POI特性实体修饰
迪斯尼的地热好不好	{地热=POI特性实体, 迪斯尼=POI名称}	[POI特性实体修饰
孚日宫的夜景好不好	{孚日宫=POI名称, 夜景=POI特性实体}	[POI特性实体修饰
青莲院的日落好不好	{日落=POI特性实体, 青莲院=POI名称}	[POI特性实体修饰
九寨沟的风水好不好	{风水=POI特性实体, 九寨沟=POI名称}	[POI特性实体修饰
红树的设计好不好	{红树=POI名称, 设计=POI特性实体}	[POI特性实体修饰
维多利亚港的绿化好不好	{维多利亚港=POI名称, 绿化=POI特性实体}	[POI特性实体修饰
青莲院的流线好不好	{流线=POI特性实体, 青莲院=POI名称}	[POI特性实体修饰
迪斯尼的出口好不好	{出口=POI特性实体, 迪斯尼=POI名称}	[POI特性实体修饰
光明寺的乐趣好不好	{光明寺=POI名称, 乐趣=POI特性实体}	[POI特性实体修饰
介绍一下景福宫的服装情况	{景福宫=POI名称, 服装=POI内部包含实体}	[POI内部实体修饰
介绍一下维多利亚港的亭情况	{维多利亚港=POI名称, 亭=POI内部包含实体}	[POI内部实体修饰
介绍一下荣军院的餐厅情况	{餐厅=POI内部包含实体, 荣军院=POI名称}	[POI内部实体修饰
介绍一下日月潭的胡同情况	{日月潭=POI名称, 胡同=POI内部包含实体}	[POI内部实体修饰
介绍一下景福宫的壁画情况	{壁画=POI内部包含实体, 景福宫=POI名称}	[POI内部实体修饰
介绍一下马穆提岛的商店情况	{商店=POI内部包含实体, 马穆提岛=POI名称}	[POI内部实体修饰
介绍一下九寨沟的宫墙情况	{九寨沟=POI名称, 宫墙=POI内部包含实体}	[POI内部实体修饰
介绍一下唐人街的屋顶情况	{屋顶=POI内部包含实体, 唐人街=POI名称}	[POI内部实体修饰
介绍一下多瑙河的沙石情况	{沙石=POI内部包含实体, 多瑙河=POI名称}	[POI内部实体修饰
介绍一下迪士尼的作品情况	{迪士尼=POI名称, 作品=POI内部包含实体}	[POI内部实体修饰
介绍一下托普卡帕宫的灯塔情况	{灯塔=POI内部包含实体, 托普卡帕宫=POI名称}	[POI内部实体修饰
介绍一下全聚德的河灯情况	{河灯=POI内部包含实体, 全聚德=POI名称}	[POI内部实体修饰
介绍一下莱茵河的玉佛情况	{莱茵河=POI名称, 玉佛=POI内部包含实体}	[POI内部实体修饰
介绍一下景福宫的楼梯情况	{景福宫=POI名称, 楼梯=POI内部包含实体}	[POI内部实体修饰
介绍一下全聚德的房间情况	{全聚德=POI名称, 房间=POI内部包含实体}	[POI内部实体修饰
介绍一下鼓浪屿的泳池情况	{泳池=POI内部包含实体, 鼓浪屿=POI名称}	[POI内部实体修饰
介绍一下玛黑区的灯泡情况	{玛黑区=POI名称, 灯泡=POI内部包含实体}	[POI内部实体修饰
介绍一下九寨沟的大门情况	{九寨沟=POI名称, 大门=POI内部包含实体}	[POI内部实体修饰
介绍一下景福宫的球场情况	{景福宫=POI名称, 球场=POI内部包含实体}	[POI内部实体修饰
介绍一下维港的展厅情况	{维港=POI名称, 展厅=POI内部包含实体}	[POI内部实体修饰
介绍一下白沙滩的艺术品情况	{白沙滩=POI名称, 艺术品=POI内部包含实体}	[POI内部实体修饰
介绍一下红树的泳池情况	{红树=POI名称, 泳池=POI内部包含实体}	[POI内部实体修饰
介绍一下多瑙河的永观堂情况	{多瑙河=POI名称, 永观堂=POI内部包含实体}	[POI内部实体修饰
介绍一下九寨沟的窗户情况	{九寨沟=POI名称, 窗户=POI内部包含实体}	[POI内部实体修饰
介绍一下猴庙的沙石情况	{沙石=POI内部包含实体, 猴庙=POI名称}	[POI内部实体修饰
介绍一下密歇根湖的电梯情况	{电梯=POI内部包含实体, 密歇根湖=POI名称}	[POI内部实体修饰
介绍一下孚日宫的酒吧情况	{孚日宫=POI名称, 酒吧=POI内部包含实体}	[POI内部实体修饰
介绍一下维多利亚港的大佛情况	{维多利亚港=POI名称, 大佛=POI内部包含实体}	[POI内部实体修饰
介绍一下唐人街的浮雕情况	{唐人街=POI名称, 浮雕=POI内部包含实体}	[POI内部实体修饰
介绍一下荣军院的保险柜情况	{荣军院=POI名称, 保险柜=POI内部包含实体}	[POI内部实体修饰
介绍一下芬兰堡的神社情况	{芬兰堡=POI名称, 神社=POI内部包含实体}	[POI内部实体修饰
介绍一下托普卡帕宫的云海情况	{托普卡帕宫=POI名称, 云海=POI内部包含实体}	[POI内部实体修饰
介绍一下孚日宫的店铺情况	{孚日宫=POI名称, 店铺=POI内部包含实体}	[POI内部实体修饰
介绍一下光明寺的咖啡馆情况	{咖啡馆=POI内部包含实体, 光明寺=POI名称}	[POI内部实体修饰
介绍一下荣军院的探知馆情况	{探知馆=POI内部包含实体, 荣军院=POI名称}	[POI内部实体修饰
介绍一下日月潭的画情况	{日月潭=POI名称, 画=POI内部包含实体}	[POI内部实体修饰
介绍一下鼓浪屿的永观堂情况	{鼓浪屿=POI名称, 永观堂=POI内部包含实体}	[POI内部实体修饰
介绍一下金阁寺的馆舍情况	{馆舍=POI内部包含实体, 金阁寺=POI名称}	[POI内部实体修饰
介绍一下大夏宫的温泉水情况	{大夏宫=POI名称, 温泉水=POI内部包含实体}	[POI内部实体修饰
介绍一下多瑙河的喷泉情况	{多瑙河=POI名称, 喷泉=POI内部包含实体}	[POI内部实体修饰
介绍一下日月潭的影城情况	{日月潭=POI名称, 影城=POI内部包含实体}	[POI内部实体修饰
介绍一下全聚德的店铺情况	{全聚德=POI名称, 店铺=POI内部包含实体}	[POI内部实体修饰
介绍一下阿尔法玛的教堂情况	{教堂=POI内部包含实体, 阿尔法玛=POI名称}	[POI内部实体修饰
介绍一下马穆提岛的云彩情况	{云彩=POI内部包含实体, 马穆提岛=POI名称}	[POI内部实体修饰
介绍一下九寨沟的井情况	{九寨沟=POI名称, 井=POI内部包含实体}	[POI内部实体修饰
介绍一下密歇根湖的岩石情况	{岩石=POI内部包含实体, 密歇根湖=POI名称}	[POI内部实体修饰
介绍一下青莲院的霓虹灯情况	{青莲院=POI名称, 霓虹灯=POI内部包含实体}	[POI内部实体修饰
介绍一下托普卡帕宫的古城堡情况	{古城堡=POI内部包含实体, 托普卡帕宫=POI名称}	[POI内部实体修饰
介绍一下迪斯尼的温泉水情况	{迪斯尼=POI名称, 温泉水=POI内部包含实体}	[POI内部实体修饰
介绍一下马穆提岛的邮筒情况	{邮筒=POI内部包含实体, 马穆提岛=POI名称}	[POI内部实体修饰
介绍一下多瑙河的冷饮店情况	{冷饮店=POI内部包含实体, 多瑙河=POI名称}	[POI内部实体修饰
介绍一下红树的海滩情况	{红树=POI名称, 海滩=POI内部包含实体}	[POI内部实体修饰
介绍一下日月潭的餐厅情况	{日月潭=POI名称, 餐厅=POI内部包含实体}	[POI内部实体修饰
介绍一下多瑙河的大佛情况	{多瑙河=POI名称, 大佛=POI内部包含实体}	[POI内部实体修饰
介绍一下莱茵河的舞厅情况	{莱茵河=POI名称, 舞厅=POI内部包含实体}	[POI内部实体修饰
介绍一下鼓浪屿的泰迪熊情况	{鼓浪屿=POI名称, 泰迪熊=POI内部包含实体}	[POI内部实体修饰
介绍一下路易港的钟楼情况	{路易港=POI名称, 钟楼=POI内部包含实体}	[POI内部实体修饰
介绍一下白沙滩的卧佛情况	{白沙滩=POI名称, 卧佛=POI内部包含实体}	[POI内部实体修饰
介绍一下鼓浪屿的银幕情况	{鼓浪屿=POI名称, 银幕=POI内部包含实体}	[POI内部实体修饰
介绍一下莱茵河的展品情况	{莱茵河=POI名称, 展品=POI内部包含实体}	[POI内部实体修饰
介绍一下托普卡帕宫的迷宫情况	{迷宫=POI内部包含实体, 托普卡帕宫=POI名称}	[POI内部实体修饰
介绍一下大夏宫的停车位情况	{大夏宫=POI名称, 停车位=POI内部包含实体}	[POI内部实体修饰
介绍一下卢浮宫的药房情况	{药房=POI内部包含实体, 卢浮宫=POI名称}	[POI内部实体修饰
介绍一下荣军院的饮食区情况	{饮食区=POI内部包含实体, 荣军院=POI名称}	[POI内部实体修饰
介绍一下日月潭的床铺情况	{日月潭=POI名称, 床铺=POI内部包含实体}	[POI内部实体修饰
介绍一下孚日宫的游乐场情况	{孚日宫=POI名称, 游乐场=POI内部包含实体}	[POI内部实体修饰
介绍一下九寨沟的红叶情况	{九寨沟=POI名称, 红叶=POI内部包含实体}	[POI内部实体修饰
介绍一下九寨沟的院子情况	{九寨沟=POI名称, 院子=POI内部包含实体}	[POI内部实体修饰
介绍一下芬兰堡的亭情况	{芬兰堡=POI名称, 亭=POI内部包含实体}	[POI内部实体修饰
介绍一下金阁寺的花园情况	{花园=POI内部包含实体, 金阁寺=POI名称}	[POI内部实体修饰
介绍一下九寨沟的药房情况	{药房=POI内部包含实体, 九寨沟=POI名称}	[POI内部实体修饰
介绍一下维多利亚港的浮雕情况	{维多利亚港=POI名称, 浮雕=POI内部包含实体}	[POI内部实体修饰
介绍一下芬兰堡的灯情况	{芬兰堡=POI名称, 灯=POI内部包含实体}	[POI内部实体修饰
介绍一下卢浮宫的大殿情况	{大殿=POI内部包含实体, 卢浮宫=POI名称}	[POI内部实体修饰
介绍一下红树的华表情况	{红树=POI名称, 华表=POI内部包含实体}	[POI内部实体修饰
介绍一下大夏宫的蜡像情况	{大夏宫=POI名称, 蜡像=POI内部包含实体}	[POI内部实体修饰
介绍一下红树的壁画情况	{红树=POI名称, 壁画=POI内部包含实体}	[POI内部实体修饰
介绍一下青莲院的沙石情况	{沙石=POI内部包含实体, 青莲院=POI名称}	[POI内部实体修饰
介绍一下唐人街的沙石情况	{唐人街=POI名称, 沙石=POI内部包含实体}	[POI内部实体修饰
介绍一下光明寺的柱子情况	{柱子=POI内部包含实体, 光明寺=POI名称}	[POI内部实体修饰
介绍一下马穆提岛的教堂情况	{教堂=POI内部包含实体, 马穆提岛=POI名称}	[POI内部实体修饰
介绍一下荣军院的铁塔情况	{铁塔=POI内部包含实体, 荣军院=POI名称}	[POI内部实体修饰
介绍一下荣军院的展品情况	{展品=POI内部包含实体, 荣军院=POI名称}	[POI内部实体修饰
介绍一下光明寺的雕像情况	{光明寺=POI名称, 雕像=POI内部包含实体}	[POI内部实体修饰
介绍一下全聚德的灯情况	{全聚德=POI名称, 灯=POI内部包含实体}	[POI内部实体修饰
介绍一下光明寺的商店情况	{光明寺=POI名称, 商店=POI内部包含实体}	[POI内部实体修饰
介绍一下马穆提岛的双人房情况	{双人房=POI内部包含实体, 马穆提岛=POI名称}	[POI内部实体修饰
介绍一下多瑙河的城墙情况	{城墙=POI内部包含实体, 多瑙河=POI名称}	[POI内部实体修饰
介绍一下阿尔法玛的蜡像情况	{阿尔法玛=POI名称, 蜡像=POI内部包含实体}	[POI内部实体修饰
介绍一下新加坡河的商场情况	{新加坡河=POI名称, 商场=POI内部包含实体}	[POI内部实体修饰
介绍一下九寨沟的画情况	{九寨沟=POI名称, 画=POI内部包含实体}	[POI内部实体修饰
介绍一下大夏宫的商户情况	{大夏宫=POI名称, 商户=POI内部包含实体}	[POI内部实体修饰
介绍一下托普卡帕宫的大佛情况	{托普卡帕宫=POI名称, 大佛=POI内部包含实体}	[POI内部实体修饰
介绍一下卢浮宫的博物馆情况	{博物馆=POI内部包含实体, 卢浮宫=POI名称}	[POI内部实体修饰
介绍一下维港的艺术品情况	{维港=POI名称, 艺术品=POI内部包含实体}	[POI内部实体修饰
介绍一下新加坡河的蜡像馆情况	{新加坡河=POI名称, 蜡像馆=POI内部包含实体}	[POI内部实体修饰
介绍一下路易港的霓虹灯情况	{路易港=POI名称, 霓虹灯=POI内部包含实体}	[POI内部实体修饰
介绍一下卢浮宫的剧场情况	{卢浮宫=POI名称, 剧场=POI内部包含实体}	[POI内部实体修饰
介绍一下大夏宫的柱子情况	{柱子=POI内部包含实体, 大夏宫=POI名称}	[POI内部实体修饰
介绍一下维港的红叶情况	{维港=POI名称, 红叶=POI内部包含实体}	[POI内部实体修饰
大夏宫的迷宫好吗	{迷宫=POI内部包含实体, 大夏宫=POI名称}	[POI内部实体修饰
孚日宫的实验室好吗	{孚日宫=POI名称, 实验室=POI内部包含实体}	[POI内部实体修饰
莱茵河的橱柜好吗	{莱茵河=POI名称, 橱柜=POI内部包含实体}	[POI内部实体修饰
玛黑区的花园好吗	{玛黑区=POI名称, 花园=POI内部包含实体}	[POI内部实体修饰
日月潭的科技馆好吗	{日月潭=POI名称, 科技馆=POI内部包含实体}	[POI内部实体修饰
芬兰堡的楼梯好吗	{芬兰堡=POI名称, 楼梯=POI内部包含实体}	[POI内部实体修饰
新加坡河的佛像好吗	{新加坡河=POI名称, 佛像=POI内部包含实体}	[POI内部实体修饰
维港的佛像好吗	{维港=POI名称, 佛像=POI内部包含实体}	[POI内部实体修饰
维港的风铃好吗	{维港=POI名称, 风铃=POI内部包含实体}	[POI内部实体修饰
新加坡河的喷泉好吗	{新加坡河=POI名称, 喷泉=POI内部包含实体}	[POI内部实体修饰
路易港的泰迪好吗	{泰迪=POI内部包含实体, 路易港=POI名称}	[POI内部实体修饰
玛黑区的塔好吗	{玛黑区=POI名称, 塔=POI内部包含实体}	[POI内部实体修饰
新加坡河的卧佛好吗	{新加坡河=POI名称, 卧佛=POI内部包含实体}	[POI内部实体修饰
阿尔法玛的图书馆好吗	{阿尔法玛=POI名称, 图书馆=POI内部包含实体}	[POI内部实体修饰
卢浮宫的筏子好吗	{卢浮宫=POI名称, 筏子=POI内部包含实体}	[POI内部实体修饰
荣军院的电梯好吗	{电梯=POI内部包含实体, 荣军院=POI名称}	[POI内部实体修饰
马穆提岛的赌场好吗	{马穆提岛=POI名称, 赌场=POI内部包含实体}	[POI内部实体修饰
鼓浪屿的皇宫好吗	{鼓浪屿=POI名称, 皇宫=POI内部包含实体}	[POI内部实体修饰
九寨沟的剧场好吗	{九寨沟=POI名称, 剧场=POI内部包含实体}	[POI内部实体修饰
白沙滩的美术馆好吗	{白沙滩=POI名称, 美术馆=POI内部包含实体}	[POI内部实体修饰
维港的剧院好吗	{剧院=POI内部包含实体, 维港=POI名称}	[POI内部实体修饰
玛黑区的药房好吗	{药房=POI内部包含实体, 玛黑区=POI名称}	[POI内部实体修饰
红树的鲜花好吗	{红树=POI名称, 鲜花=POI内部包含实体}	[POI内部实体修饰
光明寺的樱花好吗	{光明寺=POI名称, 樱花=POI内部包含实体}	[POI内部实体修饰
白沙滩的汤池好吗	{汤池=POI内部包含实体, 白沙滩=POI名称}	[POI内部实体修饰
维港的玉佛好吗	{维港=POI名称, 玉佛=POI内部包含实体}	[POI内部实体修饰
迪士尼的大殿好吗	{大殿=POI内部包含实体, 迪士尼=POI名称}	[POI内部实体修饰
九寨沟的雕像好吗	{九寨沟=POI名称, 雕像=POI内部包含实体}	[POI内部实体修饰
荣军院的地板好吗	{地板=POI内部包含实体, 荣军院=POI名称}	[POI内部实体修饰
密歇根湖的珊瑚好吗	{密歇根湖=POI名称, 珊瑚=POI内部包含实体}	[POI内部实体修饰
唐人街的剧院好吗	{剧院=POI内部包含实体, 唐人街=POI名称}	[POI内部实体修饰
迪士尼的海洋馆好吗	{海洋馆=POI内部包含实体, 迪士尼=POI名称}	[POI内部实体修饰
光明寺的酒吧好吗	{酒吧=POI内部包含实体, 光明寺=POI名称}	[POI内部实体修饰
马穆提岛的城堡好吗	{城堡=POI内部包含实体, 马穆提岛=POI名称}	[POI内部实体修饰
马穆提岛的庙宇好吗	{庙宇=POI内部包含实体, 马穆提岛=POI名称}	[POI内部实体修饰
全聚德的迷宫好吗	{全聚德=POI名称, 迷宫=POI内部包含实体}	[POI内部实体修饰
莱茵河的实验室好吗	{莱茵河=POI名称, 实验室=POI内部包含实体}	[POI内部实体修饰
白沙滩的高台好吗	{白沙滩=POI名称, 高台=POI内部包含实体}	[POI内部实体修饰
新加坡河的巷子好吗	{巷子=POI内部包含实体, 新加坡河=POI名称}	[POI内部实体修饰
鼓浪屿的宫墙好吗	{宫墙=POI内部包含实体, 鼓浪屿=POI名称}	[POI内部实体修饰
景福宫的舞厅好吗	{景福宫=POI名称, 舞厅=POI内部包含实体}	[POI内部实体修饰
全聚德的扩音器好吗	{全聚德=POI名称, 扩音器=POI内部包含实体}	[POI内部实体修饰
路易港的寺庙好吗	{寺庙=POI内部包含实体, 路易港=POI名称}	[POI内部实体修饰
玛黑区的咖啡厅好吗	{玛黑区=POI名称, 咖啡厅=POI内部包含实体}	[POI内部实体修饰
密歇根湖的冷饮店好吗	{冷饮店=POI内部包含实体, 密歇根湖=POI名称}	[POI内部实体修饰
多瑙河的风铃好吗	{风铃=POI内部包含实体, 多瑙河=POI名称}	[POI内部实体修饰
玛黑区的摊位好吗	{玛黑区=POI名称, 摊位=POI内部包含实体}	[POI内部实体修饰
鼓浪屿的馆舍好吗	{馆舍=POI内部包含实体, 鼓浪屿=POI名称}	[POI内部实体修饰
大夏宫的食堂好吗	{食堂=POI内部包含实体, 大夏宫=POI名称}	[POI内部实体修饰
卢浮宫的神社好吗	{卢浮宫=POI名称, 神社=POI内部包含实体}	[POI内部实体修饰
阿尔法玛的卫生间好吗	{卫生间=POI内部包含实体, 阿尔法玛=POI名称}	[POI内部实体修饰
金阁寺的灯泡好吗	{灯泡=POI内部包含实体, 金阁寺=POI名称}	[POI内部实体修饰
青莲院的探知馆好吗	{探知馆=POI内部包含实体, 青莲院=POI名称}	[POI内部实体修饰
金阁寺的橱柜好吗	{橱柜=POI内部包含实体, 金阁寺=POI名称}	[POI内部实体修饰
全聚德的摊位好吗	{全聚德=POI名称, 摊位=POI内部包含实体}	[POI内部实体修饰
凯旋门的卧佛好吗	{凯旋门=POI名称, 卧佛=POI内部包含实体}	[POI内部实体修饰
景福宫的灯塔好吗	{景福宫=POI名称, 灯塔=POI内部包含实体}	[POI内部实体修饰
凯旋门的温泉水好吗	{凯旋门=POI名称, 温泉水=POI内部包含实体}	[POI内部实体修饰
孚日宫的花园好吗	{孚日宫=POI名称, 花园=POI内部包含实体}	[POI内部实体修饰
大夏宫的舞厅好吗	{舞厅=POI内部包含实体, 大夏宫=POI名称}	[POI内部实体修饰
芬兰堡的亭好吗	{芬兰堡=POI名称, 亭=POI内部包含实体}	[POI内部实体修饰
光明寺的红杉树好吗	{红杉树=POI内部包含实体, 光明寺=POI名称}	[POI内部实体修饰
密歇根湖的岩石好吗	{岩石=POI内部包含实体, 密歇根湖=POI名称}	[POI内部实体修饰
维港的商店好吗	{维港=POI名称, 商店=POI内部包含实体}	[POI内部实体修饰
玛黑区的后院好吗	{玛黑区=POI名称, 后院=POI内部包含实体}	[POI内部实体修饰
白沙滩的红杉树好吗	{红杉树=POI内部包含实体, 白沙滩=POI名称}	[POI内部实体修饰
凯旋门的红叶好吗	{红叶=POI内部包含实体, 凯旋门=POI名称}	[POI内部实体修饰
马穆提岛的摊位好吗	{马穆提岛=POI名称, 摊位=POI内部包含实体}	[POI内部实体修饰
白沙滩的鸟巢好吗	{鸟巢=POI内部包含实体, 白沙滩=POI名称}	[POI内部实体修饰
青莲院的海湾好吗	{青莲院=POI名称, 海湾=POI内部包含实体}	[POI内部实体修饰
光明寺的窗户好吗	{光明寺=POI名称, 窗户=POI内部包含实体}	[POI内部实体修饰
金阁寺的桥好吗	{桥=POI内部包含实体, 金阁寺=POI名称}	[POI内部实体修饰
新加坡河的砂岩好吗	{新加坡河=POI名称, 砂岩=POI内部包含实体}	[POI内部实体修饰
卢浮宫的永观堂好吗	{卢浮宫=POI名称, 永观堂=POI内部包含实体}	[POI内部实体修饰
日月潭的剧院好吗	{日月潭=POI名称, 剧院=POI内部包含实体}	[POI内部实体修饰
凯旋门的园林好吗	{园林=POI内部包含实体, 凯旋门=POI名称}	[POI内部实体修饰
芬兰堡的舞厅好吗	{舞厅=POI内部包含实体, 芬兰堡=POI名称}	[POI内部实体修饰
猴庙的大厅好吗	{大厅=POI内部包含实体, 猴庙=POI名称}	[POI内部实体修饰
多瑙河的鲜花好吗	{鲜花=POI内部包含实体, 多瑙河=POI名称}	[POI内部实体修饰
马穆提岛的科技馆好吗	{科技馆=POI内部包含实体, 马穆提岛=POI名称}	[POI内部实体修饰
大夏宫的车位好吗	{车位=POI内部包含实体, 大夏宫=POI名称}	[POI内部实体修饰
玛黑区的楼梯好吗	{玛黑区=POI名称, 楼梯=POI内部包含实体}	[POI内部实体修饰
卢浮宫的饮食区好吗	{卢浮宫=POI名称, 饮食区=POI内部包含实体}	[POI内部实体修饰
多瑙河的瀑布好吗	{多瑙河=POI名称, 瀑布=POI内部包含实体}	[POI内部实体修饰
青莲院的保险柜好吗	{青莲院=POI名称, 保险柜=POI内部包含实体}	[POI内部实体修饰
玛黑区的宫墙好吗	{玛黑区=POI名称, 宫墙=POI内部包含实体}	[POI内部实体修饰
鼓浪屿的饮食区好吗	{鼓浪屿=POI名称, 饮食区=POI内部包含实体}	[POI内部实体修饰
荣军院的博物馆好吗	{博物馆=POI内部包含实体, 荣军院=POI名称}	[POI内部实体修饰
维港的岩石好吗	{岩石=POI内部包含实体, 维港=POI名称}	[POI内部实体修饰
全聚德的馆藏好吗	{全聚德=POI名称, 馆藏=POI内部包含实体}	[POI内部实体修饰
景福宫的橱柜好吗	{景福宫=POI名称, 橱柜=POI内部包含实体}	[POI内部实体修饰
维港的照片好吗	{维港=POI名称, 照片=POI内部包含实体}	[POI内部实体修饰
青莲院的馆舍好吗	{馆舍=POI内部包含实体, 青莲院=POI名称}	[POI内部实体修饰
维港的卫生间好吗	{维港=POI名称, 卫生间=POI内部包含实体}	[POI内部实体修饰
马穆提岛的蜡像好吗	{马穆提岛=POI名称, 蜡像=POI内部包含实体}	[POI内部实体修饰
阿尔法玛的大殿好吗	{大殿=POI内部包含实体, 阿尔法玛=POI名称}	[POI内部实体修饰
迪斯尼的树木好吗	{树木=POI内部包含实体, 迪斯尼=POI名称}	[POI内部实体修饰
迪士尼的雕像好吗	{雕像=POI内部包含实体, 迪士尼=POI名称}	[POI内部实体修饰
迪士尼的画好吗	{画=POI内部包含实体, 迪士尼=POI名称}	[POI内部实体修饰
日月潭的佛像好吗	{日月潭=POI名称, 佛像=POI内部包含实体}	[POI内部实体修饰
景福宫的咖啡馆如何	{咖啡馆=POI内部包含实体, 景福宫=POI名称}	[POI内部实体修饰
路易港的观景台如何	{观景台=POI内部包含实体, 路易港=POI名称}	[POI内部实体修饰
卢浮宫的筏子如何	{卢浮宫=POI名称, 筏子=POI内部包含实体}	[POI内部实体修饰
迪斯尼的咖啡厅如何	{咖啡厅=POI内部包含实体, 迪斯尼=POI名称}	[POI内部实体修饰
猴庙的观景台如何	{观景台=POI内部包含实体, 猴庙=POI名称}	[POI内部实体修饰
新加坡河的舞厅如何	{舞厅=POI内部包含实体, 新加坡河=POI名称}	[POI内部实体修饰
维港的停车位如何	{维港=POI名称, 停车位=POI内部包含实体}	[POI内部实体修饰
景福宫的海滩如何	{景福宫=POI名称, 海滩=POI内部包含实体}	[POI内部实体修饰
九寨沟的服装如何	{九寨沟=POI名称, 服装=POI内部包含实体}	[POI内部实体修饰
路易港的屋顶如何	{屋顶=POI内部包含实体, 路易港=POI名称}	[POI内部实体修饰
景福宫的展品如何	{景福宫=POI名称, 展品=POI内部包含实体}	[POI内部实体修饰
密歇根湖的红杉树如何	{红杉树=POI内部包含实体, 密歇根湖=POI名称}	[POI内部实体修饰
孚日宫的枫叶如何	{孚日宫=POI名称, 枫叶=POI内部包含实体}	[POI内部实体修饰
猴庙的锁如何	{锁=POI内部包含实体, 猴庙=POI名称}	[POI内部实体修饰
迪士尼的枫叶如何	{枫叶=POI内部包含实体, 迪士尼=POI名称}	[POI内部实体修饰
唐人街的高台如何	{唐人街=POI名称, 高台=POI内部包含实体}	[POI内部实体修饰
维港的草原如何	{维港=POI名称, 草原=POI内部包含实体}	[POI内部实体修饰
唐人街的沙子如何	{唐人街=POI名称, 沙子=POI内部包含实体}	[POI内部实体修饰
马穆提岛的沙滩如何	{马穆提岛=POI名称, 沙滩=POI内部包含实体}	[POI内部实体修饰
迪斯尼的铁塔如何	{铁塔=POI内部包含实体, 迪斯尼=POI名称}	[POI内部实体修饰
景福宫的塔如何	{景福宫=POI名称, 塔=POI内部包含实体}	[POI内部实体修饰
景福宫的陈设如何	{景福宫=POI名称, 陈设=POI内部包含实体}	[POI内部实体修饰
唐人街的钟表馆如何	{钟表馆=POI内部包含实体, 唐人街=POI名称}	[POI内部实体修饰
九寨沟的电梯如何	{电梯=POI内部包含实体, 九寨沟=POI名称}	[POI内部实体修饰
维港的鸟巢如何	{鸟巢=POI内部包含实体, 维港=POI名称}	[POI内部实体修饰
唐人街的红杉树如何	{红杉树=POI内部包含实体, 唐人街=POI名称}	[POI内部实体修饰
金阁寺的花园如何	{花园=POI内部包含实体, 金阁寺=POI名称}	[POI内部实体修饰
猴庙的浮雕如何	{浮雕=POI内部包含实体, 猴庙=POI名称}	[POI内部实体修饰
猴庙的城墙如何	{城墙=POI内部包含实体, 猴庙=POI名称}	[POI内部实体修饰
青莲院的筏子如何	{青莲院=POI名称, 筏子=POI内部包含实体}	[POI内部实体修饰
阿尔法玛的城堡如何	{阿尔法玛=POI名称, 城堡=POI内部包含实体}	[POI内部实体修饰
新加坡河的海草如何	{新加坡河=POI名称, 海草=POI内部包含实体}	[POI内部实体修饰
维多利亚港的足球场如何	{维多利亚港=POI名称, 足球场=POI内部包含实体}	[POI内部实体修饰
新加坡河的商店如何	{新加坡河=POI名称, 商店=POI内部包含实体}	[POI内部实体修饰
多瑙河的橱柜如何	{橱柜=POI内部包含实体, 多瑙河=POI名称}	[POI内部实体修饰
白沙滩的馆舍如何	{馆舍=POI内部包含实体, 白沙滩=POI名称}	[POI内部实体修饰
鼓浪屿的佛如何	{鼓浪屿=POI名称, 佛=POI内部包含实体}	[POI内部实体修饰
荣军院的亭如何	{荣军院=POI名称, 亭=POI内部包含实体}	[POI内部实体修饰
莱茵河的大殿如何	{莱茵河=POI名称, 大殿=POI内部包含实体}	[POI内部实体修饰
孚日宫的桥如何	{孚日宫=POI名称, 桥=POI内部包含实体}	[POI内部实体修饰
托普卡帕宫的商场如何	{托普卡帕宫=POI名称, 商场=POI内部包含实体}	[POI内部实体修饰
白沙滩的钟楼如何	{白沙滩=POI名称, 钟楼=POI内部包含实体}	[POI内部实体修饰
多瑙河的食堂如何	{食堂=POI内部包含实体, 多瑙河=POI名称}	[POI内部实体修饰
路易港的灯泡如何	{路易港=POI名称, 灯泡=POI内部包含实体}	[POI内部实体修饰
芬兰堡的树木如何	{芬兰堡=POI名称, 树木=POI内部包含实体}	[POI内部实体修饰
密歇根湖的果树如何	{密歇根湖=POI名称, 果树=POI内部包含实体}	[POI内部实体修饰
景福宫的樱花如何	{景福宫=POI名称, 樱花=POI内部包含实体}	[POI内部实体修饰
迪士尼的房间如何	{房间=POI内部包含实体, 迪士尼=POI名称}	[POI内部实体修饰
青莲院的花园如何	{青莲院=POI名称, 花园=POI内部包含实体}	[POI内部实体修饰
光明寺的官邸如何	{光明寺=POI名称, 官邸=POI内部包含实体}	[POI内部实体修饰
马穆提岛的邮筒如何	{邮筒=POI内部包含实体, 马穆提岛=POI名称}	[POI内部实体修饰
全聚德的棺材如何	{全聚德=POI名称, 棺材=POI内部包含实体}	[POI内部实体修饰
孚日宫的大佛如何	{孚日宫=POI名称, 大佛=POI内部包含实体}	[POI内部实体修饰
九寨沟的商店如何	{九寨沟=POI名称, 商店=POI内部包含实体}	[POI内部实体修饰
金阁寺的窗户如何	{金阁寺=POI名称, 窗户=POI内部包含实体}	[POI内部实体修饰
维港的店铺如何	{维港=POI名称, 店铺=POI内部包含实体}	[POI内部实体修饰
孚日宫的探知馆如何	{孚日宫=POI名称, 探知馆=POI内部包含实体}	[POI内部实体修饰
大夏宫的海报如何	{海报=POI内部包含实体, 大夏宫=POI名称}	[POI内部实体修饰
日月潭的红杉树如何	{日月潭=POI名称, 红杉树=POI内部包含实体}	[POI内部实体修饰
荣军院的鲜花如何	{鲜花=POI内部包含实体, 荣军院=POI名称}	[POI内部实体修饰
玛黑区的地板如何	{玛黑区=POI名称, 地板=POI内部包含实体}	[POI内部实体修饰
猴庙的樱花如何	{猴庙=POI名称, 樱花=POI内部包含实体}	[POI内部实体修饰
景福宫的探知馆如何	{景福宫=POI名称, 探知馆=POI内部包含实体}	[POI内部实体修饰
马穆提岛的锁如何	{锁=POI内部包含实体, 马穆提岛=POI名称}	[POI内部实体修饰
唐人街的文物如何	{唐人街=POI名称, 文物=POI内部包含实体}	[POI内部实体修饰
阿尔法玛的厕所如何	{厕所=POI内部包含实体, 阿尔法玛=POI名称}	[POI内部实体修饰
迪斯尼的商铺如何	{商铺=POI内部包含实体, 迪斯尼=POI名称}	[POI内部实体修饰
金阁寺的庙宇如何	{庙宇=POI内部包含实体, 金阁寺=POI名称}	[POI内部实体修饰
全聚德的锁如何	{锁=POI内部包含实体, 全聚德=POI名称}	[POI内部实体修饰
鼓浪屿的保险柜如何	{鼓浪屿=POI名称, 保险柜=POI内部包含实体}	[POI内部实体修饰
荣军院的药房如何	{药房=POI内部包含实体, 荣军院=POI名称}	[POI内部实体修饰
新加坡河的草原如何	{草原=POI内部包含实体, 新加坡河=POI名称}	[POI内部实体修饰
唐人街的胡同如何	{唐人街=POI名称, 胡同=POI内部包含实体}	[POI内部实体修饰
玛黑区的厕所如何	{玛黑区=POI名称, 厕所=POI内部包含实体}	[POI内部实体修饰
鼓浪屿的科技馆如何	{科技馆=POI内部包含实体, 鼓浪屿=POI名称}	[POI内部实体修饰
荣军院的井如何	{井=POI内部包含实体, 荣军院=POI名称}	[POI内部实体修饰
青莲院的藏品如何	{藏品=POI内部包含实体, 青莲院=POI名称}	[POI内部实体修饰
荣军院的钟表馆如何	{钟表馆=POI内部包含实体, 荣军院=POI名称}	[POI内部实体修饰
凯旋门的通道如何	{通道=POI内部包含实体, 凯旋门=POI名称}	[POI内部实体修饰
新加坡河的沙子如何	{新加坡河=POI名称, 沙子=POI内部包含实体}	[POI内部实体修饰
迪斯尼的商场如何	{商场=POI内部包含实体, 迪斯尼=POI名称}	[POI内部实体修饰
九寨沟的霓虹灯如何	{九寨沟=POI名称, 霓虹灯=POI内部包含实体}	[POI内部实体修饰
红树的蜡像如何	{红树=POI名称, 蜡像=POI内部包含实体}	[POI内部实体修饰
金阁寺的牌坊如何	{牌坊=POI内部包含实体, 金阁寺=POI名称}	[POI内部实体修饰
维港的胡同如何	{维港=POI名称, 胡同=POI内部包含实体}	[POI内部实体修饰
马穆提岛的陈设如何	{陈设=POI内部包含实体, 马穆提岛=POI名称}	[POI内部实体修饰
阿尔法玛的实验室如何	{阿尔法玛=POI名称, 实验室=POI内部包含实体}	[POI内部实体修饰
大夏宫的文物如何	{大夏宫=POI名称, 文物=POI内部包含实体}	[POI内部实体修饰
凯旋门的实验室如何	{凯旋门=POI名称, 实验室=POI内部包含实体}	[POI内部实体修饰
维多利亚港的钟楼如何	{维多利亚港=POI名称, 钟楼=POI内部包含实体}	[POI内部实体修饰
卢浮宫的馆舍如何	{馆舍=POI内部包含实体, 卢浮宫=POI名称}	[POI内部实体修饰
白沙滩的教堂如何	{教堂=POI内部包含实体, 白沙滩=POI名称}	[POI内部实体修饰
迪斯尼的胡同如何	{胡同=POI内部包含实体, 迪斯尼=POI名称}	[POI内部实体修饰
九寨沟的窗户如何	{九寨沟=POI名称, 窗户=POI内部包含实体}	[POI内部实体修饰
日月潭的食堂如何	{日月潭=POI名称, 食堂=POI内部包含实体}	[POI内部实体修饰
维多利亚港的海报如何	{海报=POI内部包含实体, 维多利亚港=POI名称}	[POI内部实体修饰
迪士尼的馆舍如何	{馆舍=POI内部包含实体, 迪士尼=POI名称}	[POI内部实体修饰
鼓浪屿的温泉如何	{鼓浪屿=POI名称, 温泉=POI内部包含实体}	[POI内部实体修饰
九寨沟的阶梯如何	{九寨沟=POI名称, 阶梯=POI内部包含实体}	[POI内部实体修饰
阿尔法玛的舞台如何	{舞台=POI内部包含实体, 阿尔法玛=POI名称}	[POI内部实体修饰
白沙滩的河灯好不好	{河灯=POI内部包含实体, 白沙滩=POI名称}	[POI内部实体修饰
玛黑区的双人房好不好	{玛黑区=POI名称, 双人房=POI内部包含实体}	[POI内部实体修饰
路易港的沙石好不好	{沙石=POI内部包含实体, 路易港=POI名称}	[POI内部实体修饰
玛黑区的井好不好	{玛黑区=POI名称, 井=POI内部包含实体}	[POI内部实体修饰
莱茵河的魔方好不好	{莱茵河=POI名称, 魔方=POI内部包含实体}	[POI内部实体修饰
阿尔法玛的会展好不好	{会展=POI内部包含实体, 阿尔法玛=POI名称}	[POI内部实体修饰
金阁寺的鸟巢好不好	{鸟巢=POI内部包含实体, 金阁寺=POI名称}	[POI内部实体修饰
孚日宫的鸟巢好不好	{鸟巢=POI内部包含实体, 孚日宫=POI名称}	[POI内部实体修饰
马穆提岛的庭院好不好	{庭院=POI内部包含实体, 马穆提岛=POI名称}	[POI内部实体修饰
鼓浪屿的树木好不好	{鼓浪屿=POI名称, 树木=POI内部包含实体}	[POI内部实体修饰
芬兰堡的红叶好不好	{芬兰堡=POI名称, 红叶=POI内部包含实体}	[POI内部实体修饰
日月潭的赌场好不好	{日月潭=POI名称, 赌场=POI内部包含实体}	[POI内部实体修饰
景福宫的窗户好不好	{景福宫=POI名称, 窗户=POI内部包含实体}	[POI内部实体修饰
白沙滩的赌场好不好	{白沙滩=POI名称, 赌场=POI内部包含实体}	[POI内部实体修饰
凯旋门的花园好不好	{凯旋门=POI名称, 花园=POI内部包含实体}	[POI内部实体修饰
光明寺的服装好不好	{服装=POI内部包含实体, 光明寺=POI名称}	[POI内部实体修饰
密歇根湖的海草好不好	{密歇根湖=POI名称, 海草=POI内部包含实体}	[POI内部实体修饰
凯旋门的庙宇好不好	{庙宇=POI内部包含实体, 凯旋门=POI名称}	[POI内部实体修饰
迪士尼的地板好不好	{地板=POI内部包含实体, 迪士尼=POI名称}	[POI内部实体修饰
玛黑区的草地好不好	{玛黑区=POI名称, 草地=POI内部包含实体}	[POI内部实体修饰
全聚德的红叶好不好	{全聚德=POI名称, 红叶=POI内部包含实体}	[POI内部实体修饰
托普卡帕宫的保险柜好不好	{托普卡帕宫=POI名称, 保险柜=POI内部包含实体}	[POI内部实体修饰
玛黑区的河灯好不好	{玛黑区=POI名称, 河灯=POI内部包含实体}	[POI内部实体修饰
密歇根湖的浮雕好不好	{密歇根湖=POI名称, 浮雕=POI内部包含实体}	[POI内部实体修饰
鼓浪屿的剧院好不好	{剧院=POI内部包含实体, 鼓浪屿=POI名称}	[POI内部实体修饰
卢浮宫的樱花好不好	{卢浮宫=POI名称, 樱花=POI内部包含实体}	[POI内部实体修饰
大夏宫的纪念馆好不好	{大夏宫=POI名称, 纪念馆=POI内部包含实体}	[POI内部实体修饰
路易港的窗户好不好	{路易港=POI名称, 窗户=POI内部包含实体}	[POI内部实体修饰
密歇根湖的红叶好不好	{密歇根湖=POI名称, 红叶=POI内部包含实体}	[POI内部实体修饰
多瑙河的剧场好不好	{多瑙河=POI名称, 剧场=POI内部包含实体}	[POI内部实体修饰
莱茵河的汤池好不好	{莱茵河=POI名称, 汤池=POI内部包含实体}	[POI内部实体修饰
红树的温泉水好不好	{红树=POI名称, 温泉水=POI内部包含实体}	[POI内部实体修饰
青莲院的商店好不好	{青莲院=POI名称, 商店=POI内部包含实体}	[POI内部实体修饰
马穆提岛的城堡好不好	{城堡=POI内部包含实体, 马穆提岛=POI名称}	[POI内部实体修饰
莱茵河的纪念馆好不好	{莱茵河=POI名称, 纪念馆=POI内部包含实体}	[POI内部实体修饰
大夏宫的指示牌好不好	{大夏宫=POI名称, 指示牌=POI内部包含实体}	[POI内部实体修饰
光明寺的城堡好不好	{光明寺=POI名称, 城堡=POI内部包含实体}	[POI内部实体修饰
孚日宫的座位好不好	{孚日宫=POI名称, 座位=POI内部包含实体}	[POI内部实体修饰
多瑙河的沙丘好不好	{沙丘=POI内部包含实体, 多瑙河=POI名称}	[POI内部实体修饰
荣军院的温泉好不好	{荣军院=POI名称, 温泉=POI内部包含实体}	[POI内部实体修饰
红树的云海好不好	{红树=POI名称, 云海=POI内部包含实体}	[POI内部实体修饰
鼓浪屿的实验室好不好	{鼓浪屿=POI名称, 实验室=POI内部包含实体}	[POI内部实体修饰
新加坡河的棺材好不好	{新加坡河=POI名称, 棺材=POI内部包含实体}	[POI内部实体修饰
景福宫的大殿好不好	{大殿=POI内部包含实体, 景福宫=POI名称}	[POI内部实体修饰
九寨沟的纪念堂好不好	{纪念堂=POI内部包含实体, 九寨沟=POI名称}	[POI内部实体修饰
大夏宫的庭院好不好	{庭院=POI内部包含实体, 大夏宫=POI名称}	[POI内部实体修饰
荣军院的房屋好不好	{房屋=POI内部包含实体, 荣军院=POI名称}	[POI内部实体修饰
阿尔法玛的酒吧好不好	{酒吧=POI内部包含实体, 阿尔法玛=POI名称}	[POI内部实体修饰
鼓浪屿的胡同好不好	{胡同=POI内部包含实体, 鼓浪屿=POI名称}	[POI内部实体修饰
路易港的果树好不好	{果树=POI内部包含实体, 路易港=POI名称}	[POI内部实体修饰
猴庙的海洋馆好不好	{海洋馆=POI内部包含实体, 猴庙=POI名称}	[POI内部实体修饰
鼓浪屿的泰迪熊好不好	{鼓浪屿=POI名称, 泰迪熊=POI内部包含实体}	[POI内部实体修饰
莱茵河的温泉水好不好	{莱茵河=POI名称, 温泉水=POI内部包含实体}	[POI内部实体修饰
青莲院的阶梯好不好	{青莲院=POI名称, 阶梯=POI内部包含实体}	[POI内部实体修饰
九寨沟的照片好不好	{九寨沟=POI名称, 照片=POI内部包含实体}	[POI内部实体修饰
玛黑区的草坪好不好	{玛黑区=POI名称, 草坪=POI内部包含实体}	[POI内部实体修饰
猴庙的胡同好不好	{胡同=POI内部包含实体, 猴庙=POI名称}	[POI内部实体修饰
猴庙的雕像好不好	{雕像=POI内部包含实体, 猴庙=POI名称}	[POI内部实体修饰
青莲院的舞台好不好	{舞台=POI内部包含实体, 青莲院=POI名称}	[POI内部实体修饰
唐人街的灯好不好	{唐人街=POI名称, 灯=POI内部包含实体}	[POI内部实体修饰
唐人街的教堂好不好	{唐人街=POI名称, 教堂=POI内部包含实体}	[POI内部实体修饰
玛黑区的沙滩好不好	{玛黑区=POI名称, 沙滩=POI内部包含实体}	[POI内部实体修饰
鼓浪屿的博物馆好不好	{博物馆=POI内部包含实体, 鼓浪屿=POI名称}	[POI内部实体修饰
金阁寺的植物园好不好	{植物园=POI内部包含实体, 金阁寺=POI名称}	[POI内部实体修饰
景福宫的水族馆好不好	{景福宫=POI名称, 水族馆=POI内部包含实体}	[POI内部实体修饰
芬兰堡的红树好不好	{红树=POI内部包含实体, 芬兰堡=POI名称}	[POI内部实体修饰
密歇根湖的商户好不好	{密歇根湖=POI名称, 商户=POI内部包含实体}	[POI内部实体修饰
维港的舞台好不好	{舞台=POI内部包含实体, 维港=POI名称}	[POI内部实体修饰
景福宫的泳池好不好	{泳池=POI内部包含实体, 景福宫=POI名称}	[POI内部实体修饰
荣军院的砂岩好不好	{砂岩=POI内部包含实体, 荣军院=POI名称}	[POI内部实体修饰
白沙滩的亭好不好	{白沙滩=POI名称, 亭=POI内部包含实体}	[POI内部实体修饰
维多利亚港的游乐场好不好	{游乐场=POI内部包含实体, 维多利亚港=POI名称}	[POI内部实体修饰
卢浮宫的屋顶好不好	{屋顶=POI内部包含实体, 卢浮宫=POI名称}	[POI内部实体修饰
红树的花园好不好	{红树=POI名称, 花园=POI内部包含实体}	[POI内部实体修饰
阿尔法玛的画好不好	{阿尔法玛=POI名称, 画=POI内部包含实体}	[POI内部实体修饰
路易港的长廊好不好	{长廊=POI内部包含实体, 路易港=POI名称}	[POI内部实体修饰
莱茵河的地砖好不好	{莱茵河=POI名称, 地砖=POI内部包含实体}	[POI内部实体修饰
多瑙河的风铃好不好	{风铃=POI内部包含实体, 多瑙河=POI名称}	[POI内部实体修饰
鼓浪屿的红树好不好	{红树=POI内部包含实体, 鼓浪屿=POI名称}	[POI内部实体修饰
马穆提岛的海滩好不好	{马穆提岛=POI名称, 海滩=POI内部包含实体}	[POI内部实体修饰
马穆提岛的厕所好不好	{厕所=POI内部包含实体, 马穆提岛=POI名称}	[POI内部实体修饰
维多利亚港的鸟巢好不好	{鸟巢=POI内部包含实体, 维多利亚港=POI名称}	[POI内部实体修饰
玛黑区的卧佛好不好	{玛黑区=POI名称, 卧佛=POI内部包含实体}	[POI内部实体修饰
莱茵河的实验室好不好	{莱茵河=POI名称, 实验室=POI内部包含实体}	[POI内部实体修饰
托普卡帕宫的房屋好不好	{房屋=POI内部包含实体, 托普卡帕宫=POI名称}	[POI内部实体修饰
维港的作品好不好	{维港=POI名称, 作品=POI内部包含实体}	[POI内部实体修饰
唐人街的电梯好不好	{唐人街=POI名称, 电梯=POI内部包含实体}	[POI内部实体修饰
凯旋门的停车场好不好	{凯旋门=POI名称, 停车场=POI内部包含实体}	[POI内部实体修饰
红树的剧院好不好	{红树=POI名称, 剧院=POI内部包含实体}	[POI内部实体修饰
九寨沟的华表好不好	{华表=POI内部包含实体, 九寨沟=POI名称}	[POI内部实体修饰
红树的红树好不好	{红树=POI内部包含实体}	[POI内部实体修饰
新加坡河的院子好不好	{新加坡河=POI名称, 院子=POI内部包含实体}	[POI内部实体修饰
芬兰堡的大殿好不好	{大殿=POI内部包含实体, 芬兰堡=POI名称}	[POI内部实体修饰
密歇根湖的锁好不好	{锁=POI内部包含实体, 密歇根湖=POI名称}	[POI内部实体修饰
凯旋门的车位好不好	{车位=POI内部包含实体, 凯旋门=POI名称}	[POI内部实体修饰
迪士尼的邮筒好不好	{邮筒=POI内部包含实体, 迪士尼=POI名称}	[POI内部实体修饰
金阁寺的花园好不好	{花园=POI内部包含实体, 金阁寺=POI名称}	[POI内部实体修饰
光明寺的草原好不好	{草原=POI内部包含实体, 光明寺=POI名称}	[POI内部实体修饰
金阁寺的庭院好不好	{庭院=POI内部包含实体, 金阁寺=POI名称}	[POI内部实体修饰
新加坡河的大门好不好	{新加坡河=POI名称, 大门=POI内部包含实体}	[POI内部实体修饰
多瑙河的商铺怎么样	{多瑙河=POI名称, 商铺=POI内部包含实体}	[POI内部实体修饰
金阁寺的泳池怎么样	{泳池=POI内部包含实体, 金阁寺=POI名称}	[POI内部实体修饰
维多利亚港的赌场怎么样	{维多利亚港=POI名称, 赌场=POI内部包含实体}	[POI内部实体修饰
密歇根湖的沙子怎么样	{密歇根湖=POI名称, 沙子=POI内部包含实体}	[POI内部实体修饰
孚日宫的云海怎么样	{孚日宫=POI名称, 云海=POI内部包含实体}	[POI内部实体修饰
多瑙河的阶梯怎么样	{多瑙河=POI名称, 阶梯=POI内部包含实体}	[POI内部实体修饰
白沙滩的岩石怎么样	{岩石=POI内部包含实体, 白沙滩=POI名称}	[POI内部实体修饰
路易港的钟楼怎么样	{路易港=POI名称, 钟楼=POI内部包含实体}	[POI内部实体修饰
唐人街的柱子怎么样	{柱子=POI内部包含实体, 唐人街=POI名称}	[POI内部实体修饰
鼓浪屿的枫叶怎么样	{枫叶=POI内部包含实体, 鼓浪屿=POI名称}	[POI内部实体修饰
荣军院的城堡怎么样	{城堡=POI内部包含实体, 荣军院=POI名称}	[POI内部实体修饰
新加坡河的床铺怎么样	{新加坡河=POI名称, 床铺=POI内部包含实体}	[POI内部实体修饰
荣军院的食堂怎么样	{食堂=POI内部包含实体, 荣军院=POI名称}	[POI内部实体修饰
荣军院的花园怎么样	{花园=POI内部包含实体, 荣军院=POI名称}	[POI内部实体修饰
全聚德的瀑布怎么样	{全聚德=POI名称, 瀑布=POI内部包含实体}	[POI内部实体修饰
大夏宫的双人房怎么样	{双人房=POI内部包含实体, 大夏宫=POI名称}	[POI内部实体修饰
路易港的浮雕怎么样	{路易港=POI名称, 浮雕=POI内部包含实体}	[POI内部实体修饰
莱茵河的沙石怎么样	{莱茵河=POI名称, 沙石=POI内部包含实体}	[POI内部实体修饰
青莲院的灯塔怎么样	{灯塔=POI内部包含实体, 青莲院=POI名称}	[POI内部实体修饰
金阁寺的亭怎么样	{亭=POI内部包含实体, 金阁寺=POI名称}	[POI内部实体修饰
密歇根湖的钟表馆怎么样	{钟表馆=POI内部包含实体, 密歇根湖=POI名称}	[POI内部实体修饰
猴庙的草坪怎么样	{草坪=POI内部包含实体, 猴庙=POI名称}	[POI内部实体修饰
卢浮宫的商店怎么样	{卢浮宫=POI名称, 商店=POI内部包含实体}	[POI内部实体修饰
光明寺的院子怎么样	{光明寺=POI名称, 院子=POI内部包含实体}	[POI内部实体修饰
托普卡帕宫的赌场怎么样	{托普卡帕宫=POI名称, 赌场=POI内部包含实体}	[POI内部实体修饰
唐人街的城墙怎么样	{城墙=POI内部包含实体, 唐人街=POI名称}	[POI内部实体修饰
密歇根湖的树木怎么样	{密歇根湖=POI名称, 树木=POI内部包含实体}	[POI内部实体修饰
鼓浪屿的床铺怎么样	{鼓浪屿=POI名称, 床铺=POI内部包含实体}	[POI内部实体修饰
维多利亚港的保险柜怎么样	{维多利亚港=POI名称, 保险柜=POI内部包含实体}	[POI内部实体修饰
芬兰堡的观景台怎么样	{观景台=POI内部包含实体, 芬兰堡=POI名称}	[POI内部实体修饰
芬兰堡的馆舍怎么样	{馆舍=POI内部包含实体, 芬兰堡=POI名称}	[POI内部实体修饰
九寨沟的柱子怎么样	{柱子=POI内部包含实体, 九寨沟=POI名称}	[POI内部实体修饰
大夏宫的海湾怎么样	{大夏宫=POI名称, 海湾=POI内部包含实体}	[POI内部实体修饰
鼓浪屿的赌场怎么样	{鼓浪屿=POI名称, 赌场=POI内部包含实体}	[POI内部实体修饰
新加坡河的钟楼怎么样	{新加坡河=POI名称, 钟楼=POI内部包含实体}	[POI内部实体修饰
莱茵河的巷子怎么样	{莱茵河=POI名称, 巷子=POI内部包含实体}	[POI内部实体修饰
全聚德的河灯怎么样	{河灯=POI内部包含实体, 全聚德=POI名称}	[POI内部实体修饰
多瑙河的足球场怎么样	{多瑙河=POI名称, 足球场=POI内部包含实体}	[POI内部实体修饰
红树的樱花怎么样	{红树=POI名称, 樱花=POI内部包含实体}	[POI内部实体修饰
猴庙的座位怎么样	{猴庙=POI名称, 座位=POI内部包含实体}	[POI内部实体修饰
迪斯尼的会展怎么样	{会展=POI内部包含实体, 迪斯尼=POI名称}	[POI内部实体修饰
凯旋门的博物馆怎么样	{博物馆=POI内部包含实体, 凯旋门=POI名称}	[POI内部实体修饰
芬兰堡的鸟巢怎么样	{鸟巢=POI内部包含实体, 芬兰堡=POI名称}	[POI内部实体修饰
孚日宫的邮筒怎么样	{孚日宫=POI名称, 邮筒=POI内部包含实体}	[POI内部实体修饰
孚日宫的草坪怎么样	{草坪=POI内部包含实体, 孚日宫=POI名称}	[POI内部实体修饰
红树的神社怎么样	{红树=POI名称, 神社=POI内部包含实体}	[POI内部实体修饰
青莲院的佛像怎么样	{青莲院=POI名称, 佛像=POI内部包含实体}	[POI内部实体修饰
维港的果树怎么样	{维港=POI名称, 果树=POI内部包含实体}	[POI内部实体修饰
迪士尼的楼梯怎么样	{迪士尼=POI名称, 楼梯=POI内部包含实体}	[POI内部实体修饰
景福宫的钟楼怎么样	{景福宫=POI名称, 钟楼=POI内部包含实体}	[POI内部实体修饰
玛黑区的会展怎么样	{玛黑区=POI名称, 会展=POI内部包含实体}	[POI内部实体修饰
迪斯尼的床铺怎么样	{床铺=POI内部包含实体, 迪斯尼=POI名称}	[POI内部实体修饰
荣军院的舞台怎么样	{舞台=POI内部包含实体, 荣军院=POI名称}	[POI内部实体修饰
路易港的草坪怎么样	{草坪=POI内部包含实体, 路易港=POI名称}	[POI内部实体修饰
白沙滩的艺术品怎么样	{白沙滩=POI名称, 艺术品=POI内部包含实体}	[POI内部实体修饰
孚日宫的窗户怎么样	{孚日宫=POI名称, 窗户=POI内部包含实体}	[POI内部实体修饰
托普卡帕宫的后院怎么样	{托普卡帕宫=POI名称, 后院=POI内部包含实体}	[POI内部实体修饰
唐人街的藏品怎么样	{藏品=POI内部包含实体, 唐人街=POI名称}	[POI内部实体修饰
红树的摊位怎么样	{红树=POI名称, 摊位=POI内部包含实体}	[POI内部实体修饰
莱茵河的大佛怎么样	{莱茵河=POI名称, 大佛=POI内部包含实体}	[POI内部实体修饰
马穆提岛的海湾怎么样	{海湾=POI内部包含实体, 马穆提岛=POI名称}	[POI内部实体修饰
迪斯尼的珊瑚怎么样	{珊瑚=POI内部包含实体, 迪斯尼=POI名称}	[POI内部实体修饰
新加坡河的喷泉怎么样	{新加坡河=POI名称, 喷泉=POI内部包含实体}	[POI内部实体修饰
九寨沟的红树怎么样	{红树=POI内部包含实体, 九寨沟=POI名称}	[POI内部实体修饰
维多利亚港的塔怎么样	{塔=POI内部包含实体, 维多利亚港=POI名称}	[POI内部实体修饰
路易港的酒吧怎么样	{酒吧=POI内部包含实体, 路易港=POI名称}	[POI内部实体修饰
日月潭的铁塔怎么样	{日月潭=POI名称, 铁塔=POI内部包含实体}	[POI内部实体修饰
荣军院的扩音器怎么样	{扩音器=POI内部包含实体, 荣军院=POI名称}	[POI内部实体修饰
鼓浪屿的蜡像馆怎么样	{鼓浪屿=POI名称, 蜡像馆=POI内部包含实体}	[POI内部实体修饰
阿尔法玛的足球场怎么样	{阿尔法玛=POI名称, 足球场=POI内部包含实体}	[POI内部实体修饰
景福宫的观景台怎么样	{观景台=POI内部包含实体, 景福宫=POI名称}	[POI内部实体修饰
唐人街的剧院怎么样	{剧院=POI内部包含实体, 唐人街=POI名称}	[POI内部实体修饰
马穆提岛的馆舍怎么样	{馆舍=POI内部包含实体, 马穆提岛=POI名称}	[POI内部实体修饰
新加坡河的座位怎么样	{新加坡河=POI名称, 座位=POI内部包含实体}	[POI内部实体修饰
维港的饮食区怎么样	{维港=POI名称, 饮食区=POI内部包含实体}	[POI内部实体修饰
迪士尼的艺术品怎么样	{艺术品=POI内部包含实体, 迪士尼=POI名称}	[POI内部实体修饰
维港的筏子怎么样	{维港=POI名称, 筏子=POI内部包含实体}	[POI内部实体修饰
日月潭的鲜花怎么样	{日月潭=POI名称, 鲜花=POI内部包含实体}	[POI内部实体修饰
鼓浪屿的艺术品怎么样	{鼓浪屿=POI名称, 艺术品=POI内部包含实体}	[POI内部实体修饰
景福宫的商户怎么样	{景福宫=POI名称, 商户=POI内部包含实体}	[POI内部实体修饰
维多利亚港的沙滩怎么样	{维多利亚港=POI名称, 沙滩=POI内部包含实体}	[POI内部实体修饰
全聚德的长廊怎么样	{全聚德=POI名称, 长廊=POI内部包含实体}	[POI内部实体修饰
阿尔法玛的食堂怎么样	{食堂=POI内部包含实体, 阿尔法玛=POI名称}	[POI内部实体修饰
孚日宫的蜡像怎么样	{孚日宫=POI名称, 蜡像=POI内部包含实体}	[POI内部实体修饰
孚日宫的海草怎么样	{孚日宫=POI名称, 海草=POI内部包含实体}	[POI内部实体修饰
密歇根湖的剧场怎么样	{密歇根湖=POI名称, 剧场=POI内部包含实体}	[POI内部实体修饰
大夏宫的玉佛怎么样	{大夏宫=POI名称, 玉佛=POI内部包含实体}	[POI内部实体修饰
红树的球场怎么样	{红树=POI名称, 球场=POI内部包含实体}	[POI内部实体修饰
托普卡帕宫的魔方怎么样	{魔方=POI内部包含实体, 托普卡帕宫=POI名称}	[POI内部实体修饰
红树的地板怎么样	{红树=POI名称, 地板=POI内部包含实体}	[POI内部实体修饰
白沙滩的锁怎么样	{锁=POI内部包含实体, 白沙滩=POI名称}	[POI内部实体修饰
鼓浪屿的筏子怎么样	{鼓浪屿=POI名称, 筏子=POI内部包含实体}	[POI内部实体修饰
金阁寺的灯泡怎么样	{灯泡=POI内部包含实体, 金阁寺=POI名称}	[POI内部实体修饰
日月潭的井怎么样	{日月潭=POI名称, 井=POI内部包含实体}	[POI内部实体修饰
青莲院的花园怎么样	{青莲院=POI名称, 花园=POI内部包含实体}	[POI内部实体修饰
九寨沟的海洋馆怎么样	{九寨沟=POI名称, 海洋馆=POI内部包含实体}	[POI内部实体修饰
唐人街的长廊怎么样	{唐人街=POI名称, 长廊=POI内部包含实体}	[POI内部实体修饰
孚日宫的官邸怎么样	{孚日宫=POI名称, 官邸=POI内部包含实体}	[POI内部实体修饰
白沙滩的店铺怎么样	{白沙滩=POI名称, 店铺=POI内部包含实体}	[POI内部实体修饰
大夏宫的药房怎么样	{药房=POI内部包含实体, 大夏宫=POI名称}	[POI内部实体修饰
维港有泳池吗	{泳池=POI内部包含实体, 维港=POI名称}	2.给出的属性值是否符合实际的属性值。
莱茵河有泳池吗	{泳池=POI内部包含实体, 莱茵河=POI名称}	2.给出的属性值是否符合实际的属性值。
金阁寺有卧佛吗	{卧佛=POI内部包含实体, 金阁寺=POI名称}	2.给出的属性值是否符合实际的属性值。
孚日宫有冷饮店吗	{孚日宫=POI名称, 冷饮店=POI内部包含实体}	2.给出的属性值是否符合实际的属性值。
鼓浪屿有电梯吗	{电梯=POI内部包含实体, 鼓浪屿=POI名称}	2.给出的属性值是否符合实际的属性值。
卢浮宫有枫叶吗	{枫叶=POI内部包含实体, 卢浮宫=POI名称}	2.给出的属性值是否符合实际的属性值。
密歇根湖有云海吗	{密歇根湖=POI名称, 云海=POI内部包含实体}	2.给出的属性值是否符合实际的属性值。
马穆提岛有牌坊吗	{牌坊=POI内部包含实体, 马穆提岛=POI名称}	2.给出的属性值是否符合实际的属性值。
鼓浪屿有餐厅吗	{餐厅=POI内部包含实体, 鼓浪屿=POI名称}	2.给出的属性值是否符合实际的属性值。
荣军院有佛像吗	{荣军院=POI名称, 佛像=POI内部包含实体}	2.给出的属性值是否符合实际的属性值。
玛黑区有瀑布吗	{玛黑区=POI名称, 瀑布=POI内部包含实体}	2.给出的属性值是否符合实际的属性值。
凯旋门有宫殿吗	{凯旋门=POI名称, 宫殿=POI内部包含实体}	2.给出的属性值是否符合实际的属性值。
景福宫有阶梯吗	{景福宫=POI名称, 阶梯=POI内部包含实体}	2.给出的属性值是否符合实际的属性值。
红树有画吗	{红树=POI名称, 画=POI内部包含实体}	2.给出的属性值是否符合实际的属性值。
日月潭有花园吗	{日月潭=POI名称, 花园=POI内部包含实体}	2.给出的属性值是否符合实际的属性值。
猴庙有商场吗	{猴庙=POI名称, 商场=POI内部包含实体}	2.给出的属性值是否符合实际的属性值。
路易港有楼梯吗	{路易港=POI名称, 楼梯=POI内部包含实体}	2.给出的属性值是否符合实际的属性值。
全聚德有大佛吗	{全聚德=POI名称, 大佛=POI内部包含实体}	2.给出的属性值是否符合实际的属性值。
迪士尼有柱子吗	{柱子=POI内部包含实体, 迪士尼=POI名称}	2.给出的属性值是否符合实际的属性值。
青莲院有汤池吗	{汤池=POI内部包含实体, 青莲院=POI名称}	2.给出的属性值是否符合实际的属性值。
凯旋门有大厅吗	{大厅=POI内部包含实体, 凯旋门=POI名称}	2.给出的属性值是否符合实际的属性值。
路易港有藏品吗	{藏品=POI内部包含实体, 路易港=POI名称}	2.给出的属性值是否符合实际的属性值。
红树有床铺吗	{红树=POI名称, 床铺=POI内部包含实体}	2.给出的属性值是否符合实际的属性值。
玛黑区有剧场吗	{玛黑区=POI名称, 剧场=POI内部包含实体}	2.给出的属性值是否符合实际的属性值。
莱茵河有蜡像吗	{莱茵河=POI名称, 蜡像=POI内部包含实体}	2.给出的属性值是否符合实际的属性值。
光明寺有台阶吗	{光明寺=POI名称, 台阶=POI内部包含实体}	2.给出的属性值是否符合实际的属性值。
多瑙河有邮筒吗	{邮筒=POI内部包含实体, 多瑙河=POI名称}	2.给出的属性值是否符合实际的属性值。
光明寺有院子吗	{光明寺=POI名称, 院子=POI内部包含实体}	2.给出的属性值是否符合实际的属性值。
全聚德有喷泉吗	{全聚德=POI名称, 喷泉=POI内部包含实体}	2.给出的属性值是否符合实际的属性值。
莱茵河有红杉树吗	{莱茵河=POI名称, 红杉树=POI内部包含实体}	2.给出的属性值是否符合实际的属性值。
阿尔法玛有球场吗	{阿尔法玛=POI名称, 球场=POI内部包含实体}	2.给出的属性值是否符合实际的属性值。
玛黑区有剧院吗	{玛黑区=POI名称, 剧院=POI内部包含实体}	2.给出的属性值是否符合实际的属性值。
莱茵河有雕塑吗	{莱茵河=POI名称, 雕塑=POI内部包含实体}	2.给出的属性值是否符合实际的属性值。
光明寺有迷宫吗	{迷宫=POI内部包含实体, 光明寺=POI名称}	2.给出的属性值是否符合实际的属性值。
卢浮宫有纪念馆吗	{卢浮宫=POI名称, 纪念馆=POI内部包含实体}	2.给出的属性值是否符合实际的属性值。
青莲院有霓虹灯吗	{青莲院=POI名称, 霓虹灯=POI内部包含实体}	2.给出的属性值是否符合实际的属性值。
卢浮宫有泰迪熊吗	{卢浮宫=POI名称, 泰迪熊=POI内部包含实体}	2.给出的属性值是否符合实际的属性值。
路易港有冷饮店吗	{冷饮店=POI内部包含实体, 路易港=POI名称}	2.给出的属性值是否符合实际的属性值。
新加坡河有蜡像吗	{新加坡河=POI名称, 蜡像=POI内部包含实体}	2.给出的属性值是否符合实际的属性值。
九寨沟有博物馆吗	{博物馆=POI内部包含实体, 九寨沟=POI名称}	2.给出的属性值是否符合实际的属性值。
阿尔法玛有观景台吗	{观景台=POI内部包含实体, 阿尔法玛=POI名称}	2.给出的属性值是否符合实际的属性值。
孚日宫有沙滩吗	{孚日宫=POI名称, 沙滩=POI内部包含实体}	2.给出的属性值是否符合实际的属性值。
光明寺有作品吗	{光明寺=POI名称, 作品=POI内部包含实体}	2.给出的属性值是否符合实际的属性值。
景福宫有风铃吗	{景福宫=POI名称, 风铃=POI内部包含实体}	2.给出的属性值是否符合实际的属性值。
卢浮宫有商场吗	{卢浮宫=POI名称, 商场=POI内部包含实体}	2.给出的属性值是否符合实际的属性值。
全聚德有海湾吗	{全聚德=POI名称, 海湾=POI内部包含实体}	2.给出的属性值是否符合实际的属性值。
维多利亚港有后院吗	{维多利亚港=POI名称, 后院=POI内部包含实体}	2.给出的属性值是否符合实际的属性值。
光明寺有植物园吗	{光明寺=POI名称, 植物园=POI内部包含实体}	2.给出的属性值是否符合实际的属性值。
唐人街有照片吗	{唐人街=POI名称, 照片=POI内部包含实体}	2.给出的属性值是否符合实际的属性值。
九寨沟有井吗	{九寨沟=POI名称, 井=POI内部包含实体}	2.给出的属性值是否符合实际的属性值。
九寨沟有纪念碑吗	{纪念碑=POI内部包含实体, 九寨沟=POI名称}	2.给出的属性值是否符合实际的属性值。
玛黑区有商场吗	{玛黑区=POI名称, 商场=POI内部包含实体}	2.给出的属性值是否符合实际的属性值。
卢浮宫有沙子吗	{卢浮宫=POI名称, 沙子=POI内部包含实体}	2.给出的属性值是否符合实际的属性值。
迪斯尼有铁塔吗	{铁塔=POI内部包含实体, 迪斯尼=POI名称}	2.给出的属性值是否符合实际的属性值。
九寨沟有摊位吗	{九寨沟=POI名称, 摊位=POI内部包含实体}	2.给出的属性值是否符合实际的属性值。
新加坡河有海草吗	{新加坡河=POI名称, 海草=POI内部包含实体}	2.给出的属性值是否符合实际的属性值。
大夏宫有舞台吗	{舞台=POI内部包含实体, 大夏宫=POI名称}	2.给出的属性值是否符合实际的属性值。
新加坡河有魔方吗	{魔方=POI内部包含实体, 新加坡河=POI名称}	2.给出的属性值是否符合实际的属性值。
玛黑区有筏子吗	{玛黑区=POI名称, 筏子=POI内部包含实体}	2.给出的属性值是否符合实际的属性值。
猴庙有球场吗	{球场=POI内部包含实体, 猴庙=POI名称}	2.给出的属性值是否符合实际的属性值。
光明寺有沙丘吗	{沙丘=POI内部包含实体, 光明寺=POI名称}	2.给出的属性值是否符合实际的属性值。
九寨沟有亭吗	{九寨沟=POI名称, 亭=POI内部包含实体}	2.给出的属性值是否符合实际的属性值。
迪士尼有卫生间吗	{卫生间=POI内部包含实体, 迪士尼=POI名称}	2.给出的属性值是否符合实际的属性值。
金阁寺有商场吗	{商场=POI内部包含实体, 金阁寺=POI名称}	2.给出的属性值是否符合实际的属性值。
路易港有铁塔吗	{铁塔=POI内部包含实体, 路易港=POI名称}	2.给出的属性值是否符合实际的属性值。
玛黑区有皇宫吗	{玛黑区=POI名称, 皇宫=POI内部包含实体}	2.给出的属性值是否符合实际的属性值。
大夏宫有大门吗	{大夏宫=POI名称, 大门=POI内部包含实体}	2.给出的属性值是否符合实际的属性值。
青莲院有藏品吗	{藏品=POI内部包含实体, 青莲院=POI名称}	2.给出的属性值是否符合实际的属性值。
维多利亚港有桥吗	{桥=POI内部包含实体, 维多利亚港=POI名称}	2.给出的属性值是否符合实际的属性值。
卢浮宫有实验室吗	{卢浮宫=POI名称, 实验室=POI内部包含实体}	2.给出的属性值是否符合实际的属性值。
玛黑区有商户吗	{玛黑区=POI名称, 商户=POI内部包含实体}	2.给出的属性值是否符合实际的属性值。
密歇根湖有餐厅吗	{餐厅=POI内部包含实体, 密歇根湖=POI名称}	2.给出的属性值是否符合实际的属性值。
红树有古城堡吗	{红树=POI名称, 古城堡=POI内部包含实体}	2.给出的属性值是否符合实际的属性值。
密歇根湖有花园吗	{密歇根湖=POI名称, 花园=POI内部包含实体}	2.给出的属性值是否符合实际的属性值。
维多利亚港有药房吗	{药房=POI内部包含实体, 维多利亚港=POI名称}	2.给出的属性值是否符合实际的属性值。
红树有蜡像馆吗	{红树=POI名称, 蜡像馆=POI内部包含实体}	2.给出的属性值是否符合实际的属性值。
维港有博物馆吗	{博物馆=POI内部包含实体, 维港=POI名称}	2.给出的属性值是否符合实际的属性值。
红树有霓虹灯吗	{红树=POI名称, 霓虹灯=POI内部包含实体}	2.给出的属性值是否符合实际的属性值。
莱茵河有车位吗	{莱茵河=POI名称, 车位=POI内部包含实体}	2.给出的属性值是否符合实际的属性值。
唐人街有商铺吗	{唐人街=POI名称, 商铺=POI内部包含实体}	2.给出的属性值是否符合实际的属性值。
维多利亚港有胡同吗	{胡同=POI内部包含实体, 维多利亚港=POI名称}	2.给出的属性值是否符合实际的属性值。
鼓浪屿有保险柜吗	{鼓浪屿=POI名称, 保险柜=POI内部包含实体}	2.给出的属性值是否符合实际的属性值。
托普卡帕宫有冷饮店吗	{冷饮店=POI内部包含实体, 托普卡帕宫=POI名称}	2.给出的属性值是否符合实际的属性值。
鼓浪屿有球场吗	{球场=POI内部包含实体, 鼓浪屿=POI名称}	2.给出的属性值是否符合实际的属性值。
白沙滩有摊位吗	{白沙滩=POI名称, 摊位=POI内部包含实体}	2.给出的属性值是否符合实际的属性值。
卢浮宫有卧佛吗	{卢浮宫=POI名称, 卧佛=POI内部包含实体}	2.给出的属性值是否符合实际的属性值。
维港有水族馆吗	{维港=POI名称, 水族馆=POI内部包含实体}	2.给出的属性值是否符合实际的属性值。
金阁寺有长廊吗	{长廊=POI内部包含实体, 金阁寺=POI名称}	2.给出的属性值是否符合实际的属性值。
托普卡帕宫有红树吗	{红树=POI内部包含实体, 托普卡帕宫=POI名称}	2.给出的属性值是否符合实际的属性值。
荣军院有钟楼吗	{荣军院=POI名称, 钟楼=POI内部包含实体}	2.给出的属性值是否符合实际的属性值。
鼓浪屿有钟表馆吗	{钟表馆=POI内部包含实体, 鼓浪屿=POI名称}	2.给出的属性值是否符合实际的属性值。
路易港有作品吗	{路易港=POI名称, 作品=POI内部包含实体}	2.给出的属性值是否符合实际的属性值。
凯旋门有甬道吗	{甬道=POI内部包含实体, 凯旋门=POI名称}	2.给出的属性值是否符合实际的属性值。
托普卡帕宫有蜡像吗	{托普卡帕宫=POI名称, 蜡像=POI内部包含实体}	2.给出的属性值是否符合实际的属性值。
全聚德有房间吗	{全聚德=POI名称, 房间=POI内部包含实体}	2.给出的属性值是否符合实际的属性值。
阿尔法玛有牌坊吗	{牌坊=POI内部包含实体, 阿尔法玛=POI名称}	2.给出的属性值是否符合实际的属性值。
孚日宫有锁吗	{锁=POI内部包含实体, 孚日宫=POI名称}	2.给出的属性值是否符合实际的属性值。
新加坡河有服装吗	{服装=POI内部包含实体, 新加坡河=POI名称}	2.给出的属性值是否符合实际的属性值。
唐人街有舞厅吗	{唐人街=POI名称, 舞厅=POI内部包含实体}	2.给出的属性值是否符合实际的属性值。
迪斯尼有枫叶吗	{枫叶=POI内部包含实体, 迪斯尼=POI名称}	2.给出的属性值是否符合实际的属性值。
托普卡帕宫包含剧院吗	{剧院=POI内部包含实体, 托普卡帕宫=POI名称}	2.给出的属性值是否符合实际的属性值。
维多利亚港包含园林吗	{园林=POI内部包含实体, 维多利亚港=POI名称}	2.给出的属性值是否符合实际的属性值。
维港包含甬道吗	{维港=POI名称, 甬道=POI内部包含实体}	2.给出的属性值是否符合实际的属性值。
鼓浪屿包含井吗	{井=POI内部包含实体, 鼓浪屿=POI名称}	2.给出的属性值是否符合实际的属性值。
孚日宫包含巷子吗	{巷子=POI内部包含实体, 孚日宫=POI名称}	2.给出的属性值是否符合实际的属性值。
唐人街包含瀑布吗	{唐人街=POI名称, 瀑布=POI内部包含实体}	2.给出的属性值是否符合实际的属性值。
猴庙包含海报吗	{海报=POI内部包含实体, 猴庙=POI名称}	2.给出的属性值是否符合实际的属性值。
芬兰堡包含停车位吗	{芬兰堡=POI名称, 停车位=POI内部包含实体}	2.给出的属性值是否符合实际的属性值。
迪斯尼包含球场吗	{球场=POI内部包含实体, 迪斯尼=POI名称}	2.给出的属性值是否符合实际的属性值。
迪士尼包含蜡像馆吗	{迪士尼=POI名称, 蜡像馆=POI内部包含实体}	2.给出的属性值是否符合实际的属性值。
全聚德包含宫墙吗	{全聚德=POI名称, 宫墙=POI内部包含实体}	2.给出的属性值是否符合实际的属性值。
新加坡河包含停车位吗	{新加坡河=POI名称, 停车位=POI内部包含实体}	2.给出的属性值是否符合实际的属性值。
迪士尼包含车位吗	{车位=POI内部包含实体, 迪士尼=POI名称}	2.给出的属性值是否符合实际的属性值。
白沙滩包含永观堂吗	{白沙滩=POI名称, 永观堂=POI内部包含实体}	2.给出的属性值是否符合实际的属性值。
托普卡帕宫包含温泉水吗	{托普卡帕宫=POI名称, 温泉水=POI内部包含实体}	2.给出的属性值是否符合实际的属性值。
孚日宫包含锁吗	{锁=POI内部包含实体, 孚日宫=POI名称}	2.给出的属性值是否符合实际的属性值。
玛黑区包含大佛吗	{玛黑区=POI名称, 大佛=POI内部包含实体}	2.给出的属性值是否符合实际的属性值。
维多利亚港包含鸟巢吗	{鸟巢=POI内部包含实体, 维多利亚港=POI名称}	2.给出的属性值是否符合实际的属性值。
玛黑区包含塔吗	{玛黑区=POI名称, 塔=POI内部包含实体}	2.给出的属性值是否符合实际的属性值。
维多利亚港包含佛像吗	{维多利亚港=POI名称, 佛像=POI内部包含实体}	2.给出的属性值是否符合实际的属性值。
孚日宫包含宫殿吗	{孚日宫=POI名称, 宫殿=POI内部包含实体}	2.给出的属性值是否符合实际的属性值。
九寨沟包含球场吗	{九寨沟=POI名称, 球场=POI内部包含实体}	2.给出的属性值是否符合实际的属性值。
光明寺包含停车场吗	{光明寺=POI名称, 停车场=POI内部包含实体}	2.给出的属性值是否符合实际的属性值。
莱茵河包含舞厅吗	{莱茵河=POI名称, 舞厅=POI内部包含实体}	2.给出的属性值是否符合实际的属性值。
迪斯尼包含珊瑚吗	{珊瑚=POI内部包含实体, 迪斯尼=POI名称}	2.给出的属性值是否符合实际的属性值。
荣军院包含剧场吗	{剧场=POI内部包含实体, 荣军院=POI名称}	2.给出的属性值是否符合实际的属性值。
多瑙河包含枫叶吗	{枫叶=POI内部包含实体, 多瑙河=POI名称}	2.给出的属性值是否符合实际的属性值。
新加坡河包含沙石吗	{沙石=POI内部包含实体, 新加坡河=POI名称}	2.给出的属性值是否符合实际的属性值。
荣军院包含房间吗	{房间=POI内部包含实体, 荣军院=POI名称}	2.给出的属性值是否符合实际的属性值。
光明寺包含饮食区吗	{光明寺=POI名称, 饮食区=POI内部包含实体}	2.给出的属性值是否符合实际的属性值。
托普卡帕宫包含寺庙吗	{寺庙=POI内部包含实体, 托普卡帕宫=POI名称}	2.给出的属性值是否符合实际的属性值。
日月潭包含官邸吗	{日月潭=POI名称, 官邸=POI内部包含实体}	2.给出的属性值是否符合实际的属性值。
马穆提岛包含扩音器吗	{扩音器=POI内部包含实体, 马穆提岛=POI名称}	2.给出的属性值是否符合实际的属性值。
马穆提岛包含瀑布吗	{马穆提岛=POI名称, 瀑布=POI内部包含实体}	2.给出的属性值是否符合实际的属性值。
芬兰堡包含神社吗	{芬兰堡=POI名称, 神社=POI内部包含实体}	2.给出的属性值是否符合实际的属性值。
多瑙河包含筏子吗	{多瑙河=POI名称, 筏子=POI内部包含实体}	2.给出的属性值是否符合实际的属性值。
迪士尼包含蜡像吗	{迪士尼=POI名称, 蜡像=POI内部包含实体}	2.给出的属性值是否符合实际的属性值。
玛黑区包含钟楼吗	{玛黑区=POI名称, 钟楼=POI内部包含实体}	2.给出的属性值是否符合实际的属性值。
维港包含风铃吗	{维港=POI名称, 风铃=POI内部包含实体}	2.给出的属性值是否符合实际的属性值。
托普卡帕宫包含照片吗	{托普卡帕宫=POI名称, 照片=POI内部包含实体}	2.给出的属性值是否符合实际的属性值。
多瑙河包含药房吗	{药房=POI内部包含实体, 多瑙河=POI名称}	2.给出的属性值是否符合实际的属性值。
景福宫包含海报吗	{海报=POI内部包含实体, 景福宫=POI名称}	2.给出的属性值是否符合实际的属性值。
青莲院包含餐厅吗	{餐厅=POI内部包含实体, 青莲院=POI名称}	2.给出的属性值是否符合实际的属性值。
荣军院包含喷泉吗	{喷泉=POI内部包含实体, 荣军院=POI名称}	2.给出的属性值是否符合实际的属性值。
孚日宫包含台阶吗	{孚日宫=POI名称, 台阶=POI内部包含实体}	2.给出的属性值是否符合实际的属性值。
鼓浪屿包含玉佛吗	{鼓浪屿=POI名称, 玉佛=POI内部包含实体}	2.给出的属性值是否符合实际的属性值。
大夏宫包含大厅吗	{大厅=POI内部包含实体, 大夏宫=POI名称}	2.给出的属性值是否符合实际的属性值。
景福宫包含饮食区吗	{景福宫=POI名称, 饮食区=POI内部包含实体}	2.给出的属性值是否符合实际的属性值。
托普卡帕宫包含馆藏吗	{馆藏=POI内部包含实体, 托普卡帕宫=POI名称}	2.给出的属性值是否符合实际的属性值。
托普卡帕宫包含沙丘吗	{沙丘=POI内部包含实体, 托普卡帕宫=POI名称}	2.给出的属性值是否符合实际的属性值。
光明寺包含庙宇吗	{庙宇=POI内部包含实体, 光明寺=POI名称}	2.给出的属性值是否符合实际的属性值。
芬兰堡包含沙石吗	{沙石=POI内部包含实体, 芬兰堡=POI名称}	2.给出的属性值是否符合实际的属性值。
马穆提岛包含美术馆吗	{马穆提岛=POI名称, 美术馆=POI内部包含实体}	2.给出的属性值是否符合实际的属性值。
维港包含纪念馆吗	{维港=POI名称, 纪念馆=POI内部包含实体}	2.给出的属性值是否符合实际的属性值。
迪士尼包含饮食区吗	{饮食区=POI内部包含实体, 迪士尼=POI名称}	2.给出的属性值是否符合实际的属性值。
多瑙河包含锁吗	{锁=POI内部包含实体, 多瑙河=POI名称}	2.给出的属性值是否符合实际的属性值。
迪斯尼包含筏子吗	{筏子=POI内部包含实体, 迪斯尼=POI名称}	2.给出的属性值是否符合实际的属性值。
大夏宫包含魔方吗	{魔方=POI内部包含实体, 大夏宫=POI名称}	2.给出的属性值是否符合实际的属性值。
孚日宫包含温泉吗	{孚日宫=POI名称, 温泉=POI内部包含实体}	2.给出的属性值是否符合实际的属性值。
阿尔法玛包含橱柜吗	{橱柜=POI内部包含实体, 阿尔法玛=POI名称}	2.给出的属性值是否符合实际的属性值。
日月潭包含馆藏吗	{日月潭=POI名称, 馆藏=POI内部包含实体}	2.给出的属性值是否符合实际的属性值。
新加坡河包含沙滩吗	{新加坡河=POI名称, 沙滩=POI内部包含实体}	2.给出的属性值是否符合实际的属性值。
迪士尼包含温泉水吗	{迪士尼=POI名称, 温泉水=POI内部包含实体}	2.给出的属性值是否符合实际的属性值。
猴庙包含海湾吗	{海湾=POI内部包含实体, 猴庙=POI名称}	2.给出的属性值是否符合实际的属性值。
全聚德包含园林吗	{园林=POI内部包含实体, 全聚德=POI名称}	2.给出的属性值是否符合实际的属性值。
莱茵河包含大门吗	{莱茵河=POI名称, 大门=POI内部包含实体}	2.给出的属性值是否符合实际的属性值。
凯旋门包含城堡吗	{城堡=POI内部包含实体, 凯旋门=POI名称}	2.给出的属性值是否符合实际的属性值。
维港包含赌场吗	{维港=POI名称, 赌场=POI内部包含实体}	2.给出的属性值是否符合实际的属性值。
马穆提岛包含华表吗	{华表=POI内部包含实体, 马穆提岛=POI名称}	2.给出的属性值是否符合实际的属性值。
路易港包含温泉水吗	{路易港=POI名称, 温泉水=POI内部包含实体}	2.给出的属性值是否符合实际的属性值。
维港包含长廊吗	{维港=POI名称, 长廊=POI内部包含实体}	2.给出的属性值是否符合实际的属性值。
路易港包含观景台吗	{观景台=POI内部包含实体, 路易港=POI名称}	2.给出的属性值是否符合实际的属性值。
孚日宫包含魔方吗	{孚日宫=POI名称, 魔方=POI内部包含实体}	2.给出的属性值是否符合实际的属性值。
全聚德包含草原吗	{全聚德=POI名称, 草原=POI内部包含实体}	2.给出的属性值是否符合实际的属性值。
孚日宫包含舞厅吗	{孚日宫=POI名称, 舞厅=POI内部包含实体}	2.给出的属性值是否符合实际的属性值。
迪斯尼包含胡同吗	{胡同=POI内部包含实体, 迪斯尼=POI名称}	2.给出的属性值是否符合实际的属性值。
红树包含迷宫吗	{红树=POI名称, 迷宫=POI内部包含实体}	2.给出的属性值是否符合实际的属性值。
九寨沟包含城堡吗	{九寨沟=POI名称, 城堡=POI内部包含实体}	2.给出的属性值是否符合实际的属性值。
密歇根湖包含泳池吗	{泳池=POI内部包含实体, 密歇根湖=POI名称}	2.给出的属性值是否符合实际的属性值。
新加坡河包含双人房吗	{双人房=POI内部包含实体, 新加坡河=POI名称}	2.给出的属性值是否符合实际的属性值。
迪士尼包含博物馆吗	{博物馆=POI内部包含实体, 迪士尼=POI名称}	2.给出的属性值是否符合实际的属性值。
迪斯尼包含纪念堂吗	{纪念堂=POI内部包含实体, 迪斯尼=POI名称}	2.给出的属性值是否符合实际的属性值。
光明寺包含泰迪吗	{泰迪=POI内部包含实体, 光明寺=POI名称}	2.给出的属性值是否符合实际的属性值。
迪斯尼包含冷饮店吗	{冷饮店=POI内部包含实体, 迪斯尼=POI名称}	2.给出的属性值是否符合实际的属性值。
新加坡河包含宫墙吗	{宫墙=POI内部包含实体, 新加坡河=POI名称}	2.给出的属性值是否符合实际的属性值。
白沙滩包含泰迪吗	{白沙滩=POI名称, 泰迪=POI内部包含实体}	2.给出的属性值是否符合实际的属性值。
鼓浪屿包含地砖吗	{鼓浪屿=POI名称, 地砖=POI内部包含实体}	2.给出的属性值是否符合实际的属性值。
荣军院包含岩石吗	{岩石=POI内部包含实体, 荣军院=POI名称}	2.给出的属性值是否符合实际的属性值。
荣军院包含树木吗	{树木=POI内部包含实体, 荣军院=POI名称}	2.给出的属性值是否符合实际的属性值。
莱茵河包含商店吗	{莱茵河=POI名称, 商店=POI内部包含实体}	2.给出的属性值是否符合实际的属性值。
孚日宫包含庙宇吗	{孚日宫=POI名称, 庙宇=POI内部包含实体}	2.给出的属性值是否符合实际的属性值。
青莲院包含玉佛吗	{青莲院=POI名称, 玉佛=POI内部包含实体}	2.给出的属性值是否符合实际的属性值。
荣军院包含纪念碑吗	{纪念碑=POI内部包含实体, 荣军院=POI名称}	2.给出的属性值是否符合实际的属性值。
卢浮宫包含霓虹灯吗	{卢浮宫=POI名称, 霓虹灯=POI内部包含实体}	2.给出的属性值是否符合实际的属性值。
全聚德包含庙宇吗	{全聚德=POI名称, 庙宇=POI内部包含实体}	2.给出的属性值是否符合实际的属性值。
鼓浪屿包含地板吗	{地板=POI内部包含实体, 鼓浪屿=POI名称}	2.给出的属性值是否符合实际的属性值。
红树包含塔吗	{红树=POI名称, 塔=POI内部包含实体}	2.给出的属性值是否符合实际的属性值。
光明寺包含药房吗	{药房=POI内部包含实体, 光明寺=POI名称}	2.给出的属性值是否符合实际的属性值。
玛黑区包含甬道吗	{玛黑区=POI名称, 甬道=POI内部包含实体}	2.给出的属性值是否符合实际的属性值。
玛黑区包含电梯吗	{玛黑区=POI名称, 电梯=POI内部包含实体}	2.给出的属性值是否符合实际的属性值。
芬兰堡多少钱一晚	{芬兰堡=POI名称}	价格
唐人街多少钱一晚	{唐人街=POI名称}	价格
白沙滩多少钱一晚	{白沙滩=POI名称}	价格
卢浮宫多少钱一晚	{卢浮宫=POI名称}	价格
孚日宫多少钱一晚	{孚日宫=POI名称}	价格
景福宫多少钱一晚	{景福宫=POI名称}	价格
迪士尼多少钱一晚	{迪士尼=POI名称}	价格
莱茵河多少钱一晚	{莱茵河=POI名称}	价格
金阁寺多少钱一晚	{金阁寺=POI名称}	价格
鼓浪屿多少钱一晚	{鼓浪屿=POI名称}	价格
日月潭多少钱一晚	{日月潭=POI名称}	价格
路易港多少钱一晚	{路易港=POI名称}	价格
马穆提岛多少钱一晚	{马穆提岛=POI名称}	价格
红树多少钱一晚	{红树=POI名称}	价格
光明寺多少钱一晚	{光明寺=POI名称}	价格
阿尔法玛多少钱一晚	{阿尔法玛=POI名称}	价格
九寨沟多少钱一晚	{九寨沟=POI名称}	价格
全聚德多少钱一晚	{全聚德=POI名称}	价格
凯旋门多少钱一晚	{凯旋门=POI名称}	价格
多瑙河多少钱一晚	{多瑙河=POI名称}	价格
大夏宫多少钱一晚	{大夏宫=POI名称}	价格
玛黑区多少钱一晚	{玛黑区=POI名称}	价格
荣军院多少钱一晚	{荣军院=POI名称}	价格
青莲院多少钱一晚	{青莲院=POI名称}	价格
托普卡帕宫多少钱一晚	{托普卡帕宫=POI名称}	价格
维多利亚港多少钱一晚	{维多利亚港=POI名称}	价格
迪斯尼多少钱一晚	{迪斯尼=POI名称}	价格
新加坡河多少钱一晚	{新加坡河=POI名称}	价格
维港多少钱一晚	{维港=POI名称}	价格
里尔的酒店	{里尔=地理位置参数}	POI list
加拿大卡尔加里的酒店	{加拿大卡尔加里=地理位置参数}	POI list
马斯特里赫特的酒店	{马斯特里赫特=地理位置参数}	POI list
爱尔兰科克的酒店	{爱尔兰科克=地理位置参数}	POI list
赫尔格达的酒店	{赫尔格达=地理位置参数}	POI list
中国北京的酒店	{中国北京=地理位置参数}	POI list
马来西亚瓜拉登嘉楼的酒店	{马来西亚瓜拉登嘉楼=地理位置参数}	POI list
所罗门群岛奥基的酒店	{所罗门群岛奥基=地理位置参数}	POI list
比利时梅赫伦的酒店	{比利时梅赫伦=地理位置参数}	POI list
萨斯费的酒店	{萨斯费=地理位置参数}	POI list
纳克索斯的酒店	{纳克索斯=地理位置参数}	POI list
姬路的酒店	{姬路=地理位置参数}	POI list
马来西亚八打灵再也的酒店	{马来西亚八打灵再也=地理位置参数}	POI list
越南芽庄的酒店	{越南芽庄=地理位置参数}	POI list
希腊纳克索斯的酒店	{希腊纳克索斯=地理位置参数}	POI list
菲律宾黎牙实比的酒店	{菲律宾黎牙实比=地理位置参数}	POI list
罗斯基勒的酒店	{罗斯基勒=地理位置参数}	POI list
米蒂亚罗岛的酒店	{米蒂亚罗岛=地理位置参数}	POI list
华盛顿的酒店	{华盛顿=地理位置参数}	POI list
希腊克里特岛的酒店	{希腊克里特岛=地理位置参数}	POI list
科克斯巴扎尔的酒店	{科克斯巴扎尔=地理位置参数}	POI list
葡萄牙法蒂玛的酒店	{葡萄牙法蒂玛=地理位置参数}	POI list
以色列里雄莱锡安的酒店	{以色列里雄莱锡安=地理位置参数}	POI list
仙台的酒店	{仙台=地理位置参数}	POI list
阿雷格里港的酒店	{阿雷格里港=地理位置参数}	POI list
捷克卡罗维发利的酒店	{捷克卡罗维发利=地理位置参数}	POI list
温尼伯的酒店	{温尼伯=地理位置参数}	POI list
瑞典马尔默的酒店	{瑞典马尔默=地理位置参数}	POI list
瑞典阿比斯库的酒店	{瑞典阿比斯库=地理位置参数}	POI list
日本姬路的酒店	{日本姬路=地理位置参数}	POI list
林茨的酒店	{林茨=地理位置参数}	POI list
新北的酒店	{新北=地理位置参数}	POI list
哥打巴鲁的酒店	{哥打巴鲁=地理位置参数}	POI list
英国纽卡斯尔的酒店	{英国纽卡斯尔=地理位置参数}	POI list
兹沃勒的酒店	{兹沃勒=地理位置参数}	POI list
荷兰海牙的酒店	{荷兰海牙=地理位置参数}	POI list
诺丁汉的酒店	{诺丁汉=地理位置参数}	POI list
韩国丽水的酒店	{韩国丽水=地理位置参数}	POI list
比萨的酒店	{比萨=地理位置参数}	POI list
意大利卢卡的酒店	{意大利卢卡=地理位置参数}	POI list
布雷的酒店	{布雷=地理位置参数}	POI list
奥卢的酒店	{奥卢=地理位置参数}	POI list
美国奥兰多的酒店	{美国奥兰多=地理位置参数}	POI list
艾图塔基的酒店	{艾图塔基=地理位置参数}	POI list
德国汉堡的酒店	{德国汉堡=地理位置参数}	POI list
托马尔的酒店	{托马尔=地理位置参数}	POI list
萨拉戈萨的酒店	{萨拉戈萨=地理位置参数}	POI list
马尔代夫马尔代夫的酒店	{马尔代夫马尔代夫=地理位置参数}	POI list
泰国罗勇的酒店	{泰国罗勇=地理位置参数}	POI list
美国芝加哥的酒店	{美国芝加哥=地理位置参数}	POI list
罗马的酒店	{罗马=地理位置参数}	POI list
阿根廷罗萨里奥的酒店	{阿根廷罗萨里奥=地理位置参数}	POI list
丹麦罗斯基勒的酒店	{丹麦罗斯基勒=地理位置参数}	POI list
高雄的酒店	{高雄=地理位置参数}	POI list
奥地利克拉根福的酒店	{奥地利克拉根福=地理位置参数}	POI list
班多尔班的酒店	{班多尔班=地理位置参数}	POI list
哥伦比亚卡塔赫纳的酒店	{哥伦比亚卡塔赫纳=地理位置参数}	POI list
丹老的酒店	{丹老=地理位置参数}	POI list
鲁汶的酒店	{鲁汶=地理位置参数}	POI list
奥尔堡的酒店	{奥尔堡=地理位置参数}	POI list
澳大利亚布里斯班的酒店	{澳大利亚布里斯班=地理位置参数}	POI list
芬兰伊纳里的酒店	{芬兰伊纳里=地理位置参数}	POI list
费特希耶的酒店	{费特希耶=地理位置参数}	POI list
马来西亚丰盛港的酒店	{马来西亚丰盛港=地理位置参数}	POI list
埃及努韦巴的酒店	{埃及努韦巴=地理位置参数}	POI list
拉斯帕尔马斯的酒店	{拉斯帕尔马斯=地理位置参数}	POI list
阿克雷里的酒店	{阿克雷里=地理位置参数}	POI list
希腊比雷埃夫斯的酒店	{希腊比雷埃夫斯=地理位置参数}	POI list
尼泊尔帕坦的酒店	{尼泊尔帕坦=地理位置参数}	POI list
比利时休伊的酒店	{比利时休伊=地理位置参数}	POI list
澳大利亚黄金海岸的酒店	{澳大利亚黄金海岸=地理位置参数}	POI list
杜马盖地的酒店	{杜马盖地=地理位置参数}	POI list
印度尼西亚库塔的酒店	{印度尼西亚库塔=地理位置参数}	POI list
孟加拉国库什蒂亚的酒店	{孟加拉国库什蒂亚=地理位置参数}	POI list
布里斯托的酒店	{布里斯托=地理位置参数}	POI list
朗布尔的酒店	{朗布尔=地理位置参数}	POI list
新加坡新加坡的酒店	{新加坡新加坡=地理位置参数}	POI list
斯里兰卡埃勒的酒店	{斯里兰卡埃勒=地理位置参数}	POI list
贝克斯菲尔德的酒店	{贝克斯菲尔德=地理位置参数}	POI list
槟城的酒店	{槟城=地理位置参数}	POI list
以色列埃拉特的酒店	{以色列埃拉特=地理位置参数}	POI list
迈泰奥拉的酒店	{迈泰奥拉=地理位置参数}	POI list
中国澎湖列岛的酒店	{中国澎湖列岛=地理位置参数}	POI list
库克群岛阿蒂乌岛的酒店	{库克群岛阿蒂乌岛=地理位置参数}	POI list
英国爱丁堡的酒店	{英国爱丁堡=地理位置参数}	POI list
希腊圣托里尼的酒店	{希腊圣托里尼=地理位置参数}	POI list
夏蒙尼的酒店	{夏蒙尼=地理位置参数}	POI list
毛里求斯毛里求斯的酒店	{毛里求斯毛里求斯=地理位置参数}	POI list
金泽的酒店	{金泽=地理位置参数}	POI list
伊尔库茨克的酒店	{伊尔库茨克=地理位置参数}	POI list
捷克克鲁姆洛夫的酒店	{捷克克鲁姆洛夫=地理位置参数}	POI list
马特勒的酒店	{马特勒=地理位置参数}	POI list
万隆的酒店	{万隆=地理位置参数}	POI list
廷布的酒店	{廷布=地理位置参数}	POI list
缅甸蒲甘的酒店	{缅甸蒲甘=地理位置参数}	POI list
莱比锡的酒店	{莱比锡=地理位置参数}	POI list
阿姆斯特丹的酒店	{阿姆斯特丹=地理位置参数}	POI list
圣卡洛斯-德巴里洛切的酒店	{圣卡洛斯-德巴里洛切=地理位置参数}	POI list
温莎市的酒店	{温莎市=地理位置参数}	POI list
爪哇岛的酒店	{爪哇岛=地理位置参数}	POI list
推荐个酒店	{}	POI list
推荐3个酒店	{3个=head}	POI list
推荐5个酒店	{5个=head}	POI list
推荐三个酒店	{三个=head}	POI list
推荐十个酒店	{十个=head}	POI list
推荐10个酒店	{10个=head}	POI list
推荐五个酒店	{五个=head}	POI list
我想住酒店	{}	POI list
距离我最近的酒店	{}	POI list
根特最热门的酒店	{根特=地理位置参数}	POI list
马德望最热门的酒店	{马德望=地理位置参数}	POI list
长滩最热门的酒店	{长滩=地理位置参数}	POI list
法国凡尔赛最热门的酒店	{法国凡尔赛=地理位置参数}	POI list
葡萄牙丰沙尔最热门的酒店	{葡萄牙丰沙尔=地理位置参数}	POI list
秘鲁特鲁希略最热门的酒店	{秘鲁特鲁希略=地理位置参数}	POI list
阿巴斯港最热门的酒店	{阿巴斯港=地理位置参数}	POI list
以色列贝尔谢巴最热门的酒店	{以色列贝尔谢巴=地理位置参数}	POI list
马赛最热门的酒店	{马赛=地理位置参数}	POI list
合艾最热门的酒店	{合艾=地理位置参数}	POI list
斯里兰卡蒂瑟默哈拉默最热门的酒店	{斯里兰卡蒂瑟默哈拉默=地理位置参数}	POI list
春武里府最热门的酒店	{春武里府=地理位置参数}	POI list
莱蒂西亚最热门的酒店	{莱蒂西亚=地理位置参数}	POI list
名古屋最热门的酒店	{名古屋=地理位置参数}	POI list
豪伊杜索博斯洛最热门的酒店	{豪伊杜索博斯洛=地理位置参数}	POI list
加拿大尼亚加拉瀑布城最热门的酒店	{加拿大尼亚加拉瀑布城=地理位置参数}	POI list
巴斯最热门的酒店	{巴斯=地理位置参数}	POI list
布达佩斯最热门的酒店	{布达佩斯=地理位置参数}	POI list
马来西亚槟城最热门的酒店	{马来西亚槟城=地理位置参数}	POI list
巴西圣路易斯最热门的酒店	{巴西圣路易斯=地理位置参数}	POI list
丹老最热门的酒店	{丹老=地理位置参数}	POI list
印度尼西亚巴厘巴板最热门的酒店	{印度尼西亚巴厘巴板=地理位置参数}	POI list
捷克俄斯特拉发最热门的酒店	{捷克俄斯特拉发=地理位置参数}	POI list
德国福森最热门的酒店	{德国福森=地理位置参数}	POI list
埃尔卡拉法特最热门的酒店	{埃尔卡拉法特=地理位置参数}	POI list
白沙瓦最热门的酒店	{白沙瓦=地理位置参数}	POI list
德国弗莱堡最热门的酒店	{德国弗莱堡=地理位置参数}	POI list
奥马鲁最热门的酒店	{奥马鲁=地理位置参数}	POI list
丹麦奥胡斯最热门的酒店	{丹麦奥胡斯=地理位置参数}	POI list
安塔利亚最热门的酒店	{安塔利亚=地理位置参数}	POI list
斯里兰卡锡吉里耶最热门的酒店	{斯里兰卡锡吉里耶=地理位置参数}	POI list
蒙特利尔最热门的酒店	{蒙特利尔=地理位置参数}	POI list
加勒最热门的酒店	{加勒=地理位置参数}	POI list
因弗卡吉尔最热门的酒店	{因弗卡吉尔=地理位置参数}	POI list
尼亚加拉瀑布城最热门的酒店	{尼亚加拉瀑布城=地理位置参数}	POI list
图卢兹最热门的酒店	{图卢兹=地理位置参数}	POI list
荷兰马斯特里赫特最热门的酒店	{荷兰马斯特里赫特=地理位置参数}	POI list
爱尔兰科克最热门的酒店	{爱尔兰科克=地理位置参数}	POI list
拉各斯最热门的酒店	{拉各斯=地理位置参数}	POI list
拉斯维加斯最热门的酒店	{拉斯维加斯=地理位置参数}	POI list
菲律宾公主港最热门的酒店	{菲律宾公主港=地理位置参数}	POI list
堪培拉最热门的酒店	{堪培拉=地理位置参数}	POI list
全州最热门的酒店	{全州=地理位置参数}	POI list
库尔纳最热门的酒店	{库尔纳=地理位置参数}	POI list
希腊奥林匹亚最热门的酒店	{希腊奥林匹亚=地理位置参数}	POI list
伯克利最热门的酒店	{伯克利=地理位置参数}	POI list
曼谷最热门的酒店	{曼谷=地理位置参数}	POI list
迪南最热门的酒店	{迪南=地理位置参数}	POI list
栋索尔最热门的酒店	{栋索尔=地理位置参数}	POI list
澳大利亚库兰达最热门的酒店	{澳大利亚库兰达=地理位置参数}	POI list
冰岛雷克雅未克最热门的酒店	{冰岛雷克雅未克=地理位置参数}	POI list
塔巴最热门的酒店	{塔巴=地理位置参数}	POI list
马尔多纳多港最热门的酒店	{马尔多纳多港=地理位置参数}	POI list
卡塔赫纳最热门的酒店	{卡塔赫纳=地理位置参数}	POI list
科尔多瓦最热门的酒店	{科尔多瓦=地理位置参数}	POI list
澳大利亚珀斯最热门的酒店	{澳大利亚珀斯=地理位置参数}	POI list
马来西亚怡保最热门的酒店	{马来西亚怡保=地理位置参数}	POI list
番红花城最热门的酒店	{番红花城=地理位置参数}	POI list
意大利米兰最热门的酒店	{意大利米兰=地理位置参数}	POI list
圣何塞最热门的酒店	{圣何塞=地理位置参数}	POI list
库比蒂诺最热门的酒店	{库比蒂诺=地理位置参数}	POI list
柬埔寨贡布最热门的酒店	{柬埔寨贡布=地理位置参数}	POI list
里昂最热门的酒店	{里昂=地理位置参数}	POI list
奥地利格蒙登最热门的酒店	{奥地利格蒙登=地理位置参数}	POI list
埃及赫尔格达最热门的酒店	{埃及赫尔格达=地理位置参数}	POI list
巴拉顿菲赖德最热门的酒店	{巴拉顿菲赖德=地理位置参数}	POI list
埃斯泰尔戈姆最热门的酒店	{埃斯泰尔戈姆=地理位置参数}	POI list
冰岛米湖最热门的酒店	{冰岛米湖=地理位置参数}	POI list
西班牙贝尼多姆最热门的酒店	{西班牙贝尼多姆=地理位置参数}	POI list
戈公最热门的酒店	{戈公=地理位置参数}	POI list
沙特利雅得最热门的酒店	{沙特利雅得=地理位置参数}	POI list
萨格里斯最热门的酒店	{萨格里斯=地理位置参数}	POI list
别府最热门的酒店	{别府=地理位置参数}	POI list
拉斯海马最热门的酒店	{拉斯海马=地理位置参数}	POI list
哥伦比亚佩雷拉最热门的酒店	{哥伦比亚佩雷拉=地理位置参数}	POI list
秘鲁马尔多纳多港最热门的酒店	{秘鲁马尔多纳多港=地理位置参数}	POI list
法国埃兹最热门的酒店	{法国埃兹=地理位置参数}	POI list
奥胡斯最热门的酒店	{奥胡斯=地理位置参数}	POI list
匈牙利黑维兹最热门的酒店	{匈牙利黑维兹=地理位置参数}	POI list
八打灵再也最热门的酒店	{八打灵再也=地理位置参数}	POI list
美国长滩最热门的酒店	{美国长滩=地理位置参数}	POI list
东枝最热门的酒店	{东枝=地理位置参数}	POI list
毛里求斯贝尔马尔最热门的酒店	{毛里求斯贝尔马尔=地理位置参数}	POI list
巴西萨尔瓦多最热门的酒店	{巴西萨尔瓦多=地理位置参数}	POI list
巴淡岛最热门的酒店	{巴淡岛=地理位置参数}	POI list
萨尔瓦多最热门的酒店	{萨尔瓦多=地理位置参数}	POI list
柬埔寨马德望最热门的酒店	{柬埔寨马德望=地理位置参数}	POI list
美国纳帕最热门的酒店	{美国纳帕=地理位置参数}	POI list
德国贝希特斯加登最热门的酒店	{德国贝希特斯加登=地理位置参数}	POI list
阿德莱德最热门的酒店	{阿德莱德=地理位置参数}	POI list
冰岛阿克雷里最热门的酒店	{冰岛阿克雷里=地理位置参数}	POI list
卡塔尼亚最热门的酒店	{卡塔尼亚=地理位置参数}	POI list
基洛夫最热门的酒店	{基洛夫=地理位置参数}	POI list
但尼丁最热门的酒店	{但尼丁=地理位置参数}	POI list
山打根最热门的酒店	{山打根=地理位置参数}	POI list
意大利巴勒莫最热门的酒店	{意大利巴勒莫=地理位置参数}	POI list
缅甸内比都最热门的酒店	{缅甸内比都=地理位置参数}	POI list
亚琛最热门的酒店	{亚琛=地理位置参数}	POI list
法国格拉斯最热门的酒店	{法国格拉斯=地理位置参数}	POI list
瑞士巴塞尔最热门的酒店	{瑞士巴塞尔=地理位置参数}	POI list
美国长滩最热门的四星级酒店	{四星级=星级, 美国长滩=地理位置参数}	POI list
卢卡最热门的三星级酒店	{三星级=星级, 卢卡=地理位置参数}	POI list
莫尔斯比港最热门的四星级酒店	{四星级=星级, 莫尔斯比港=地理位置参数}	POI list
米科诺斯岛最热门的五星级酒店	{米科诺斯岛=地理位置参数, 五星级=星级}	POI list
美国费城最热门的三星级酒店	{三星级=星级, 美国费城=地理位置参数}	POI list
比利时布鲁塞尔最热门的四星级酒店	{四星级=星级, 比利时布鲁塞尔=地理位置参数}	POI list
俄斯特拉发最热门的五星级酒店	{俄斯特拉发=地理位置参数, 五星级=星级}	POI list
智利圣地亚哥最热门的四星级酒店	{四星级=星级, 智利圣地亚哥=地理位置参数}	POI list
斐济南迪最热门的三星级酒店	{三星级=星级, 斐济南迪=地理位置参数}	POI list
伊朗库姆最热门的四星级酒店	{四星级=星级, 伊朗库姆=地理位置参数}	POI list
美国布法罗最热门的五星级酒店	{美国布法罗=地理位置参数, 五星级=星级}	POI list
斯特拉斯堡最热门的五星级酒店	{斯特拉斯堡=地理位置参数, 五星级=星级}	POI list
越南下龙湾最热门的四星级酒店	{四星级=星级, 越南下龙湾=地理位置参数}	POI list
康提最热门的四星级酒店	{四星级=星级, 康提=地理位置参数}	POI list
日本神户最热门的四星级酒店	{四星级=星级, 日本神户=地理位置参数}	POI list
美国圣克鲁斯最热门的三星级酒店	{三星级=星级, 美国圣克鲁斯=地理位置参数}	POI list
法鲁最热门的三星级酒店	{三星级=星级, 法鲁=地理位置参数}	POI list
德布勒森最热门的三星级酒店	{三星级=星级, 德布勒森=地理位置参数}	POI list
朗塞斯顿最热门的三星级酒店	{三星级=星级, 朗塞斯顿=地理位置参数}	POI list
施瓦茨最热门的四星级酒店	{四星级=星级, 施瓦茨=地理位置参数}	POI list
库塔最热门的五星级酒店	{库塔=地理位置参数, 五星级=星级}	POI list
圣克鲁斯最热门的五星级酒店	{圣克鲁斯=地理位置参数, 五星级=星级}	POI list
新西兰蒂卡普湖最热门的三星级酒店	{三星级=星级, 新西兰蒂卡普湖=地理位置参数}	POI list
巴布亚新几内亚莫尔斯比港最热门的四星级酒店	{四星级=星级, 巴布亚新几内亚莫尔斯比港=地理位置参数}	POI list
巴西圣保罗最热门的四星级酒店	{四星级=星级, 巴西圣保罗=地理位置参数}	POI list
法属波利尼西亚胡阿希内岛最热门的五星级酒店	{法属波利尼西亚胡阿希内岛=地理位置参数, 五星级=星级}	POI list
西班牙萨拉戈萨最热门的四星级酒店	{四星级=星级, 西班牙萨拉戈萨=地理位置参数}	POI list
日本北九州最热门的五星级酒店	{日本北九州=地理位置参数, 五星级=星级}	POI list
荷兰羊角村最热门的四星级酒店	{四星级=星级, 荷兰羊角村=地理位置参数}	POI list
网走最热门的五星级酒店	{网走=地理位置参数, 五星级=星级}	POI list
印度尼西亚乌布最热门的四星级酒店	{四星级=星级, 印度尼西亚乌布=地理位置参数}	POI list
芬兰凯米最热门的三星级酒店	{三星级=星级, 芬兰凯米=地理位置参数}	POI list
加拿大萨斯卡通最热门的三星级酒店	{三星级=星级, 加拿大萨斯卡通=地理位置参数}	POI list
科尔多瓦最热门的四星级酒店	{四星级=星级, 科尔多瓦=地理位置参数}	POI list
韩国春川最热门的三星级酒店	{三星级=星级, 韩国春川=地理位置参数}	POI list
塞维利亚最热门的五星级酒店	{塞维利亚=地理位置参数, 五星级=星级}	POI list
意大利威尼斯最热门的四星级酒店	{四星级=星级, 意大利威尼斯=地理位置参数}	POI list
中国嘉义最热门的四星级酒店	{四星级=星级, 中国嘉义=地理位置参数}	POI list
日本静冈最热门的四星级酒店	{日本静冈=地理位置参数, 四星级=星级}	POI list
都灵最热门的五星级酒店	{都灵=地理位置参数, 五星级=星级}	POI list
瑞士布里恩茨最热门的四星级酒店	{四星级=星级, 瑞士布里恩茨=地理位置参数}	POI list
卡法亚特最热门的三星级酒店	{三星级=星级, 卡法亚特=地理位置参数}	POI list
英国利兹最热门的五星级酒店	{英国利兹=地理位置参数, 五星级=星级}	POI list
维尔茨堡最热门的五星级酒店	{维尔茨堡=地理位置参数, 五星级=星级}	POI list
巴格达最热门的四星级酒店	{四星级=星级, 巴格达=地理位置参数}	POI list
库克群岛米蒂亚罗岛最热门的五星级酒店	{库克群岛米蒂亚罗岛=地理位置参数, 五星级=星级}	POI list
吉达最热门的五星级酒店	{吉达=地理位置参数, 五星级=星级}	POI list
埃及马特鲁最热门的四星级酒店	{四星级=星级, 埃及马特鲁=地理位置参数}	POI list
马来西亚美里最热门的四星级酒店	{四星级=星级, 马来西亚美里=地理位置参数}	POI list
博德最热门的三星级酒店	{三星级=星级, 博德=地理位置参数}	POI list
印度尼西亚泗水最热门的五星级酒店	{印度尼西亚泗水=地理位置参数, 五星级=星级}	POI list
那霸最热门的五星级酒店	{那霸=地理位置参数, 五星级=星级}	POI list
莫皮蒂岛最热门的四星级酒店	{四星级=星级, 莫皮蒂岛=地理位置参数}	POI list
巴基斯坦拉哈尔最热门的五星级酒店	{巴基斯坦拉哈尔=地理位置参数, 五星级=星级}	POI list
美国长滩最热门的五星级酒店	{美国长滩=地理位置参数, 五星级=星级}	POI list
埃斯泰尔戈姆最热门的四星级酒店	{四星级=星级, 埃斯泰尔戈姆=地理位置参数}	POI list
阿蒂乌岛最热门的五星级酒店	{阿蒂乌岛=地理位置参数, 五星级=星级}	POI list
神户最热门的五星级酒店	{神户=地理位置参数, 五星级=星级}	POI list
老挝巴色最热门的三星级酒店	{三星级=星级, 老挝巴色=地理位置参数}	POI list
吉隆坡最热门的三星级酒店	{三星级=星级, 吉隆坡=地理位置参数}	POI list
卡梅尔最热门的四星级酒店	{四星级=星级, 卡梅尔=地理位置参数}	POI list
米科诺斯岛最热门的三星级酒店	{三星级=星级, 米科诺斯岛=地理位置参数}	POI list
川崎最热门的五星级酒店	{川崎=地理位置参数, 五星级=星级}	POI list
秘鲁库斯科最热门的四星级酒店	{四星级=星级, 秘鲁库斯科=地理位置参数}	POI list
努韦巴最热门的四星级酒店	{努韦巴=地理位置参数, 四星级=星级}	POI list
贝特谢安最热门的三星级酒店	{三星级=星级, 贝特谢安=地理位置参数}	POI list
格拉茨最热门的三星级酒店	{三星级=星级, 格拉茨=地理位置参数}	POI list
瑞士温特图尔最热门的五星级酒店	{瑞士温特图尔=地理位置参数, 五星级=星级}	POI list
阿斯旺最热门的五星级酒店	{阿斯旺=地理位置参数, 五星级=星级}	POI list
瑞士卢加诺最热门的四星级酒店	{四星级=星级, 瑞士卢加诺=地理位置参数}	POI list
捷克卡罗维发利最热门的四星级酒店	{四星级=星级, 捷克卡罗维发利=地理位置参数}	POI list
意大利阿马尔菲最热门的五星级酒店	{意大利阿马尔菲=地理位置参数, 五星级=星级}	POI list
蓝毗尼最热门的四星级酒店	{四星级=星级, 蓝毗尼=地理位置参数}	POI list
新西兰汉密尔顿最热门的三星级酒店	{三星级=星级, 新西兰汉密尔顿=地理位置参数}	POI list
捷克库特纳霍拉最热门的五星级酒店	{捷克库特纳霍拉=地理位置参数, 五星级=星级}	POI list
热海最热门的三星级酒店	{三星级=星级, 热海=地理位置参数}	POI list
光州最热门的五星级酒店	{光州=地理位置参数, 五星级=星级}	POI list
秘鲁利马最热门的五星级酒店	{秘鲁利马=地理位置参数, 五星级=星级}	POI list
法属波利尼西亚莫雷阿岛最热门的四星级酒店	{四星级=星级, 法属波利尼西亚莫雷阿岛=地理位置参数}	POI list
萨拉曼卡最热门的三星级酒店	{三星级=星级, 萨拉曼卡=地理位置参数}	POI list
特隆赫姆最热门的四星级酒店	{四星级=星级, 特隆赫姆=地理位置参数}	POI list
法国图卢兹最热门的三星级酒店	{三星级=星级, 法国图卢兹=地理位置参数}	POI list
费城最热门的四星级酒店	{四星级=星级, 费城=地理位置参数}	POI list
德国波茨坦最热门的三星级酒店	{三星级=星级, 德国波茨坦=地理位置参数}	POI list
素可泰最热门的三星级酒店	{三星级=星级, 素可泰=地理位置参数}	POI list
兰达岛最热门的五星级酒店	{兰达岛=地理位置参数, 五星级=星级}	POI list
格拉斯哥最热门的五星级酒店	{格拉斯哥=地理位置参数, 五星级=星级}	POI list
捷克比尔森最热门的三星级酒店	{三星级=星级, 捷克比尔森=地理位置参数}	POI list
埃及法尤姆最热门的五星级酒店	{埃及法尤姆=地理位置参数, 五星级=星级}	POI list
瑞士日内瓦最热门的五星级酒店	{瑞士日内瓦=地理位置参数, 五星级=星级}	POI list
下龙湾最热门的四星级酒店	{四星级=星级, 下龙湾=地理位置参数}	POI list
匈牙利布达佩斯最热门的三星级酒店	{三星级=星级, 匈牙利布达佩斯=地理位置参数}	POI list
庞贝最热门的四星级酒店	{四星级=星级, 庞贝=地理位置参数}	POI list
丁格尔最热门的三星级酒店	{三星级=星级, 丁格尔=地理位置参数}	POI list
施皮茨最热门的三星级酒店	{三星级=星级, 施皮茨=地理位置参数}	POI list
卡利最热门的四星级酒店	{四星级=星级, 卡利=地理位置参数}	POI list
马洛卡帕尔马最热门的五星级酒店	{马洛卡帕尔马=地理位置参数, 五星级=星级}	POI list
伊拉克巴格达最热门的五星级酒店	{伊拉克巴格达=地理位置参数, 五星级=星级}	POI list
美瑛最热门的四星级酒店	{四星级=星级, 美瑛=地理位置参数}	POI list
韩国济州岛最热门的三星级酒店	{三星级=星级, 韩国济州岛=地理位置参数}	POI list
马来西亚八打灵再也最便宜的酒店	{马来西亚八打灵再也=地理位置参数}	POI list
沙迦最便宜的酒店	{沙迦=地理位置参数}	POI list
法国波尔多最便宜的酒店	{法国波尔多=地理位置参数}	POI list
里约热内卢最便宜的酒店	{里约热内卢=地理位置参数}	POI list
荷兰海牙最便宜的酒店	{荷兰海牙=地理位置参数}	POI list
萨能最便宜的酒店	{萨能=地理位置参数}	POI list
阿联酋富吉拉最便宜的酒店	{阿联酋富吉拉=地理位置参数}	POI list
冰岛埃伊尔斯塔济最便宜的酒店	{冰岛埃伊尔斯塔济=地理位置参数}	POI list
瑞士因特拉肯最便宜的酒店	{瑞士因特拉肯=地理位置参数}	POI list
巴基斯坦木尔坦最便宜的酒店	{巴基斯坦木尔坦=地理位置参数}	POI list
莱顿最便宜的酒店	{莱顿=地理位置参数}	POI list
哥伦比亚圣玛尔塔最便宜的酒店	{哥伦比亚圣玛尔塔=地理位置参数}	POI list
梅尔克最便宜的酒店	{梅尔克=地理位置参数}	POI list
斯里兰卡马特莱最便宜的酒店	{斯里兰卡马特莱=地理位置参数}	POI list
意大利热那亚最便宜的酒店	{意大利热那亚=地理位置参数}	POI list
圣吉米尼亚诺最便宜的酒店	{圣吉米尼亚诺=地理位置参数}	POI list
圣路易斯最便宜的酒店	{圣路易斯=地理位置参数}	POI list
蓝山最便宜的酒店	{蓝山=地理位置参数}	POI list
德国福森最便宜的酒店	{德国福森=地理位置参数}	POI list
阿雷格里港最便宜的酒店	{阿雷格里港=地理位置参数}	POI list
埼玉最便宜的酒店	{埼玉=地理位置参数}	POI list
富良野最便宜的酒店	{富良野=地理位置参数}	POI list
土耳其伊斯坦布尔最便宜的酒店	{土耳其伊斯坦布尔=地理位置参数}	POI list
挪威罗弗敦群岛最便宜的酒店	{挪威罗弗敦群岛=地理位置参数}	POI list
菲律宾薄荷岛最便宜的酒店	{菲律宾薄荷岛=地理位置参数}	POI list
列日最便宜的酒店	{列日=地理位置参数}	POI list
恩戈地最便宜的酒店	{恩戈地=地理位置参数}	POI list
特鲁希略最便宜的酒店	{特鲁希略=地理位置参数}	POI list
韦瓦克最便宜的酒店	{韦瓦克=地理位置参数}	POI list
巴布亚新几内亚拉包尔最便宜的酒店	{巴布亚新几内亚拉包尔=地理位置参数}	POI list
匈牙利黑维兹最便宜的酒店	{匈牙利黑维兹=地理位置参数}	POI list
英国南安普顿最便宜的酒店	{英国南安普顿=地理位置参数}	POI list
别府最便宜的酒店	{别府=地理位置参数}	POI list
英国格拉斯哥最便宜的酒店	{英国格拉斯哥=地理位置参数}	POI list
日本佐贺最便宜的酒店	{日本佐贺=地理位置参数}	POI list
美里最便宜的酒店	{美里=地理位置参数}	POI list
荷兰乌得勒支最便宜的酒店	{荷兰乌得勒支=地理位置参数}	POI list
伊尔库茨克最便宜的酒店	{伊尔库茨克=地理位置参数}	POI list
圣塔芭芭拉最便宜的酒店	{圣塔芭芭拉=地理位置参数}	POI list
甲米最便宜的酒店	{甲米=地理位置参数}	POI list
黑维兹最便宜的酒店	{黑维兹=地理位置参数}	POI list
瑞士蒙特勒最便宜的酒店	{瑞士蒙特勒=地理位置参数}	POI list
巴德岗最便宜的酒店	{巴德岗=地理位置参数}	POI list
日本洞爷湖最便宜的酒店	{日本洞爷湖=地理位置参数}	POI list
中国台中最便宜的酒店	{中国台中=地理位置参数}	POI list
中国垦丁最便宜的酒店	{中国垦丁=地理位置参数}	POI list
印度尼西亚金巴兰最便宜的酒店	{印度尼西亚金巴兰=地理位置参数}	POI list
西班牙拉斯帕尔马斯最便宜的酒店	{西班牙拉斯帕尔马斯=地理位置参数}	POI list
斯里兰卡本托特最便宜的酒店	{斯里兰卡本托特=地理位置参数}	POI list
孟加拉国库什蒂亚最便宜的酒店	{孟加拉国库什蒂亚=地理位置参数}	POI list
中国彰化最便宜的酒店	{中国彰化=地理位置参数}	POI list
荷兰鲁尔蒙德最便宜的酒店	{荷兰鲁尔蒙德=地理位置参数}	POI list
埃及卢克索最便宜的酒店	{埃及卢克索=地理位置参数}	POI list
仁川最便宜的酒店	{仁川=地理位置参数}	POI list
高山最便宜的酒店	{高山=地理位置参数}	POI list
挪威特罗姆瑟最便宜的酒店	{挪威特罗姆瑟=地理位置参数}	POI list
门迪最便宜的酒店	{门迪=地理位置参数}	POI list
奥兰多最便宜的酒店	{奥兰多=地理位置参数}	POI list
奥基最便宜的酒店	{奥基=地理位置参数}	POI list
阿根廷卡法亚特最便宜的酒店	{阿根廷卡法亚特=地理位置参数}	POI list
日本神户最便宜的酒店	{日本神户=地理位置参数}	POI list
戈罗卡最便宜的酒店	{戈罗卡=地理位置参数}	POI list
澳大利亚堪培拉最便宜的酒店	{澳大利亚堪培拉=地理位置参数}	POI list
帕罗最便宜的酒店	{帕罗=地理位置参数}	POI list
五渔村最便宜的酒店	{五渔村=地理位置参数}	POI list
土耳其费特希耶最便宜的酒店	{土耳其费特希耶=地理位置参数}	POI list
高松最便宜的酒店	{高松=地理位置参数}	POI list
意大利维罗纳最便宜的酒店	{意大利维罗纳=地理位置参数}	POI list
艾图塔基最便宜的酒店	{艾图塔基=地理位置参数}	POI list
赖扬最便宜的酒店	{赖扬=地理位置参数}	POI list
中国澳门最便宜的酒店	{中国澳门=地理位置参数}	POI list
美国芝加哥最便宜的酒店	{美国芝加哥=地理位置参数}	POI list
捷克克鲁姆洛夫最便宜的酒店	{捷克克鲁姆洛夫=地理位置参数}	POI list
卡法亚特最便宜的酒店	{卡法亚特=地理位置参数}	POI list
美国圣路易奥比斯波最便宜的酒店	{美国圣路易奥比斯波=地理位置参数}	POI list
韩国天安市最便宜的酒店	{韩国天安市=地理位置参数}	POI list
卡塔尔豪尔最便宜的酒店	{卡塔尔豪尔=地理位置参数}	POI list
哥伦比亚亚美尼亚城最便宜的酒店	{哥伦比亚亚美尼亚城=地理位置参数}	POI list
韩国安东最便宜的酒店	{韩国安东=地理位置参数}	POI list
俄罗斯喀山最便宜的酒店	{俄罗斯喀山=地理位置参数}	POI list
福森最便宜的酒店	{福森=地理位置参数}	POI list
库克群岛阿蒂乌岛最便宜的酒店	{库克群岛阿蒂乌岛=地理位置参数}	POI list
泰国帕岸岛最便宜的酒店	{泰国帕岸岛=地理位置参数}	POI list
中国台东最便宜的酒店	{中国台东=地理位置参数}	POI list
金海市最便宜的酒店	{金海市=地理位置参数}	POI list
希腊德尔斐最便宜的酒店	{希腊德尔斐=地理位置参数}	POI list
日本知床半岛最便宜的酒店	{日本知床半岛=地理位置参数}	POI list
温莎市最便宜的酒店	{温莎市=地理位置参数}	POI list
阿雷基帕最便宜的酒店	{阿雷基帕=地理位置参数}	POI list
埃及法尤姆最便宜的酒店	{埃及法尤姆=地理位置参数}	POI list
法国夏蒙尼最便宜的酒店	{法国夏蒙尼=地理位置参数}	POI list
圣彼得堡最便宜的酒店	{圣彼得堡=地理位置参数}	POI list
基拉尼最便宜的酒店	{基拉尼=地理位置参数}	POI list
新西兰皇后镇最便宜的酒店	{新西兰皇后镇=地理位置参数}	POI list
巴西纳塔尔最便宜的酒店	{巴西纳塔尔=地理位置参数}	POI list
越南下龙湾最便宜的酒店	{越南下龙湾=地理位置参数}	POI list
维罗纳最便宜的酒店	{维罗纳=地理位置参数}	POI list
道格拉斯港最便宜的酒店	{道格拉斯港=地理位置参数}	POI list
阿布扎比最便宜的酒店	{阿布扎比=地理位置参数}	POI list
爱尔兰科克最便宜的酒店	{爱尔兰科克=地理位置参数}	POI list
孟加拉国库尔纳最便宜的酒店是哪个	{孟加拉国库尔纳=地理位置参数}	POI list
长崎最便宜的酒店是哪个	{长崎=地理位置参数}	POI list
冲绳最便宜的酒店是哪个	{冲绳=地理位置参数}	POI list
戛纳最便宜的酒店是哪个	{戛纳=地理位置参数}	POI list
葡萄牙维亚纳堡最便宜的酒店是哪个	{葡萄牙维亚纳堡=地理位置参数}	POI list
爱尔兰利默里克最便宜的酒店是哪个	{爱尔兰利默里克=地理位置参数}	POI list
菲律宾锡基霍尔最便宜的酒店是哪个	{菲律宾锡基霍尔=地理位置参数}	POI list
比利时布鲁日最便宜的酒店是哪个	{比利时布鲁日=地理位置参数}	POI list
荷兰埃因霍温最便宜的酒店是哪个	{荷兰埃因霍温=地理位置参数}	POI list
弗莱堡最便宜的酒店是哪个	{弗莱堡=地理位置参数}	POI list
希腊奥林匹亚最便宜的酒店是哪个	{希腊奥林匹亚=地理位置参数}	POI list
荷兰兹沃勒最便宜的酒店是哪个	{荷兰兹沃勒=地理位置参数}	POI list
中国高雄最便宜的酒店是哪个	{中国高雄=地理位置参数}	POI list
泰国攀牙最便宜的酒店是哪个	{泰国攀牙=地理位置参数}	POI list
阿比斯库最便宜的酒店是哪个	{阿比斯库=地理位置参数}	POI list
澳大利亚朗塞斯顿最便宜的酒店是哪个	{澳大利亚朗塞斯顿=地理位置参数}	POI list
马来西亚美里最便宜的酒店是哪个	{马来西亚美里=地理位置参数}	POI list
卡尔加里最便宜的酒店是哪个	{卡尔加里=地理位置参数}	POI list
阿拉梅达最便宜的酒店是哪个	{阿拉梅达=地理位置参数}	POI list
库克群岛米蒂亚罗岛最便宜的酒店是哪个	{库克群岛米蒂亚罗岛=地理位置参数}	POI list
库克群岛拉罗汤加岛最便宜的酒店是哪个	{库克群岛拉罗汤加岛=地理位置参数}	POI list
瑞士贝特默阿尔卑最便宜的酒店是哪个	{瑞士贝特默阿尔卑=地理位置参数}	POI list
马来西亚山打根最便宜的酒店是哪个	{马来西亚山打根=地理位置参数}	POI list
西班牙圣塞瓦斯蒂安最便宜的酒店是哪个	{西班牙圣塞瓦斯蒂安=地理位置参数}	POI list
芬兰罗瓦涅米最便宜的酒店是哪个	{芬兰罗瓦涅米=地理位置参数}	POI list
俄罗斯弗拉基米尔最便宜的酒店是哪个	{俄罗斯弗拉基米尔=地理位置参数}	POI list
纽卡斯尔最便宜的酒店是哪个	{纽卡斯尔=地理位置参数}	POI list
巴淡岛最便宜的酒店是哪个	{巴淡岛=地理位置参数}	POI list
波茨坦最便宜的酒店是哪个	{波茨坦=地理位置参数}	POI list
佐贺最便宜的酒店是哪个	{佐贺=地理位置参数}	POI list
罗什平纳最便宜的酒店是哪个	{罗什平纳=地理位置参数}	POI list
万象最便宜的酒店是哪个	{万象=地理位置参数}	POI list
卢克索最便宜的酒店是哪个	{卢克索=地理位置参数}	POI list
加拿大哈利法克斯最便宜的酒店是哪个	{加拿大哈利法克斯=地理位置参数}	POI list
伊拉克苏莱曼尼亚最便宜的酒店是哪个	{伊拉克苏莱曼尼亚=地理位置参数}	POI list
佩雷拉最便宜的酒店是哪个	{佩雷拉=地理位置参数}	POI list
印度尼西亚巴淡岛最便宜的酒店是哪个	{印度尼西亚巴淡岛=地理位置参数}	POI list
丹麦哥本哈根最便宜的酒店是哪个	{丹麦哥本哈根=地理位置参数}	POI list
巴哈马拿骚最便宜的酒店是哪个	{巴哈马拿骚=地理位置参数}	POI list
菲律宾安吉利斯最便宜的酒店是哪个	{菲律宾安吉利斯=地理位置参数}	POI list
大阪最便宜的酒店是哪个	{大阪=地理位置参数}	POI list
卢戈最便宜的酒店是哪个	{卢戈=地理位置参数}	POI list
英国伦敦最便宜的酒店是哪个	{英国伦敦=地理位置参数}	POI list
沃韦最便宜的酒店是哪个	{沃韦=地理位置参数}	POI list
凯夫拉维克最便宜的酒店是哪个	{凯夫拉维克=地理位置参数}	POI list
日本长崎最便宜的酒店是哪个	{日本长崎=地理位置参数}	POI list
巴西巴西利亚最便宜的酒店是哪个	{巴西巴西利亚=地理位置参数}	POI list
卡罗维发利最便宜的酒店是哪个	{卡罗维发利=地理位置参数}	POI list
泰国曼谷最便宜的酒店是哪个	{泰国曼谷=地理位置参数}	POI list
捷克库特纳霍拉最便宜的酒店是哪个	{捷克库特纳霍拉=地理位置参数}	POI list
库特纳霍拉最便宜的酒店是哪个	{库特纳霍拉=地理位置参数}	POI list
新西兰箭镇最便宜的酒店是哪个	{新西兰箭镇=地理位置参数}	POI list
拉斯维加斯最便宜的酒店是哪个	{拉斯维加斯=地理位置参数}	POI list
华欣最便宜的酒店是哪个	{华欣=地理位置参数}	POI list
木尔坦最便宜的酒店是哪个	{木尔坦=地理位置参数}	POI list
首尔最便宜的酒店是哪个	{首尔=地理位置参数}	POI list
法国圣马洛最便宜的酒店是哪个	{法国圣马洛=地理位置参数}	POI list
奥林匹亚最便宜的酒店是哪个	{奥林匹亚=地理位置参数}	POI list
南极洲南设得兰群岛最便宜的酒店是哪个	{南极洲南设得兰群岛=地理位置参数}	POI list
阿威罗最便宜的酒店是哪个	{阿威罗=地理位置参数}	POI list
泰国北碧府最便宜的酒店是哪个	{泰国北碧府=地理位置参数}	POI list
采法特最便宜的酒店是哪个	{采法特=地理位置参数}	POI list
意大利佛罗伦萨最便宜的酒店是哪个	{意大利佛罗伦萨=地理位置参数}	POI list
不丹布姆唐最便宜的酒店是哪个	{不丹布姆唐=地理位置参数}	POI list
日光最便宜的酒店是哪个	{日光=地理位置参数}	POI list
吴哥窟最便宜的酒店是哪个	{吴哥窟=地理位置参数}	POI list
江陵最便宜的酒店是哪个	{江陵=地理位置参数}	POI list
澳大利亚爱丽丝泉最便宜的酒店是哪个	{澳大利亚爱丽丝泉=地理位置参数}	POI list
黎牙实比最便宜的酒店是哪个	{黎牙实比=地理位置参数}	POI list
泰国兰达岛最便宜的酒店是哪个	{泰国兰达岛=地理位置参数}	POI list
哥伦比亚佩雷拉最便宜的酒店是哪个	{哥伦比亚佩雷拉=地理位置参数}	POI list
美国西雅图最便宜的酒店是哪个	{美国西雅图=地理位置参数}	POI list
菲律宾达沃最便宜的酒店是哪个	{菲律宾达沃=地理位置参数}	POI list
德黑兰最便宜的酒店是哪个	{德黑兰=地理位置参数}	POI list
美国阿纳海姆最便宜的酒店是哪个	{美国阿纳海姆=地理位置参数}	POI list
韩国原州市最便宜的酒店是哪个	{韩国原州市=地理位置参数}	POI list
耶路撒冷最便宜的酒店是哪个	{耶路撒冷=地理位置参数}	POI list
德国波茨坦最便宜的酒店是哪个	{德国波茨坦=地理位置参数}	POI list
越南美奈最便宜的酒店是哪个	{越南美奈=地理位置参数}	POI list
西班牙贝尼多姆最便宜的酒店是哪个	{西班牙贝尼多姆=地理位置参数}	POI list
比利时迪南最便宜的酒店是哪个	{比利时迪南=地理位置参数}	POI list
肯尼亚内罗毕最便宜的酒店是哪个	{肯尼亚内罗毕=地理位置参数}	POI list
葡萄牙吉马良斯最便宜的酒店是哪个	{葡萄牙吉马良斯=地理位置参数}	POI list
匈牙利埃格尔最便宜的酒店是哪个	{匈牙利埃格尔=地理位置参数}	POI list
新西兰格林诺奇最便宜的酒店是哪个	{新西兰格林诺奇=地理位置参数}	POI list
印度尼西亚蓝梦岛最便宜的酒店是哪个	{印度尼西亚蓝梦岛=地理位置参数}	POI list
伊朗卡尚最便宜的酒店是哪个	{伊朗卡尚=地理位置参数}	POI list
小樽最便宜的酒店是哪个	{小樽=地理位置参数}	POI list
弗里堡最便宜的酒店是哪个	{弗里堡=地理位置参数}	POI list
马当最便宜的酒店是哪个	{马当=地理位置参数}	POI list
罗托鲁瓦最便宜的酒店是哪个	{罗托鲁瓦=地理位置参数}	POI list
日本川崎最便宜的酒店是哪个	{日本川崎=地理位置参数}	POI list
拉哈尔最便宜的酒店是哪个	{拉哈尔=地理位置参数}	POI list
冰岛雷克雅未克最便宜的酒店是哪个	{冰岛雷克雅未克=地理位置参数}	POI list
比隆最便宜的酒店是哪个	{比隆=地理位置参数}	POI list
达卡最便宜的酒店是哪个	{达卡=地理位置参数}	POI list
鲁尔蒙德最便宜的酒店是哪个	{鲁尔蒙德=地理位置参数}	POI list
爱尔兰基尔根尼最便宜的酒店是哪个	{爱尔兰基尔根尼=地理位置参数}	POI list
柬埔寨贡布最便宜的酒店是哪个	{柬埔寨贡布=地理位置参数}	POI list
菲律宾栋索尔最便宜的酒店是哪个	{菲律宾栋索尔=地理位置参数}	POI list
希腊圣托里尼住哪里最便宜	{希腊圣托里尼=地理位置参数}	POI list
富吉拉住哪里最便宜	{富吉拉=地理位置参数}	POI list
江陵住哪里最便宜	{江陵=地理位置参数}	POI list
夜功府住哪里最便宜	{夜功府=地理位置参数}	POI list
丹布勒住哪里最便宜	{丹布勒=地理位置参数}	POI list
冰岛阿克雷里住哪里最便宜	{冰岛阿克雷里=地理位置参数}	POI list
科克斯巴扎尔住哪里最便宜	{科克斯巴扎尔=地理位置参数}	POI list
普纳奥亚住哪里最便宜	{普纳奥亚=地理位置参数}	POI list
格林德瓦住哪里最便宜	{格林德瓦=地理位置参数}	POI list
瑞典马尔默住哪里最便宜	{瑞典马尔默=地理位置参数}	POI list
埃及塔巴住哪里最便宜	{埃及塔巴=地理位置参数}	POI list
沙巴住哪里最便宜	{沙巴=地理位置参数}	POI list
锡耶纳住哪里最便宜	{锡耶纳=地理位置参数}	POI list
印度尼西亚万鸦老住哪里最便宜	{印度尼西亚万鸦老=地理位置参数}	POI list
乌鲁班巴住哪里最便宜	{乌鲁班巴=地理位置参数}	POI list
艾恩住哪里最便宜	{艾恩=地理位置参数}	POI list
日本富士山住哪里最便宜	{日本富士山=地理位置参数}	POI list
菲律宾维甘住哪里最便宜	{菲律宾维甘=地理位置参数}	POI list
万荣住哪里最便宜	{万荣=地理位置参数}	POI list
韩国仁川住哪里最便宜	{韩国仁川=地理位置参数}	POI list
高松住哪里最便宜	{高松=地理位置参数}	POI list
丰沙湾住哪里最便宜	{丰沙湾=地理位置参数}	POI list
蓝毗尼住哪里最便宜	{蓝毗尼=地理位置参数}	POI list
阿根廷门多萨住哪里最便宜	{阿根廷门多萨=地理位置参数}	POI list
福冈住哪里最便宜	{福冈=地理位置参数}	POI list
希腊罗得岛住哪里最便宜	{希腊罗得岛=地理位置参数}	POI list
巴西巴西利亚住哪里最便宜	{巴西巴西利亚=地理位置参数}	POI list
越南潘切市住哪里最便宜	{越南潘切市=地理位置参数}	POI list
加勒住哪里最便宜	{加勒=地理位置参数}	POI list
美国檀香山住哪里最便宜	{美国檀香山=地理位置参数}	POI list
爱丁堡住哪里最便宜	{爱丁堡=地理位置参数}	POI list
埃及马特鲁住哪里最便宜	{埃及马特鲁=地理位置参数}	POI list
维亚纳堡住哪里最便宜	{维亚纳堡=地理位置参数}	POI list
拉斯佩齐亚住哪里最便宜	{拉斯佩齐亚=地理位置参数}	POI list
皮克顿住哪里最便宜	{皮克顿=地理位置参数}	POI list
加拿大基洛纳住哪里最便宜	{加拿大基洛纳=地理位置参数}	POI list
日本网走住哪里最便宜	{日本网走=地理位置参数}	POI list
扎金索斯住哪里最便宜	{扎金索斯=地理位置参数}	POI list
花莲住哪里最便宜	{花莲=地理位置参数}	POI list
巴布亚新几内亚门迪住哪里最便宜	{巴布亚新几内亚门迪=地理位置参数}	POI list
图恩住哪里最便宜	{图恩=地理位置参数}	POI list
毛里求斯贝尔马尔住哪里最便宜	{毛里求斯贝尔马尔=地理位置参数}	POI list
西班牙贝尼多姆住哪里最便宜	{西班牙贝尼多姆=地理位置参数}	POI list
荷兰兹沃勒住哪里最便宜	{荷兰兹沃勒=地理位置参数}	POI list
法国尼斯住哪里最便宜	{法国尼斯=地理位置参数}	POI list
麦加住哪里最便宜	{麦加=地理位置参数}	POI list
中国北京住哪里最便宜	{中国北京=地理位置参数}	POI list
斯里兰卡美蕊沙住哪里最便宜	{斯里兰卡美蕊沙=地理位置参数}	POI list
里约热内卢住哪里最便宜	{里约热内卢=地理位置参数}	POI list
巴塔利亚住哪里最便宜	{巴塔利亚=地理位置参数}	POI list
老挝北宾住哪里最便宜	{老挝北宾=地理位置参数}	POI list
凡尔赛住哪里最便宜	{凡尔赛=地理位置参数}	POI list
越南下龙湾住哪里最便宜	{越南下龙湾=地理位置参数}	POI list
塞萨洛尼基住哪里最便宜	{塞萨洛尼基=地理位置参数}	POI list
伊朗亚兹德住哪里最便宜	{伊朗亚兹德=地理位置参数}	POI list
瑞典斯德哥尔摩住哪里最便宜	{瑞典斯德哥尔摩=地理位置参数}	POI list
瑞士格林德瓦住哪里最便宜	{瑞士格林德瓦=地理位置参数}	POI list
缅甸丹老住哪里最便宜	{缅甸丹老=地理位置参数}	POI list
美里住哪里最便宜	{美里=地理位置参数}	POI list
苏梅岛住哪里最便宜	{苏梅岛=地理位置参数}	POI list
巴西里约热内卢住哪里最便宜	{巴西里约热内卢=地理位置参数}	POI list
宜兰住哪里最便宜	{宜兰=地理位置参数}	POI list
韩国安东住哪里最便宜	{韩国安东=地理位置参数}	POI list
法国南特住哪里最便宜	{法国南特=地理位置参数}	POI list
丰盛港住哪里最便宜	{丰盛港=地理位置参数}	POI list
岘港住哪里最便宜	{岘港=地理位置参数}	POI list
库尔纳住哪里最便宜	{库尔纳=地理位置参数}	POI list
意大利卢卡住哪里最便宜	{意大利卢卡=地理位置参数}	POI list
俄罗斯喀山住哪里最便宜	{俄罗斯喀山=地理位置参数}	POI list
圣托里尼住哪里最便宜	{圣托里尼=地理位置参数}	POI list
澳大利亚黄金海岸住哪里最便宜	{澳大利亚黄金海岸=地理位置参数}	POI list
枫丹白露住哪里最便宜	{枫丹白露=地理位置参数}	POI list
以色列里雄莱锡安住哪里最便宜	{以色列里雄莱锡安=地理位置参数}	POI list
横滨住哪里最便宜	{横滨=地理位置参数}	POI list
美国纽约住哪里最便宜	{美国纽约=地理位置参数}	POI list
斯卡恩住哪里最便宜	{斯卡恩=地理位置参数}	POI list
韩国龙仁市住哪里最便宜	{韩国龙仁市=地理位置参数}	POI list
海参崴住哪里最便宜	{海参崴=地理位置参数}	POI list
俄罗斯弗拉基米尔住哪里最便宜	{俄罗斯弗拉基米尔=地理位置参数}	POI list
伊瓜苏港住哪里最便宜	{伊瓜苏港=地理位置参数}	POI list
匈牙利维谢格拉德住哪里最便宜	{匈牙利维谢格拉德=地理位置参数}	POI list
马来西亚马六甲住哪里最便宜	{马来西亚马六甲=地理位置参数}	POI list
长崎住哪里最便宜	{长崎=地理位置参数}	POI list
马来西亚瓜拉登嘉楼住哪里最便宜	{马来西亚瓜拉登嘉楼=地理位置参数}	POI list
伊尔库茨克住哪里最便宜	{伊尔库茨克=地理位置参数}	POI list
安塔利亚住哪里最便宜	{安塔利亚=地理位置参数}	POI list
日本千叶市住哪里最便宜	{日本千叶市=地理位置参数}	POI list
仙本那住哪里最便宜	{仙本那=地理位置参数}	POI list
意大利巴勒莫住哪里最便宜	{意大利巴勒莫=地理位置参数}	POI list
梅尔克住哪里最便宜	{梅尔克=地理位置参数}	POI list
泰国攀牙住哪里最便宜	{泰国攀牙=地理位置参数}	POI list
费城住哪里最便宜	{费城=地理位置参数}	POI list
斯里兰卡蒂瑟默哈拉默住哪里最便宜	{斯里兰卡蒂瑟默哈拉默=地理位置参数}	POI list
斯里兰卡加勒住哪里最便宜	{斯里兰卡加勒=地理位置参数}	POI list
南极洲南设得兰群岛住哪里最便宜	{南极洲南设得兰群岛=地理位置参数}	POI list
埃及卢克索住哪里最便宜	{埃及卢克索=地理位置参数}	POI list
贾夫纳住哪里最便宜	{贾夫纳=地理位置参数}	POI list
葡萄牙波尔图住哪里最便宜	{葡萄牙波尔图=地理位置参数}	POI list
达尔文住哪里最便宜	{达尔文=地理位置参数}	POI list
印度尼西亚库塔住哪里最便宜	{印度尼西亚库塔=地理位置参数}	POI list
最便宜的酒店在瓦伊塔佩哪里	{瓦伊塔佩=地区国家城市}	POI list
最便宜的酒店在阿维拉哪里	{阿维拉=地区国家城市}	POI list
最便宜的酒店在凯萨莉亚哪里	{凯萨莉亚=地区国家城市}	POI list
最便宜的酒店在比利时哪里	{比利时=地区国家城市}	POI list
最便宜的酒店在腓特烈港哪里	{腓特烈港=地区国家城市}	POI list
最便宜的酒店在卡尔维亚哪里	{卡尔维亚=地区国家城市}	POI list
最便宜的酒店在摩苏尔哪里	{摩苏尔=地区国家城市}	POI list
最便宜的酒店在蒙特利尔哪里	{蒙特利尔=地区国家城市}	POI list
最便宜的酒店在福伦丹哪里	{福伦丹=地区国家城市}	POI list
最便宜的酒店在古晋哪里	{古晋=地区国家城市}	POI list
最便宜的酒店在巴厘巴板哪里	{巴厘巴板=地区国家城市}	POI list
最便宜的酒店在卡法亚特哪里	{卡法亚特=地区国家城市}	POI list
最便宜的酒店在金门哪里	{金门=地区国家城市}	POI list
最便宜的酒店在云林哪里	{云林=地区国家城市}	POI list
最便宜的酒店在维谢格拉德哪里	{维谢格拉德=地区国家城市}	POI list
最便宜的酒店在米湖哪里	{米湖=地区国家城市}	POI list
最便宜的酒店在芒特哈根哪里	{芒特哈根=地区国家城市}	POI list
最便宜的酒店在阿努拉德普勒哪里	{阿努拉德普勒=地区国家城市}	POI list
最便宜的酒店在富川哪里	{富川=地区国家城市}	POI list
最便宜的酒店在塞哥维亚哪里	{塞哥维亚=地区国家城市}	POI list
最便宜的酒店在西哈努克哪里	{西哈努克=地区国家城市}	POI list
最便宜的酒店在温尼伯哪里	{温尼伯=地区国家城市}	POI list
最便宜的酒店在那霸哪里	{那霸=地区国家城市}	POI list
最便宜的酒店在忠州哪里	{忠州=地区国家城市}	POI list
最便宜的酒店在塞班哪里	{塞班=地区国家城市}	POI list
最便宜的酒店在凯夫拉维克哪里	{凯夫拉维克=地区国家城市}	POI list
最便宜的酒店在库比蒂诺哪里	{库比蒂诺=地区国家城市}	POI list
最便宜的酒店在布雷哪里	{布雷=地区国家城市}	POI list
最便宜的酒店在兰达岛哪里	{兰达岛=地区国家城市}	POI list
最便宜的酒店在琅南塔哪里	{琅南塔=地区国家城市}	POI list
最便宜的酒店在玛琅哪里	{玛琅=地区国家城市}	POI list
最便宜的酒店在庞贝哪里	{庞贝=地区国家城市}	POI list
最便宜的酒店在董里哪里	{董里=地区国家城市}	POI list
最便宜的酒店在波士顿哪里	{波士顿=地区国家城市}	POI list
最便宜的酒店在卡塔赫纳哪里	{卡塔赫纳=地区国家城市}	POI list
最便宜的酒店在利物浦哪里	{利物浦=地区国家城市}	POI list
最便宜的酒店在达沃斯哪里	{达沃斯=地区国家城市}	POI list
最便宜的酒店在加拿大哪里	{加拿大=地区国家城市}	POI list
最便宜的酒店在蒙特雷哪里	{蒙特雷=地区国家城市}	POI list
最便宜的酒店在滑铁卢哪里	{滑铁卢=地区国家城市}	POI list
最便宜的酒店在依云哪里	{依云=地区国家城市}	POI list
最便宜的酒店在安吉利斯哪里	{安吉利斯=地区国家城市}	POI list
最便宜的酒店在新不列颠岛哪里	{新不列颠岛=地区国家城市}	POI list
最便宜的酒店在阿姆斯特丹哪里	{阿姆斯特丹=地区国家城市}	POI list
最便宜的酒店在沙巴哪里	{沙巴=地区国家城市}	POI list
最便宜的酒店在沙湾拿吉哪里	{沙湾拿吉=地区国家城市}	POI list
最便宜的酒店在毕尔巴鄂哪里	{毕尔巴鄂=地区国家城市}	POI list
最便宜的酒店在雅加达哪里	{雅加达=地区国家城市}	POI list
最便宜的酒店在仰光哪里	{仰光=地区国家城市}	POI list
最便宜的酒店在木浦市哪里	{木浦市=地区国家城市}	POI list
最便宜的酒店在萨拉曼卡哪里	{萨拉曼卡=地区国家城市}	POI list
最便宜的酒店在伊兹密尔哪里	{伊兹密尔=地区国家城市}	POI list
最便宜的酒店在宜兰哪里	{宜兰=地区国家城市}	POI list
最便宜的酒店在布里斯班哪里	{布里斯班=地区国家城市}	POI list
最便宜的酒店在会晒哪里	{会晒=地区国家城市}	POI list
最便宜的酒店在金边哪里	{金边=地区国家城市}	POI list
最便宜的酒店在和歌山哪里	{和歌山=地区国家城市}	POI list
最便宜的酒店在吉隆坡哪里	{吉隆坡=地区国家城市}	POI list
最便宜的酒店在贝尼多姆哪里	{贝尼多姆=地区国家城市}	POI list
最便宜的酒店在新北哪里	{新北=地区国家城市}	POI list
最便宜的酒店在基洛夫哪里	{基洛夫=地区国家城市}	POI list
最便宜的酒店在波恩哪里	{波恩=地区国家城市}	POI list
最便宜的酒店在塞维利亚哪里	{塞维利亚=地区国家城市}	POI list
最便宜的酒店在蒂卡普湖哪里	{蒂卡普湖=地区国家城市}	POI list
最便宜的酒店在毛里求斯哪里	{毛里求斯=地区国家城市}	POI list
最便宜的酒店在合艾哪里	{合艾=地区国家城市}	POI list
最便宜的酒店在伊斯坦布尔哪里	{伊斯坦布尔=地区国家城市}	POI list
最便宜的酒店在台中哪里	{台中=地区国家城市}	POI list
最便宜的酒店在维克哪里	{维克=地区国家城市}	POI list
最便宜的酒店在特拉维夫哪里	{特拉维夫=地区国家城市}	POI list
最便宜的酒店在眉谬哪里	{眉谬=地区国家城市}	POI list
最便宜的酒店在安东哪里	{安东=地区国家城市}	POI list
最便宜的酒店在伊萨菲厄泽哪里	{伊萨菲厄泽=地区国家城市}	POI list
最便宜的酒店在马六甲哪里	{马六甲=地区国家城市}	POI list
最便宜的酒店在巴德伊舍哪里	{巴德伊舍=地区国家城市}	POI list
最便宜的酒店在亚兹德哪里	{亚兹德=地区国家城市}	POI list
最便宜的酒店在吉佐哪里	{吉佐=地区国家城市}	POI list
最便宜的酒店在巴塞卢什哪里	{巴塞卢什=地区国家城市}	POI list
最便宜的酒店在热浪岛哪里	{热浪岛=地区国家城市}	POI list
最便宜的酒店在阿马尔菲哪里	{阿马尔菲=地区国家城市}	POI list
最便宜的酒店在阿雷格里港哪里	{阿雷格里港=地区国家城市}	POI list
最便宜的酒店在棕榈泉哪里	{棕榈泉=地区国家城市}	POI list
最便宜的酒店在伊豆哪里	{伊豆=地区国家城市}	POI list
最便宜的酒店在卧龙岗哪里	{卧龙岗=地区国家城市}	POI list
最便宜的酒店在圣保罗哪里	{圣保罗=地区国家城市}	POI list
最便宜的酒店在马卡蒂哪里	{马卡蒂=地区国家城市}	POI list
最便宜的酒店在厄勒布鲁哪里	{厄勒布鲁=地区国家城市}	POI list
最便宜的酒店在赫尔辛基哪里	{赫尔辛基=地区国家城市}	POI list
最便宜的酒店在阿拉梅达哪里	{阿拉梅达=地区国家城市}	POI list
最便宜的酒店在延雪平哪里	{延雪平=地区国家城市}	POI list
最便宜的酒店在宇治哪里	{宇治=地区国家城市}	POI list
最便宜的酒店在霍尼亚拉哪里	{霍尼亚拉=地区国家城市}	POI list
最便宜的酒店在科克哪里	{科克=地区国家城市}	POI list
最便宜的酒店在阿巴斯港哪里	{阿巴斯港=地区国家城市}	POI list
最便宜的酒店在巴塔利亚哪里	{巴塔利亚=地区国家城市}	POI list
最便宜的酒店在苏莱曼尼亚哪里	{苏莱曼尼亚=地区国家城市}	POI list
最便宜的酒店在安特卫普哪里	{安特卫普=地区国家城市}	POI list
最便宜的酒店在拿骚哪里	{拿骚=地区国家城市}	POI list
最便宜的酒店在仙本那哪里	{仙本那=地区国家城市}	POI list
最便宜的酒店在老挝哪里	{老挝=地区国家城市}	POI list
贾夫纳最便宜的四星级酒店	{四星级=星级, 贾夫纳=地理位置参数}	POI list
意大利西西里岛最便宜的三星级酒店	{三星级=星级, 意大利西西里岛=地理位置参数}	POI list
以色列贝特谢安最便宜的四星级酒店	{四星级=星级, 以色列贝特谢安=地理位置参数}	POI list
马来西亚古晋最便宜的三星级酒店	{三星级=星级, 马来西亚古晋=地理位置参数}	POI list
泰国大城最便宜的四星级酒店	{四星级=星级, 泰国大城=地理位置参数}	POI list
瑞士沙夫豪森最便宜的三星级酒店	{三星级=星级, 瑞士沙夫豪森=地理位置参数}	POI list
斯米兰群岛最便宜的四星级酒店	{四星级=星级, 斯米兰群岛=地理位置参数}	POI list
斯里兰卡乌纳瓦图纳最便宜的三星级酒店	{三星级=星级, 斯里兰卡乌纳瓦图纳=地理位置参数}	POI list
葡萄牙奥比都斯最便宜的四星级酒店	{葡萄牙奥比都斯=地理位置参数, 四星级=星级}	POI list
西班牙马拉加最便宜的五星级酒店	{西班牙马拉加=地理位置参数, 五星级=星级}	POI list
勃固最便宜的四星级酒店	{四星级=星级, 勃固=地理位置参数}	POI list
巴西里约热内卢最便宜的四星级酒店	{四星级=星级, 巴西里约热内卢=地理位置参数}	POI list
葡萄牙里斯本最便宜的五星级酒店	{葡萄牙里斯本=地理位置参数, 五星级=星级}	POI list
奥比都斯最便宜的四星级酒店	{四星级=星级, 奥比都斯=地理位置参数}	POI list
以色列米茨佩拉蒙最便宜的三星级酒店	{三星级=星级, 以色列米茨佩拉蒙=地理位置参数}	POI list
尔湾最便宜的四星级酒店	{尔湾=地理位置参数, 四星级=星级}	POI list
名古屋最便宜的三星级酒店	{三星级=星级, 名古屋=地理位置参数}	POI list
希腊迈泰奥拉最便宜的三星级酒店	{三星级=星级, 希腊迈泰奥拉=地理位置参数}	POI list
西班牙格拉纳达最便宜的三星级酒店	{三星级=星级, 西班牙格拉纳达=地理位置参数}	POI list
埃及苏伊士最便宜的五星级酒店	{埃及苏伊士=地理位置参数, 五星级=星级}	POI list
法国阿尔勒最便宜的五星级酒店	{法国阿尔勒=地理位置参数, 五星级=星级}	POI list
日本鹿儿岛最便宜的三星级酒店	{日本鹿儿岛=地理位置参数, 三星级=星级}	POI list
马来西亚丰盛港最便宜的五星级酒店	{马来西亚丰盛港=地理位置参数, 五星级=星级}	POI list
忠州最便宜的四星级酒店	{四星级=星级, 忠州=地理位置参数}	POI list
巴德伊舍最便宜的三星级酒店	{巴德伊舍=地理位置参数, 三星级=星级}	POI list
日本鹿儿岛最便宜的五星级酒店	{日本鹿儿岛=地理位置参数, 五星级=星级}	POI list
卡劳最便宜的四星级酒店	{四星级=星级, 卡劳=地理位置参数}	POI list
利默里克最便宜的四星级酒店	{利默里克=地理位置参数, 四星级=星级}	POI list
卡塔尔赖扬最便宜的五星级酒店	{卡塔尔赖扬=地理位置参数, 五星级=星级}	POI list
尼泊尔加德满都最便宜的五星级酒店	{尼泊尔加德满都=地理位置参数, 五星级=星级}	POI list
西班牙巴塞罗那最便宜的四星级酒店	{四星级=星级, 西班牙巴塞罗那=地理位置参数}	POI list
长滩最便宜的四星级酒店	{四星级=星级, 长滩=地理位置参数}	POI list
中国香港最便宜的五星级酒店	{中国香港=地理位置参数, 五星级=星级}	POI list
知床半岛最便宜的四星级酒店	{四星级=星级, 知床半岛=地理位置参数}	POI list
泰国苏梅岛最便宜的四星级酒店	{四星级=星级, 泰国苏梅岛=地理位置参数}	POI list
印度尼西亚巴厘岛最便宜的四星级酒店	{四星级=星级, 印度尼西亚巴厘岛=地理位置参数}	POI list
英国英国湖区最便宜的四星级酒店	{英国英国湖区=地理位置参数, 四星级=星级}	POI list
巴勒莫最便宜的五星级酒店	{巴勒莫=地理位置参数, 五星级=星级}	POI list
温尼伯最便宜的三星级酒店	{三星级=星级, 温尼伯=地理位置参数}	POI list
冰岛斯蒂基斯霍尔米最便宜的三星级酒店	{三星级=星级, 冰岛斯蒂基斯霍尔米=地理位置参数}	POI list
意大利博洛尼亚最便宜的三星级酒店	{三星级=星级, 意大利博洛尼亚=地理位置参数}	POI list
旭川最便宜的五星级酒店	{旭川=地理位置参数, 五星级=星级}	POI list
恩格尔贝格最便宜的三星级酒店	{三星级=星级, 恩格尔贝格=地理位置参数}	POI list
巴西利亚最便宜的四星级酒店	{四星级=星级, 巴西利亚=地理位置参数}	POI list
柬埔寨戈公最便宜的五星级酒店	{柬埔寨戈公=地理位置参数, 五星级=星级}	POI list
韩国西归浦最便宜的三星级酒店	{三星级=星级, 韩国西归浦=地理位置参数}	POI list
垦丁最便宜的五星级酒店	{垦丁=地理位置参数, 五星级=星级}	POI list
佛罗伦萨最便宜的四星级酒店	{四星级=星级, 佛罗伦萨=地理位置参数}	POI list
宿雾最便宜的三星级酒店	{三星级=星级, 宿雾=地理位置参数}	POI list
阿比斯库最便宜的五星级酒店	{阿比斯库=地理位置参数, 五星级=星级}	POI list
日本旭川最便宜的四星级酒店	{四星级=星级, 日本旭川=地理位置参数}	POI list
奥洛穆茨最便宜的四星级酒店	{四星级=星级, 奥洛穆茨=地理位置参数}	POI list
法属波利尼西亚胡阿希内岛最便宜的四星级酒店	{四星级=星级, 法属波利尼西亚胡阿希内岛=地理位置参数}	POI list
西班牙昆卡最便宜的五星级酒店	{西班牙昆卡=地理位置参数, 五星级=星级}	POI list
葡萄牙阿尔科巴萨最便宜的五星级酒店	{葡萄牙阿尔科巴萨=地理位置参数, 五星级=星级}	POI list
泰国清迈最便宜的三星级酒店	{三星级=星级, 泰国清迈=地理位置参数}	POI list
日本埼玉最便宜的三星级酒店	{三星级=星级, 日本埼玉=地理位置参数}	POI list
新西兰奥马鲁最便宜的五星级酒店	{新西兰奥马鲁=地理位置参数, 五星级=星级}	POI list
冰岛埃伊尔斯塔济最便宜的五星级酒店	{冰岛埃伊尔斯塔济=地理位置参数, 五星级=星级}	POI list
西班牙龙达最便宜的五星级酒店	{西班牙龙达=地理位置参数, 五星级=星级}	POI list
瑞士沃韦最便宜的三星级酒店	{三星级=星级, 瑞士沃韦=地理位置参数}	POI list
印度尼西亚金巴兰最便宜的三星级酒店	{三星级=星级, 印度尼西亚金巴兰=地理位置参数}	POI list
图恩最便宜的五星级酒店	{图恩=地理位置参数, 五星级=星级}	POI list
内坦亚最便宜的四星级酒店	{四星级=星级, 内坦亚=地理位置参数}	POI list
法国圣马洛最便宜的四星级酒店	{四星级=星级, 法国圣马洛=地理位置参数}	POI list
日本美瑛最便宜的四星级酒店	{日本美瑛=地理位置参数, 四星级=星级}	POI list
瑞士施皮茨最便宜的四星级酒店	{瑞士施皮茨=地理位置参数, 四星级=星级}	POI list
斯里兰卡乌纳瓦图纳最便宜的五星级酒店	{斯里兰卡乌纳瓦图纳=地理位置参数, 五星级=星级}	POI list
澳大利亚拜伦湾最便宜的五星级酒店	{澳大利亚拜伦湾=地理位置参数, 五星级=星级}	POI list
枫丹白露最便宜的五星级酒店	{枫丹白露=地理位置参数, 五星级=星级}	POI list
拉哈尔最便宜的五星级酒店	{拉哈尔=地理位置参数, 五星级=星级}	POI list
福伦丹最便宜的四星级酒店	{福伦丹=地理位置参数, 四星级=星级}	POI list
兰达岛最便宜的三星级酒店	{三星级=星级, 兰达岛=地理位置参数}	POI list
卡塔尔多哈最便宜的五星级酒店	{卡塔尔多哈=地理位置参数, 五星级=星级}	POI list
日本伊势最便宜的四星级酒店	{四星级=星级, 日本伊势=地理位置参数}	POI list
采尔马特最便宜的四星级酒店	{四星级=星级, 采尔马特=地理位置参数}	POI list
秘鲁乌鲁班巴最便宜的四星级酒店	{四星级=星级, 秘鲁乌鲁班巴=地理位置参数}	POI list
福森最便宜的五星级酒店	{福森=地理位置参数, 五星级=星级}	POI list
邦劳最便宜的四星级酒店	{四星级=星级, 邦劳=地理位置参数}	POI list
龙达最便宜的三星级酒店	{三星级=星级, 龙达=地理位置参数}	POI list
木浦市最便宜的四星级酒店	{四星级=星级, 木浦市=地理位置参数}	POI list
瑞士卢塞恩最便宜的五星级酒店	{瑞士卢塞恩=地理位置参数, 五星级=星级}	POI list
基督城最便宜的四星级酒店	{四星级=星级, 基督城=地理位置参数}	POI list
爱尔兰基拉尼最便宜的四星级酒店	{四星级=星级, 爱尔兰基拉尼=地理位置参数}	POI list
利兹最便宜的三星级酒店	{三星级=星级, 利兹=地理位置参数}	POI list
埃及努韦巴最便宜的五星级酒店	{埃及努韦巴=地理位置参数, 五星级=星级}	POI list
桃园最便宜的四星级酒店	{四星级=星级, 桃园=地理位置参数}	POI list
埃及吉萨最便宜的五星级酒店	{埃及吉萨=地理位置参数, 五星级=星级}	POI list
热海最便宜的四星级酒店	{四星级=星级, 热海=地理位置参数}	POI list
泰国夜功府最便宜的四星级酒店	{四星级=星级, 泰国夜功府=地理位置参数}	POI list
德国班贝格最便宜的四星级酒店	{四星级=星级, 德国班贝格=地理位置参数}	POI list
梅赫伦最便宜的四星级酒店	{四星级=星级, 梅赫伦=地理位置参数}	POI list
瑞士巴塞尔最便宜的四星级酒店	{四星级=星级, 瑞士巴塞尔=地理位置参数}	POI list
阿罗萨最便宜的三星级酒店	{三星级=星级, 阿罗萨=地理位置参数}	POI list
胡志明市最便宜的四星级酒店	{胡志明市=地理位置参数, 四星级=星级}	POI list
英国湖区最便宜的五星级酒店	{英国湖区=地理位置参数, 五星级=星级}	POI list
罗萨里奥最便宜的五星级酒店	{罗萨里奥=地理位置参数, 五星级=星级}	POI list
冰岛维克最便宜的三星级酒店	{三星级=星级, 冰岛维克=地理位置参数}	POI list
维亚纳堡最便宜的五星级酒店	{维亚纳堡=地理位置参数, 五星级=星级}	POI list
所罗门群岛吉佐最便宜的五星级酒店	{所罗门群岛吉佐=地理位置参数, 五星级=星级}	POI list
孟加拉国班多尔班有实验室的四星级酒店	{四星级=星级, 孟加拉国班多尔班=地理位置参数, 实验室=POI内部包含实体}	POI list
凯米有作品的四星级酒店	{四星级=星级, 作品=POI内部包含实体, 凯米=地理位置参数}	POI list
昆卡有铁塔的五星级酒店	{铁塔=POI内部包含实体, 昆卡=地理位置参数, 五星级=星级}	POI list
库特纳霍拉有红杉树的四星级酒店	{四星级=星级, 红杉树=POI内部包含实体, 库特纳霍拉=地理位置参数}	POI list
玛琅有电梯的四星级酒店	{四星级=星级, 玛琅=地理位置参数, 电梯=POI内部包含实体}	POI list
阿根廷圣卡洛斯-德巴里洛切有沙石的四星级酒店	{四星级=星级, 沙石=POI内部包含实体, 阿根廷圣卡洛斯-德巴里洛切=地理位置参数}	POI list
伊势有地砖的三星级酒店	{三星级=星级, 伊势=地理位置参数, 地砖=POI内部包含实体}	POI list
干尼亚有邮筒的五星级酒店	{邮筒=POI内部包含实体, 干尼亚=地理位置参数, 五星级=星级}	POI list
瑞典林雪平有橱柜的四星级酒店	{四星级=星级, 瑞典林雪平=地理位置参数, 橱柜=POI内部包含实体}	POI list
威尼斯有院子的三星级酒店	{三星级=星级, 威尼斯=地理位置参数, 院子=POI内部包含实体}	POI list
圣塔芭芭拉有魔方的四星级酒店	{四星级=星级, 圣塔芭芭拉=地理位置参数, 魔方=POI内部包含实体}	POI list
日本大阪有井的三星级酒店	{三星级=星级, 井=POI内部包含实体, 日本大阪=地理位置参数}	POI list
马来西亚关丹有院子的四星级酒店	{四星级=星级, 马来西亚关丹=地理位置参数, 院子=POI内部包含实体}	POI list
西班牙马德里有后院的四星级酒店	{四星级=星级, 后院=POI内部包含实体, 西班牙马德里=地理位置参数}	POI list
日本冈山有地砖的三星级酒店	{三星级=星级, 地砖=POI内部包含实体, 日本冈山=地理位置参数}	POI list
阿讷西有商铺的五星级酒店	{阿讷西=地理位置参数, 商铺=POI内部包含实体, 五星级=星级}	POI list
伊斯兰堡有舞厅的四星级酒店	{四星级=星级, 伊斯兰堡=地理位置参数, 舞厅=POI内部包含实体}	POI list
维克有咖啡馆的四星级酒店	{四星级=星级, 咖啡馆=POI内部包含实体, 维克=地理位置参数}	POI list
兰卡威有地砖的三星级酒店	{三星级=星级, 兰卡威=地理位置参数, 地砖=POI内部包含实体}	POI list
夜丰颂有楼梯的三星级酒店	{三星级=星级, 夜丰颂=地理位置参数, 楼梯=POI内部包含实体}	POI list
盐湖城有窗户的五星级酒店	{盐湖城=地理位置参数, 窗户=POI内部包含实体, 五星级=星级}	POI list
拉瓦格有海湾的四星级酒店	{四星级=星级, 海湾=POI内部包含实体, 拉瓦格=地理位置参数}	POI list
韩国木浦市有图书馆的三星级酒店	{三星级=星级, 韩国木浦市=地理位置参数, 图书馆=POI内部包含实体}	POI list
以色列拿撒勒有云海的四星级酒店	{四星级=星级, 以色列拿撒勒=地理位置参数, 云海=POI内部包含实体}	POI list
挪威博德有柱子的三星级酒店	{三星级=星级, 柱子=POI内部包含实体, 挪威博德=地理位置参数}	POI list
法国圣马洛有赌场的五星级酒店	{法国圣马洛=地理位置参数, 赌场=POI内部包含实体, 五星级=星级}	POI list
圣加仑有佛的三星级酒店	{三星级=星级, 圣加仑=地理位置参数, 佛=POI内部包含实体}	POI list
韩国昌原有官邸的三星级酒店	{三星级=星级, 韩国昌原=地理位置参数, 官邸=POI内部包含实体}	POI list
丹布勒有鸟巢的五星级酒店	{鸟巢=POI内部包含实体, 丹布勒=地理位置参数, 五星级=星级}	POI list
法国圣马洛有宫殿的四星级酒店	{四星级=星级, 法国圣马洛=地理位置参数, 宫殿=POI内部包含实体}	POI list
都灵有灯泡的五星级酒店	{都灵=地理位置参数, 灯泡=POI内部包含实体, 五星级=星级}	POI list
华欣有海湾的三星级酒店	{三星级=星级, 海湾=POI内部包含实体, 华欣=地理位置参数}	POI list
都柏林有红叶的三星级酒店	{三星级=星级, 都柏林=地理位置参数, 红叶=POI内部包含实体}	POI list
波蓬德塔有车位的五星级酒店	{车位=POI内部包含实体, 波蓬德塔=地理位置参数, 五星级=星级}	POI list
瑞士文根有魔方的五星级酒店	{魔方=POI内部包含实体, 瑞士文根=地理位置参数, 五星级=星级}	POI list
西班牙格拉纳达有草坪的五星级酒店	{草坪=POI内部包含实体, 西班牙格拉纳达=地理位置参数, 五星级=星级}	POI list
巴西累西腓有馆舍的四星级酒店	{四星级=星级, 馆舍=POI内部包含实体, 巴西累西腓=地理位置参数}	POI list
南设得兰群岛有美术馆的四星级酒店	{四星级=星级, 南设得兰群岛=地理位置参数, 美术馆=POI内部包含实体}	POI list
南极洲南设得兰群岛有河灯的五星级酒店	{河灯=POI内部包含实体, 南极洲南设得兰群岛=地理位置参数, 五星级=星级}	POI list
奥卢有窗户的五星级酒店	{奥卢=地理位置参数, 窗户=POI内部包含实体, 五星级=星级}	POI list
诺丁汉有酒吧的五星级酒店	{酒吧=POI内部包含实体, 诺丁汉=地理位置参数, 五星级=星级}	POI list
斯里兰卡康提有观景台的五星级酒店	{观景台=POI内部包含实体, 斯里兰卡康提=地理位置参数, 五星级=星级}	POI list
冰岛赫本有停车场的五星级酒店	{冰岛赫本=地理位置参数, 停车场=POI内部包含实体, 五星级=星级}	POI list
西班牙特内里费岛有庙宇的四星级酒店	{四星级=星级, 西班牙特内里费岛=地理位置参数, 庙宇=POI内部包含实体}	POI list
尔湾有魔方的四星级酒店	{尔湾=地理位置参数, 四星级=星级, 魔方=POI内部包含实体}	POI list
比利时休伊有座位的三星级酒店	{三星级=星级, 比利时休伊=地理位置参数, 座位=POI内部包含实体}	POI list
箭镇有古城堡的五星级酒店	{古城堡=POI内部包含实体, 箭镇=地理位置参数, 五星级=星级}	POI list
莫斯科有温泉的四星级酒店	{四星级=星级, 莫斯科=地理位置参数, 温泉=POI内部包含实体}	POI list
埃及马特鲁有神社的三星级酒店	{三星级=星级, 埃及马特鲁=地理位置参数, 神社=POI内部包含实体}	POI list
法国图卢兹有筏子的三星级酒店	{三星级=星级, 法国图卢兹=地理位置参数, 筏子=POI内部包含实体}	POI list
菲律宾公主港有商场的三星级酒店	{三星级=星级, 菲律宾公主港=地理位置参数, 商场=POI内部包含实体}	POI list
特罗姆瑟有纪念馆的三星级酒店	{三星级=星级, 特罗姆瑟=地理位置参数, 纪念馆=POI内部包含实体}	POI list
恩戈地有灯泡的四星级酒店	{四星级=星级, 恩戈地=地理位置参数, 灯泡=POI内部包含实体}	POI list
库什蒂亚有鸟巢的四星级酒店	{库什蒂亚=地理位置参数, 鸟巢=POI内部包含实体, 四星级=星级}	POI list
普诺有沙丘的四星级酒店	{普诺=地理位置参数, 四星级=星级, 沙丘=POI内部包含实体}	POI list
西班牙利亚内斯有美术馆的三星级酒店	{三星级=星级, 西班牙利亚内斯=地理位置参数, 美术馆=POI内部包含实体}	POI list
中国嘉义有霓虹灯的三星级酒店	{三星级=星级, 中国嘉义=地理位置参数, 霓虹灯=POI内部包含实体}	POI list
琅多有探知馆的五星级酒店	{探知馆=POI内部包含实体, 琅多=地理位置参数, 五星级=星级}	POI list
俄罗斯海参崴有银幕的四星级酒店	{四星级=星级, 俄罗斯海参崴=地理位置参数, 银幕=POI内部包含实体}	POI list
卢卡有永观堂的五星级酒店	{卢卡=地理位置参数, 永观堂=POI内部包含实体, 五星级=星级}	POI list
大城有大佛的三星级酒店	{三星级=星级, 大城=地理位置参数, 大佛=POI内部包含实体}	POI list
菲律宾安吉利斯有温泉水的五星级酒店	{菲律宾安吉利斯=地理位置参数, 温泉水=POI内部包含实体, 五星级=星级}	POI list
哈尔施塔特有大殿的三星级酒店	{三星级=星级, 大殿=POI内部包含实体, 哈尔施塔特=地理位置参数}	POI list
坦加勒有沙石的三星级酒店	{三星级=星级, 沙石=POI内部包含实体, 坦加勒=地理位置参数}	POI list
肯尼亚内罗毕有雕像的五星级酒店	{雕像=POI内部包含实体, 肯尼亚内罗毕=地理位置参数, 五星级=星级}	POI list
美国圣路易奥比斯波有会展的四星级酒店	{四星级=星级, 会展=POI内部包含实体, 美国圣路易奥比斯波=地理位置参数}	POI list
西班牙卡尔维亚有珊瑚的四星级酒店	{四星级=星级, 西班牙卡尔维亚=地理位置参数, 珊瑚=POI内部包含实体}	POI list
热浪岛有沙子的五星级酒店	{沙子=POI内部包含实体, 热浪岛=地理位置参数, 五星级=星级}	POI list
南非开普敦有赌场的四星级酒店	{四星级=星级, 南非开普敦=地理位置参数, 赌场=POI内部包含实体}	POI list
老挝琅勃拉邦有泳池的四星级酒店	{泳池=POI内部包含实体, 四星级=星级, 老挝琅勃拉邦=地理位置参数}	POI list
富士山有博物馆的五星级酒店	{博物馆=POI内部包含实体, 富士山=地理位置参数, 五星级=星级}	POI list
卡法亚特有卧佛的五星级酒店	{卡法亚特=地理位置参数, 卧佛=POI内部包含实体, 五星级=星级}	POI list
意大利米兰有保险柜的五星级酒店	{意大利米兰=地理位置参数, 保险柜=POI内部包含实体, 五星级=星级}	POI list
尼泊尔加德满都有照片的四星级酒店	{四星级=星级, 尼泊尔加德满都=地理位置参数, 照片=POI内部包含实体}	POI list
高威有停车位的五星级酒店	{高威=地理位置参数, 停车位=POI内部包含实体, 五星级=星级}	POI list
秘鲁马尔多纳多港有橱柜的四星级酒店	{四星级=星级, 橱柜=POI内部包含实体, 秘鲁马尔多纳多港=地理位置参数}	POI list
锡尔赫特有蜡像的四星级酒店	{四星级=星级, 锡尔赫特=地理位置参数, 蜡像=POI内部包含实体}	POI list
塔拉戈纳有台阶的三星级酒店	{三星级=星级, 塔拉戈纳=地理位置参数, 台阶=POI内部包含实体}	POI list
中国澎湖列岛有文物的三星级酒店	{三星级=星级, 中国澎湖列岛=地理位置参数, 文物=POI内部包含实体}	POI list
法兰克福有扩音器的五星级酒店	{扩音器=POI内部包含实体, 法兰克福=地理位置参数, 五星级=星级}	POI list
芬兰凯米有纪念碑的四星级酒店	{纪念碑=POI内部包含实体, 四星级=星级, 芬兰凯米=地理位置参数}	POI list
干尼亚有红树的四星级酒店	{红树=POI内部包含实体, 四星级=星级, 干尼亚=地理位置参数}	POI list
昆卡有赌场的五星级酒店	{昆卡=地理位置参数, 赌场=POI内部包含实体, 五星级=星级}	POI list
布鲁日有药房的三星级酒店	{药房=POI内部包含实体, 三星级=星级, 布鲁日=地理位置参数}	POI list
斯米兰群岛有长廊的四星级酒店	{四星级=星级, 斯米兰群岛=地理位置参数, 长廊=POI内部包含实体}	POI list
图卢兹有地砖的三星级酒店	{三星级=星级, 图卢兹=地理位置参数, 地砖=POI内部包含实体}	POI list
中国澎湖列岛有咖啡馆的四星级酒店	{四星级=星级, 咖啡馆=POI内部包含实体, 中国澎湖列岛=地理位置参数}	POI list
爱丁堡有云海的三星级酒店	{三星级=星级, 爱丁堡=地理位置参数, 云海=POI内部包含实体}	POI list
南极洲南极半岛有佛像的三星级酒店	{三星级=星级, 南极洲南极半岛=地理位置参数, 佛像=POI内部包含实体}	POI list
法属波利尼西亚普纳奥亚有魔方的五星级酒店	{魔方=POI内部包含实体, 法属波利尼西亚普纳奥亚=地理位置参数, 五星级=星级}	POI list
南非约翰内斯堡有蜡像的四星级酒店	{四星级=星级, 南非约翰内斯堡=地理位置参数, 蜡像=POI内部包含实体}	POI list
伊纳里有纪念碑的四星级酒店	{纪念碑=POI内部包含实体, 四星级=星级, 伊纳里=地理位置参数}	POI list
锡吉里耶有剧院的五星级酒店	{剧院=POI内部包含实体, 锡吉里耶=地理位置参数, 五星级=星级}	POI list
德国斯图加特有甬道的五星级酒店	{德国斯图加特=地理位置参数, 甬道=POI内部包含实体, 五星级=星级}	POI list
圣塞瓦斯蒂安有大佛的三星级酒店	{三星级=星级, 圣塞瓦斯蒂安=地理位置参数, 大佛=POI内部包含实体}	POI list
库特纳霍拉有商铺的五星级酒店	{库特纳霍拉=地理位置参数, 商铺=POI内部包含实体, 五星级=星级}	POI list
弗拉基米尔有展厅的三星级酒店	{三星级=星级, 弗拉基米尔=地理位置参数, 展厅=POI内部包含实体}	POI list
布鲁塞尔有陈设的四星级酒店	{四星级=星级, 陈设=POI内部包含实体, 布鲁塞尔=地理位置参数}	POI list
锡耶纳有珊瑚的三星级酒店	{三星级=星级, 锡耶纳=地理位置参数, 珊瑚=POI内部包含实体}	POI list
埃及吉萨有塔的四星级酒店	{四星级=星级, 塔=POI内部包含实体, 埃及吉萨=地理位置参数}	POI list
有没有有沙滩的三星级酒店	{三星级=星级, 沙滩=POI内部包含实体}	POI list
有没有有舞厅的三星级酒店	{三星级=星级, 舞厅=POI内部包含实体}	POI list
有没有有海滩的三星级酒店	{三星级=星级, 海滩=POI内部包含实体}	POI list
有没有有舞台的四星级酒店	{四星级=星级, 舞台=POI内部包含实体}	POI list
有没有有华表的三星级酒店	{华表=POI内部包含实体, 三星级=星级}	POI list
有没有有海湾的四星级酒店	{四星级=星级, 海湾=POI内部包含实体}	POI list
有没有有棺材的五星级酒店	{棺材=POI内部包含实体, 五星级=星级}	POI list
有没有有永观堂的三星级酒店	{三星级=星级, 永观堂=POI内部包含实体}	POI list
有没有有大佛的三星级酒店	{三星级=星级, 大佛=POI内部包含实体}	POI list
有没有有雕像的四星级酒店	{四星级=星级, 雕像=POI内部包含实体}	POI list
有没有有神社的四星级酒店	{四星级=星级, 神社=POI内部包含实体}	POI list
有没有有馆舍的三星级酒店	{三星级=星级, 馆舍=POI内部包含实体}	POI list
有没有有照片的五星级酒店	{照片=POI内部包含实体, 五星级=星级}	POI list
有没有有卧佛的三星级酒店	{三星级=星级, 卧佛=POI内部包含实体}	POI list
有没有有长廊的四星级酒店	{四星级=星级, 长廊=POI内部包含实体}	POI list
有没有有店铺的四星级酒店	{四星级=星级, 店铺=POI内部包含实体}	POI list
有没有有永观堂的四星级酒店	{四星级=星级, 永观堂=POI内部包含实体}	POI list
有没有有高台的三星级酒店	{三星级=星级, 高台=POI内部包含实体}	POI list
有没有有园林的四星级酒店	{园林=POI内部包含实体, 四星级=星级}	POI list
有没有有华表的四星级酒店	{华表=POI内部包含实体, 四星级=星级}	POI list
有没有有沙石的四星级酒店	{四星级=星级, 沙石=POI内部包含实体}	POI list
有没有有古城堡的五星级酒店	{古城堡=POI内部包含实体, 五星级=星级}	POI list
有没有有球场的三星级酒店	{三星级=星级, 球场=POI内部包含实体}	POI list
有没有有观景台的四星级酒店	{四星级=星级, 观景台=POI内部包含实体}	POI list
有没有有商户的四星级酒店	{四星级=星级, 商户=POI内部包含实体}	POI list
有没有有宫殿的三星级酒店	{三星级=星级, 宫殿=POI内部包含实体}	POI list
有没有有观景台的五星级酒店	{观景台=POI内部包含实体, 五星级=星级}	POI list
有没有有神社的三星级酒店	{三星级=星级, 神社=POI内部包含实体}	POI list
有没有有大门的五星级酒店	{大门=POI内部包含实体, 五星级=星级}	POI list
有没有有亭的四星级酒店	{四星级=星级, 亭=POI内部包含实体}	POI list
有没有有华表的五星级酒店	{华表=POI内部包含实体, 五星级=星级}	POI list
有没有有游乐场的五星级酒店	{游乐场=POI内部包含实体, 五星级=星级}	POI list
有没有有筏子的四星级酒店	{四星级=星级, 筏子=POI内部包含实体}	POI list
有没有有咖啡厅的五星级酒店	{咖啡厅=POI内部包含实体, 五星级=星级}	POI list
有没有有卫生间的五星级酒店	{卫生间=POI内部包含实体, 五星级=星级}	POI list
有没有有砂岩的四星级酒店	{四星级=星级, 砂岩=POI内部包含实体}	POI list
有没有有大佛的四星级酒店	{四星级=星级, 大佛=POI内部包含实体}	POI list
有没有有城墙的四星级酒店	{城墙=POI内部包含实体, 四星级=星级}	POI list
有没有有大殿的四星级酒店	{四星级=星级, 大殿=POI内部包含实体}	POI list
有没有有大殿的五星级酒店	{大殿=POI内部包含实体, 五星级=星级}	POI list
有没有有咖啡馆的五星级酒店	{咖啡馆=POI内部包含实体, 五星级=星级}	POI list
有没有有文物的三星级酒店	{三星级=星级, 文物=POI内部包含实体}	POI list
有没有有纪念堂的五星级酒店	{纪念堂=POI内部包含实体, 五星级=星级}	POI list
有没有有古城堡的四星级酒店	{四星级=星级, 古城堡=POI内部包含实体}	POI list
有没有有地板的三星级酒店	{三星级=星级, 地板=POI内部包含实体}	POI list
有没有有照片的三星级酒店	{三星级=星级, 照片=POI内部包含实体}	POI list
有没有有纪念馆的五星级酒店	{纪念馆=POI内部包含实体, 五星级=星级}	POI list
有没有有影城的五星级酒店	{影城=POI内部包含实体, 五星级=星级}	POI list
有没有有赌场的五星级酒店	{赌场=POI内部包含实体, 五星级=星级}	POI list
有没有有卧佛的五星级酒店	{卧佛=POI内部包含实体, 五星级=星级}	POI list
有没有有房屋的四星级酒店	{房屋=POI内部包含实体, 四星级=星级}	POI list
有没有有温泉水的三星级酒店	{三星级=星级, 温泉水=POI内部包含实体}	POI list
有没有有床铺的五星级酒店	{床铺=POI内部包含实体, 五星级=星级}	POI list
有没有有官邸的三星级酒店	{三星级=星级, 官邸=POI内部包含实体}	POI list
有没有有指示牌的四星级酒店	{四星级=星级, 指示牌=POI内部包含实体}	POI list
有没有有云海的四星级酒店	{四星级=星级, 云海=POI内部包含实体}	POI list
有没有有餐厅的四星级酒店	{四星级=星级, 餐厅=POI内部包含实体}	POI list
有没有有舞厅的五星级酒店	{舞厅=POI内部包含实体, 五星级=星级}	POI list
有没有有河灯的五星级酒店	{河灯=POI内部包含实体, 五星级=星级}	POI list
有没有有扩音器的三星级酒店	{三星级=星级, 扩音器=POI内部包含实体}	POI list
有没有有灯的三星级酒店	{三星级=星级, 灯=POI内部包含实体}	POI list
有没有有城堡的三星级酒店	{三星级=星级, 城堡=POI内部包含实体}	POI list
有没有有壁画的五星级酒店	{壁画=POI内部包含实体, 五星级=星级}	POI list
有没有有店铺的五星级酒店	{店铺=POI内部包含实体, 五星级=星级}	POI list
有没有有纪念馆的四星级酒店	{四星级=星级, 纪念馆=POI内部包含实体}	POI list
有没有有塔的三星级酒店	{三星级=星级, 塔=POI内部包含实体}	POI list
有没有有牌坊的三星级酒店	{牌坊=POI内部包含实体, 三星级=星级}	POI list
有没有有服装的五星级酒店	{服装=POI内部包含实体, 五星级=星级}	POI list
有没有有车位的五星级酒店	{车位=POI内部包含实体, 五星级=星级}	POI list
有没有有阶梯的四星级酒店	{四星级=星级, 阶梯=POI内部包含实体}	POI list
有没有有城堡的五星级酒店	{城堡=POI内部包含实体, 五星级=星级}	POI list
有没有有地板的五星级酒店	{地板=POI内部包含实体, 五星级=星级}	POI list
有没有有科技馆的三星级酒店	{三星级=星级, 科技馆=POI内部包含实体}	POI list
有没有有橱柜的五星级酒店	{橱柜=POI内部包含实体, 五星级=星级}	POI list
有没有有皇宫的四星级酒店	{四星级=星级, 皇宫=POI内部包含实体}	POI list
有没有有牌坊的五星级酒店	{牌坊=POI内部包含实体, 五星级=星级}	POI list
有没有有庭院的四星级酒店	{四星级=星级, 庭院=POI内部包含实体}	POI list
有没有有玉佛的四星级酒店	{四星级=星级, 玉佛=POI内部包含实体}	POI list
有没有有果树的五星级酒店	{果树=POI内部包含实体, 五星级=星级}	POI list
有没有有科技馆的五星级酒店	{科技馆=POI内部包含实体, 五星级=星级}	POI list
有没有有厕所的四星级酒店	{厕所=POI内部包含实体, 四星级=星级}	POI list
有没有有停车场的三星级酒店	{三星级=星级, 停车场=POI内部包含实体}	POI list
有没有有神社的五星级酒店	{神社=POI内部包含实体, 五星级=星级}	POI list
有没有有摊位的三星级酒店	{三星级=星级, 摊位=POI内部包含实体}	POI list
有没有有果树的三星级酒店	{三星级=星级, 果树=POI内部包含实体}	POI list
有没有有纪念碑的五星级酒店	{纪念碑=POI内部包含实体, 五星级=星级}	POI list
有没有有厕所的三星级酒店	{三星级=星级, 厕所=POI内部包含实体}	POI list
有没有有座位的四星级酒店	{四星级=星级, 座位=POI内部包含实体}	POI list
有没有有植物园的四星级酒店	{四星级=星级, 植物园=POI内部包含实体}	POI list
有没有有房屋的五星级酒店	{房屋=POI内部包含实体, 五星级=星级}	POI list
有没有有砂岩的三星级酒店	{三星级=星级, 砂岩=POI内部包含实体}	POI list
有没有有大殿的三星级酒店	{三星级=星级, 大殿=POI内部包含实体}	POI list
有没有有展品的三星级酒店	{三星级=星级, 展品=POI内部包含实体}	POI list
有没有有画的三星级酒店	{三星级=星级, 画=POI内部包含实体}	POI list
有没有有宫墙的三星级酒店	{三星级=星级, 宫墙=POI内部包含实体}	POI list
有没有有屋顶的五星级酒店	{屋顶=POI内部包含实体, 五星级=星级}	POI list
有没有有商场的三星级酒店	{三星级=星级, 商场=POI内部包含实体}	POI list
有没有有红叶的四星级酒店	{四星级=星级, 红叶=POI内部包含实体}	POI list
有没有有车位的四星级酒店	{四星级=星级, 车位=POI内部包含实体}	POI list
有没有有鲜花的三星级酒店	{三星级=星级, 鲜花=POI内部包含实体}	POI list
有没有图案清晰的酒店	{图案=POI特性实体, 清晰=POI特性实体修饰}	POI list
有没有晚霞棒的酒店	{棒=POI特性实体修饰, 晚霞=POI特性实体}	POI list
有没有情节逗趣的酒店	{情节=POI特性实体, 逗趣=POI特性实体修饰}	POI list
有没有冷气不足的酒店	{冷气=POI特性实体, 不足=POI特性实体修饰}	POI list
有没有灯光显眼的酒店	{显眼=POI特性实体修饰, 灯光=POI特性实体}	POI list
有没有构造错综复杂的酒店	{构造=POI特性实体, 错综复杂=POI特性实体修饰}	POI list
有没有温度高啊的酒店	{温度=POI特性实体, 高啊=POI特性实体修饰}	POI list
有没有落日超美的酒店	{落日=POI特性实体, 超美=POI特性实体修饰}	POI list
有没有空间小的的酒店	{空间=POI特性实体, 小的=POI特性实体修饰}	POI list
有没有设施幼稚的酒店	{幼稚=POI特性实体修饰, 设施=POI特性实体}	POI list
有没有海景棒的酒店	{棒=POI特性实体修饰, 海景=POI特性实体}	POI list
有没有气息淡的酒店	{淡=POI特性实体修饰, 气息=POI特性实体}	POI list
有没有流线乱的酒店	{乱=POI特性实体修饰, 流线=POI特性实体}	POI list
有没有地热有名的酒店	{地热=POI特性实体, 有名=POI特性实体修饰}	POI list
有没有装饰突兀的酒店	{突兀=POI特性实体修饰, 装饰=POI特性实体}	POI list
有没有气氛太好的酒店	{太好=POI特性实体修饰, 气氛=POI特性实体}	POI list
有没有布景干净的酒店	{干净=POI特性实体修饰, 布景=POI特性实体}	POI list
有没有氛围奇特的酒店	{氛围=POI特性实体, 奇特=POI特性实体修饰}	POI list
有没有布置低调的酒店	{布置=POI特性实体, 低调=POI特性实体修饰}	POI list
有没有体验优的酒店	{体验=POI特性实体, 优=POI特性实体修饰}	POI list
有没有名头很大的酒店	{很大=POI特性实体修饰, 名头=POI特性实体}	POI list
有没有装备优良的酒店	{装备=POI特性实体, 优良=POI特性实体修饰}	POI list
有没有名头响亮的酒店	{响亮=POI特性实体修饰, 名头=POI特性实体}	POI list
有没有光线鲜艳的酒店	{鲜艳=POI特性实体修饰, 光线=POI特性实体}	POI list
有没有日出美了的酒店	{美了=POI特性实体修饰, 日出=POI特性实体}	POI list
有没有日出美的酒店	{日出=POI特性实体, 美=POI特性实体修饰}	POI list
有没有布局紧密的酒店	{紧密=POI特性实体修饰, 布局=POI特性实体}	POI list
有没有景象诡异的酒店	{诡异=POI特性实体修饰, 景象=POI特性实体}	POI list
有没有布置朴素的酒店	{布置=POI特性实体, 朴素=POI特性实体修饰}	POI list
有没有气势庄严的酒店	{气势=POI特性实体, 庄严=POI特性实体修饰}	POI list
有没有底蕴厚的酒店	{底蕴=POI特性实体, 厚=POI特性实体修饰}	POI list
有没有地势平的酒店	{平=POI特性实体修饰, 地势=POI特性实体}	POI list
有没有流线复杂的酒店	{流线=POI特性实体, 复杂=POI特性实体修饰}	POI list
有没有意义巨大的酒店	{巨大=POI特性实体修饰, 意义=POI特性实体}	POI list
有没有店面众多的酒店	{店面=POI特性实体, 众多=POI特性实体修饰}	POI list
有没有现代感强的的酒店	{现代感=POI特性实体, 强的=POI特性实体修饰}	POI list
有没有夜晚清爽的酒店	{夜晚=POI特性实体, 清爽=POI特性实体修饰}	POI list
有没有可游性高的酒店	{可游性=POI特性实体, 高=POI特性实体修饰}	POI list
有没有夜晚凉爽的酒店	{夜晚=POI特性实体, 凉爽=POI特性实体修饰}	POI list
有没有格局宏伟的酒店	{格局=POI特性实体, 宏伟=POI特性实体修饰}	POI list
有没有布局紧凑的酒店	{紧凑=POI特性实体修饰, 布局=POI特性实体}	POI list
有没有光线强的酒店	{强=POI特性实体修饰, 光线=POI特性实体}	POI list
有没有招牌不起眼的酒店	{不起眼=POI特性实体修饰, 招牌=POI特性实体}	POI list
有没有秩序整齐的酒店	{整齐=POI特性实体修饰, 秩序=POI特性实体}	POI list
有没有晚霞美的的酒店	{晚霞=POI特性实体, 美的=POI特性实体修饰}	POI list
有没有配置低的酒店	{配置=POI特性实体, 低=POI特性实体修饰}	POI list
有没有秩序棒的酒店	{棒=POI特性实体修饰, 秩序=POI特性实体}	POI list
有没有装修新的酒店	{新=POI特性实体修饰, 装修=POI特性实体}	POI list
有没有景观不佳的酒店	{景观=POI特性实体, 不佳=POI特性实体修饰}	POI list
有没有地形低的酒店	{地形=POI特性实体, 低=POI特性实体修饰}	POI list
有没有夜景朦朦胧胧的酒店	{朦朦胧胧=POI特性实体修饰, 夜景=POI特性实体}	POI list
有没有卫生赞的酒店	{卫生=POI特性实体, 赞=POI特性实体修饰}	POI list
有没有人气单薄的酒店	{人气=POI特性实体, 单薄=POI特性实体修饰}	POI list
有没有光线充足的酒店	{充足=POI特性实体修饰, 光线=POI特性实体}	POI list
有没有污染重的的酒店	{重的=POI特性实体修饰, 污染=POI特性实体}	POI list
有没有名声响亮的酒店	{名声=POI特性实体, 响亮=POI特性实体修饰}	POI list
有没有样式稀有的酒店	{样式=POI特性实体, 稀有=POI特性实体修饰}	POI list
有没有创意神奇的酒店	{神奇=POI特性实体修饰, 创意=POI特性实体}	POI list
有没有温度烫的酒店	{温度=POI特性实体, 烫=POI特性实体修饰}	POI list
有没有景致各异的酒店	{各异=POI特性实体修饰, 景致=POI特性实体}	POI list
有没有安检不错的酒店	{不错=POI特性实体修饰, 安检=POI特性实体}	POI list
有没有店面密集的酒店	{店面=POI特性实体, 密集=POI特性实体修饰}	POI list
有没有观赏性有限的酒店	{有限=POI特性实体修饰, 观赏性=POI特性实体}	POI list
有没有出口小的酒店	{出口=POI特性实体, 小=POI特性实体修饰}	POI list
有没有空间紧凑的酒店	{空间=POI特性实体, 紧凑=POI特性实体修饰}	POI list
有没有构造复杂的酒店	{构造=POI特性实体, 复杂=POI特性实体修饰}	POI list
有没有色彩明晰的酒店	{色彩=POI特性实体, 明晰=POI特性实体修饰}	POI list
有没有体验好玩儿的酒店	{体验=POI特性实体, 好玩儿=POI特性实体修饰}	POI list
有没有氛围美好的酒店	{美好=POI特性实体修饰, 氛围=POI特性实体}	POI list
有没有设备旧的酒店	{旧=POI特性实体修饰, 设备=POI特性实体}	POI list
有没有地面崎岖的酒店	{崎岖=POI特性实体修饰, 地面=POI特性实体}	POI list
有没有安检安全的酒店	{安全=POI特性实体修饰, 安检=POI特性实体}	POI list
有没有历史感多的酒店	{历史感=POI特性实体, 多=POI特性实体修饰}	POI list
有没有音场烂的酒店	{烂=POI特性实体修饰, 音场=POI特性实体}	POI list
有没有灯火夺目的酒店	{灯火=POI特性实体, 夺目=POI特性实体修饰}	POI list
有没有特点少见的酒店	{少见=POI特性实体修饰, 特点=POI特性实体}	POI list
有没有形象丰富的酒店	{形象=POI特性实体, 丰富=POI特性实体修饰}	POI list
有没有晚霞艳丽的酒店	{晚霞=POI特性实体, 艳丽=POI特性实体修饰}	POI list
有没有夕阳非常好的酒店	{非常好=POI特性实体修饰, 夕阳=POI特性实体}	POI list
有没有生态好的酒店	{生态=POI特性实体, 好=POI特性实体修饰}	POI list
有没有视角独特的酒店	{独特=POI特性实体修饰, 视角=POI特性实体}	POI list
有没有卫生棒的酒店	{棒=POI特性实体修饰, 卫生=POI特性实体}	POI list
有没有夜景一塌糊涂的酒店	{夜景=POI特性实体, 一塌糊涂=POI特性实体修饰}	POI list
有没有装潢华贵的酒店	{装潢=POI特性实体, 华贵=POI特性实体修饰}	POI list
有没有氛围一流的酒店	{氛围=POI特性实体, 一流=POI特性实体修饰}	POI list
有没有冷气不够的酒店	{冷气=POI特性实体, 不够=POI特性实体修饰}	POI list
有没有规模太大的酒店	{太大=POI特性实体修饰, 规模=POI特性实体}	POI list
有没有气氛贴切的酒店	{贴切=POI特性实体修饰, 气氛=POI特性实体}	POI list
有没有趣味丰富的酒店	{趣味=POI特性实体, 丰富=POI特性实体修饰}	POI list
有没有外墙脏的酒店	{外墙=POI特性实体, 脏=POI特性实体修饰}	POI list
有没有风力越来越大的酒店	{越来越大=POI特性实体修饰, 风力=POI特性实体}	POI list
有没有形象全的酒店	{形象=POI特性实体, 全=POI特性实体修饰}	POI list
有没有光线好得多的酒店	{好得多=POI特性实体修饰, 光线=POI特性实体}	POI list
有没有装修好看的酒店	{好看=POI特性实体修饰, 装修=POI特性实体}	POI list
有没有形态凶猛的酒店	{形态=POI特性实体, 凶猛=POI特性实体修饰}	POI list
有没有设置别出心裁的酒店	{设置=POI特性实体, 别出心裁=POI特性实体修饰}	POI list
有没有格局合理的酒店	{合理=POI特性实体修饰, 格局=POI特性实体}	POI list
有没有视野非凡的酒店	{非凡=POI特性实体修饰, 视野=POI特性实体}	POI list
有没有空间狭窄的酒店	{空间=POI特性实体, 狭窄=POI特性实体修饰}	POI list
有没有外观不怎么样的酒店	{外观=POI特性实体, 不怎么样=POI特性实体修饰}	POI list
推荐几个风力强的五星级酒店	{强=POI特性实体修饰, 风力=POI特性实体, 五星级=星级}	POI list
推荐几个景色尚可的五星级酒店	{尚可=POI特性实体修饰, 景色=POI特性实体, 五星级=星级}	POI list
推荐几个视野赞的四星级酒店	{四星级=星级, 视野=POI特性实体, 赞=POI特性实体修饰}	POI list
推荐几个面积宽的三星级酒店	{三星级=星级, 宽=POI特性实体修饰, 面积=POI特性实体}	POI list
推荐几个构造复杂的三星级酒店	{三星级=星级, 构造=POI特性实体, 复杂=POI特性实体修饰}	POI list
推荐几个细节清晰的三星级酒店	{三星级=星级, 细节=POI特性实体, 清晰=POI特性实体修饰}	POI list
推荐几个历史感十足的三星级酒店	{三星级=星级, 历史感=POI特性实体, 十足=POI特性实体修饰}	POI list
推荐几个内饰陈旧的五星级酒店	{内饰=POI特性实体, 陈旧=POI特性实体修饰, 五星级=星级}	POI list
推荐几个噪声不断的四星级酒店	{四星级=星级, 不断=POI特性实体修饰, 噪声=POI特性实体}	POI list
推荐几个绿化好好的三星级酒店	{三星级=星级, 绿化=POI特性实体, 好好=POI特性实体修饰}	POI list
推荐几个风水好的五星级酒店	{风水=POI特性实体, 好=POI特性实体修饰, 五星级=星级}	POI list
推荐几个乐趣不多的四星级酒店	{四星级=星级, 不多=POI特性实体修饰, 乐趣=POI特性实体}	POI list
推荐几个场景好玩的五星级酒店	{好玩=POI特性实体修饰, 场景=POI特性实体, 五星级=星级}	POI list
推荐几个设置不错的五星级酒店	{设置=POI特性实体, 不错=POI特性实体修饰, 五星级=星级}	POI list
推荐几个格局明亮的五星级酒店	{格局=POI特性实体, 明亮=POI特性实体修饰, 五星级=星级}	POI list
推荐几个视觉不错的四星级酒店	{四星级=星级, 视觉=POI特性实体, 不错=POI特性实体修饰}	POI list
推荐几个灯光突出的五星级酒店	{突出=POI特性实体修饰, 灯光=POI特性实体, 五星级=星级}	POI list
推荐几个环境好玩的四星级酒店	{四星级=星级, 好玩=POI特性实体修饰, 环境=POI特性实体}	POI list
推荐几个风水非常好的四星级酒店	{非常好=POI特性实体修饰, 四星级=星级, 风水=POI特性实体}	POI list
推荐几个可游性强的四星级酒店	{四星级=星级, 可游性=POI特性实体, 强=POI特性实体修饰}	POI list
推荐几个夜生活少的五星级酒店	{少=POI特性实体修饰, 夜生活=POI特性实体, 五星级=星级}	POI list
推荐几个空间有限的四星级酒店	{四星级=星级, 空间=POI特性实体, 有限=POI特性实体修饰}	POI list
推荐几个配置低的三星级酒店	{三星级=星级, 配置=POI特性实体, 低=POI特性实体修饰}	POI list
推荐几个景色还成的五星级酒店	{还成=POI特性实体修饰, 景色=POI特性实体, 五星级=星级}	POI list
推荐几个外观阴森的三星级酒店	{三星级=星级, 外观=POI特性实体, 阴森=POI特性实体修饰}	POI list
推荐几个入口酷的三星级酒店	{三星级=星级, 入口=POI特性实体, 酷=POI特性实体修饰}	POI list
推荐几个入口壮观的五星级酒店	{入口=POI特性实体, 壮观=POI特性实体修饰, 五星级=星级}	POI list
推荐几个配置低的五星级酒店	{配置=POI特性实体, 低=POI特性实体修饰, 五星级=星级}	POI list
推荐几个历史感重的四星级酒店	{四星级=星级, 历史感=POI特性实体, 重=POI特性实体修饰}	POI list
推荐几个布局紧凑的四星级酒店	{四星级=星级, 紧凑=POI特性实体修饰, 布局=POI特性实体}	POI list
推荐几个配置不够好的四星级酒店	{四星级=星级, 配置=POI特性实体, 不够好=POI特性实体修饰}	POI list
推荐几个风情浓浓的三星级酒店	{三星级=星级, 风情=POI特性实体, 浓浓=POI特性实体修饰}	POI list
推荐几个布景很好的五星级酒店	{布景=POI特性实体, 很好=POI特性实体修饰, 五星级=星级}	POI list
推荐几个清洁度高的五星级酒店	{清洁度=POI特性实体, 高=POI特性实体修饰, 五星级=星级}	POI list
推荐几个图案清楚的三星级酒店	{图案=POI特性实体, 三星级=星级, 清楚=POI特性实体修饰}	POI list
推荐几个气温舒服的三星级酒店	{三星级=星级, 气温=POI特性实体, 舒服=POI特性实体修饰}	POI list
推荐几个入口好玩的三星级酒店	{三星级=星级, 入口=POI特性实体, 好玩=POI特性实体修饰}	POI list
推荐几个气息淡的五星级酒店	{淡=POI特性实体修饰, 气息=POI特性实体, 五星级=星级}	POI list
推荐几个入口棒的三星级酒店	{三星级=星级, 棒=POI特性实体修饰, 入口=POI特性实体}	POI list
推荐几个形态凶猛的三星级酒店	{三星级=星级, 形态=POI特性实体, 凶猛=POI特性实体修饰}	POI list
推荐几个色彩和谐的三星级酒店	{三星级=星级, 色彩=POI特性实体, 和谐=POI特性实体修饰}	POI list
推荐几个规模超大的四星级酒店	{四星级=星级, 超大=POI特性实体修饰, 规模=POI特性实体}	POI list
推荐几个色彩一致的四星级酒店	{四星级=星级, 色彩=POI特性实体, 一致=POI特性实体修饰}	POI list
推荐几个视角最佳的三星级酒店	{三星级=星级, 视角=POI特性实体, 最佳=POI特性实体修饰}	POI list
推荐几个清洁度高的三星级酒店	{清洁度=POI特性实体, 三星级=星级, 高=POI特性实体修饰}	POI list
推荐几个可游性高的五星级酒店	{可游性=POI特性实体, 高=POI特性实体修饰, 五星级=星级}	POI list
推荐几个绿化一流的四星级酒店	{四星级=星级, 绿化=POI特性实体, 一流=POI特性实体修饰}	POI list
推荐几个晚霞不错的三星级酒店	{三星级=星级, 不错=POI特性实体修饰, 晚霞=POI特性实体}	POI list
推荐几个风水极好的三星级酒店	{极好=POI特性实体修饰, 三星级=星级, 风水=POI特性实体}	POI list
推荐几个设备土的四星级酒店	{四星级=星级, 设备=POI特性实体, 土=POI特性实体修饰}	POI list
推荐几个风力越来越大的四星级酒店	{四星级=星级, 越来越大=POI特性实体修饰, 风力=POI特性实体}	POI list
推荐几个日落短暂的五星级酒店	{日落=POI特性实体, 短暂=POI特性实体修饰, 五星级=星级}	POI list
推荐几个历史感很强的三星级酒店	{三星级=星级, 历史感=POI特性实体, 很强=POI特性实体修饰}	POI list
推荐几个绿化多的四星级酒店	{四星级=星级, 绿化=POI特性实体, 多=POI特性实体修饰}	POI list
推荐几个细节清清楚楚的五星级酒店	{细节=POI特性实体, 清清楚楚=POI特性实体修饰, 五星级=星级}	POI list
推荐几个灯火温暖的四星级酒店	{温暖=POI特性实体修饰, 四星级=星级, 灯火=POI特性实体}	POI list
推荐几个风格简朴的四星级酒店	{四星级=星级, 简朴=POI特性实体修饰, 风格=POI特性实体}	POI list
推荐几个光线强烈的四星级酒店	{四星级=星级, 强烈=POI特性实体修饰, 光线=POI特性实体}	POI list
推荐几个声势惊人的四星级酒店	{四星级=星级, 声势=POI特性实体, 惊人=POI特性实体修饰}	POI list
推荐几个设备老的三星级酒店	{三星级=星级, 老=POI特性实体修饰, 设备=POI特性实体}	POI list
推荐几个安检专业的三星级酒店	{三星级=星级, 安检=POI特性实体, 专业=POI特性实体修饰}	POI list
推荐几个底蕴浓厚的三星级酒店	{三星级=星级, 底蕴=POI特性实体, 浓厚=POI特性实体修饰}	POI list
推荐几个名气一般的三星级酒店	{三星级=星级, 一般=POI特性实体修饰, 名气=POI特性实体}	POI list
推荐几个互动性不少的四星级酒店	{互动性=POI特性实体, 四星级=星级, 不少=POI特性实体修饰}	POI list
推荐几个装饰浮夸的三星级酒店	{三星级=星级, 浮夸=POI特性实体修饰, 装饰=POI特性实体}	POI list
推荐几个布置简朴的四星级酒店	{布置=POI特性实体, 四星级=星级, 简朴=POI特性实体修饰}	POI list
推荐几个外表新的四星级酒店	{新=POI特性实体修饰, 四星级=星级, 外表=POI特性实体}	POI list
推荐几个地热有名的三星级酒店	{三星级=星级, 地热=POI特性实体, 有名=POI特性实体修饰}	POI list
推荐几个门面隐蔽的五星级酒店	{门面=POI特性实体, 隐蔽=POI特性实体修饰, 五星级=星级}	POI list
推荐几个体验出色的五星级酒店	{出色=POI特性实体修饰, 体验=POI特性实体, 五星级=星级}	POI list
推荐几个装潢华丽的五星级酒店	{华丽=POI特性实体修饰, 装潢=POI特性实体, 五星级=星级}	POI list
推荐几个视觉赞的四星级酒店	{四星级=星级, 视觉=POI特性实体, 赞=POI特性实体修饰}	POI list
推荐几个景致丰富的四星级酒店	{四星级=星级, 丰富=POI特性实体修饰, 景致=POI特性实体}	POI list
推荐几个污染重的的四星级酒店	{四星级=星级, 重的=POI特性实体修饰, 污染=POI特性实体}	POI list
推荐几个氛围诱人的五星级酒店	{氛围=POI特性实体, 诱人=POI特性实体修饰, 五星级=星级}	POI list
推荐几个设施低龄化的五星级酒店	{低龄化=POI特性实体修饰, 设施=POI特性实体, 五星级=星级}	POI list
推荐几个气势威严的三星级酒店	{三星级=星级, 气势=POI特性实体, 威严=POI特性实体修饰}	POI list
推荐几个底蕴厚重的四星级酒店	{四星级=星级, 底蕴=POI特性实体, 厚重=POI特性实体修饰}	POI list
推荐几个视觉极佳的三星级酒店	{三星级=星级, 视觉=POI特性实体, 极佳=POI特性实体修饰}	POI list
推荐几个场景美轮美奂的五星级酒店	{美轮美奂=POI特性实体修饰, 场景=POI特性实体, 五星级=星级}	POI list
推荐几个风力强的三星级酒店	{三星级=星级, 强=POI特性实体修饰, 风力=POI特性实体}	POI list
推荐几个风力强劲的四星级酒店	{四星级=星级, 强劲=POI特性实体修饰, 风力=POI特性实体}	POI list
推荐几个日落短暂的三星级酒店	{三星级=星级, 日落=POI特性实体, 短暂=POI特性实体修饰}	POI list
推荐几个设置巧妙的三星级酒店	{三星级=星级, 设置=POI特性实体, 巧妙=POI特性实体修饰}	POI list
推荐几个道路宽敞的四星级酒店	{四星级=星级, 宽敞=POI特性实体修饰, 道路=POI特性实体}	POI list
推荐几个场景奇特的三星级酒店	{三星级=星级, 奇特=POI特性实体修饰, 场景=POI特性实体}	POI list
推荐几个现代感强的三星级酒店	{现代感=POI特性实体, 三星级=星级, 强=POI特性实体修饰}	POI list
推荐几个色彩暖的四星级酒店	{四星级=星级, 暖=POI特性实体修饰, 色彩=POI特性实体}	POI list
推荐几个面积宏大的五星级酒店	{宏大=POI特性实体修饰, 面积=POI特性实体, 五星级=星级}	POI list
推荐几个规模盛大的四星级酒店	{四星级=星级, 盛大=POI特性实体修饰, 规模=POI特性实体}	POI list
推荐几个历史感浓的五星级酒店	{浓=POI特性实体修饰, 历史感=POI特性实体, 五星级=星级}	POI list
推荐几个内饰简单的三星级酒店	{三星级=星级, 内饰=POI特性实体, 简单=POI特性实体修饰}	POI list
推荐几个布景好看的三星级酒店	{三星级=星级, 好看=POI特性实体修饰, 布景=POI特性实体}	POI list
推荐几个现代感强的的三星级酒店	{现代感=POI特性实体, 三星级=星级, 强的=POI特性实体修饰}	POI list
推荐几个污染多了的四星级酒店	{四星级=星级, 多了=POI特性实体修饰, 污染=POI特性实体}	POI list
推荐几个体验幽默的五星级酒店	{体验=POI特性实体, 幽默=POI特性实体修饰, 五星级=星级}	POI list
推荐几个景象诡异的五星级酒店	{诡异=POI特性实体修饰, 景象=POI特性实体, 五星级=星级}	POI list
推荐几个场景秀丽的三星级酒店	{三星级=星级, 秀丽=POI特性实体修饰, 场景=POI特性实体}	POI list
推荐几个氛围不错的五星级酒店	{氛围=POI特性实体, 不错=POI特性实体修饰, 五星级=星级}	POI list
推荐几个香火足的四星级酒店	{香火=POI特性实体, 四星级=星级, 足=POI特性实体修饰}	POI list
有道路宽敞的三星级酒店吗	{三星级=星级, 宽敞=POI特性实体修饰, 道路=POI特性实体}	POI list
有招牌老旧的三星级酒店吗	{三星级=星级, 老旧=POI特性实体修饰, 招牌=POI特性实体}	POI list
有地貌有趣的四星级酒店吗	{四星级=星级, 地貌=POI特性实体, 有趣=POI特性实体修饰}	POI list
有底蕴深厚的三星级酒店吗	{三星级=星级, 底蕴=POI特性实体, 深厚=POI特性实体修饰}	POI list
有流线乱的五星级酒店吗	{乱=POI特性实体修饰, 流线=POI特性实体, 五星级=星级}	POI list
有夜景差的四星级酒店吗	{四星级=星级, 夜景=POI特性实体, 差=POI特性实体修饰}	POI list
有晚霞耀眼的三星级酒店吗	{三星级=星级, 耀眼=POI特性实体修饰, 晚霞=POI特性实体}	POI list
有绿化不错啊的五星级酒店吗	{绿化=POI特性实体, 不错啊=POI特性实体修饰, 五星级=星级}	POI list
有设置精巧的三星级酒店吗	{三星级=星级, 设置=POI特性实体, 精巧=POI特性实体修饰}	POI list
有地面高低不平的五星级酒店吗	{地面=POI特性实体, 高低不平=POI特性实体修饰, 五星级=星级}	POI list
有装备干净的五星级酒店吗	{装备=POI特性实体, 干净=POI特性实体修饰, 五星级=星级}	POI list
有布局紧密的四星级酒店吗	{紧密=POI特性实体修饰, 四星级=星级, 布局=POI特性实体}	POI list
有情节生动的五星级酒店吗	{情节=POI特性实体, 生动=POI特性实体修饰, 五星级=星级}	POI list
有视角最佳的五星级酒店吗	{视角=POI特性实体, 最佳=POI特性实体修饰, 五星级=星级}	POI list
有夕阳漂亮的四星级酒店吗	{漂亮=POI特性实体修饰, 四星级=星级, 夕阳=POI特性实体}	POI list
有光线清楚的五星级酒店吗	{清楚=POI特性实体修饰, 光线=POI特性实体, 五星级=星级}	POI list
有布景一流的五星级酒店吗	{布景=POI特性实体, 一流=POI特性实体修饰, 五星级=星级}	POI list
有地形低的五星级酒店吗	{地形=POI特性实体, 低=POI特性实体修饰, 五星级=星级}	POI list
有设计高明的三星级酒店吗	{三星级=星级, 设计=POI特性实体, 高明=POI特性实体修饰}	POI list
有设计赞的五星级酒店吗	{设计=POI特性实体, 赞=POI特性实体修饰, 五星级=星级}	POI list
有海景雄壮的五星级酒店吗	{海景=POI特性实体, 雄壮=POI特性实体修饰, 五星级=星级}	POI list
有情节浪漫的三星级酒店吗	{三星级=星级, 情节=POI特性实体, 浪漫=POI特性实体修饰}	POI list
有卫生好了的三星级酒店吗	{三星级=星级, 好了=POI特性实体修饰, 卫生=POI特性实体}	POI list
有形态凶猛的五星级酒店吗	{形态=POI特性实体, 凶猛=POI特性实体修饰, 五星级=星级}	POI list
有声势惊人的五星级酒店吗	{声势=POI特性实体, 惊人=POI特性实体修饰, 五星级=星级}	POI list
有卫生赞的四星级酒店吗	{四星级=星级, 卫生=POI特性实体, 赞=POI特性实体修饰}	POI list
有卫生棒的四星级酒店吗	{四星级=星级, 棒=POI特性实体修饰, 卫生=POI特性实体}	POI list
有装修辉煌的五星级酒店吗	{辉煌=POI特性实体修饰, 装修=POI特性实体, 五星级=星级}	POI list
有噪声大的三星级酒店吗	{三星级=星级, 大=POI特性实体修饰, 噪声=POI特性实体}	POI list
有趣味不断的四星级酒店吗	{趣味=POI特性实体, 四星级=星级, 不断=POI特性实体修饰}	POI list
有设计佳的五星级酒店吗	{设计=POI特性实体, 佳=POI特性实体修饰, 五星级=星级}	POI list
有装潢贵气的三星级酒店吗	{三星级=星级, 装潢=POI特性实体, 贵气=POI特性实体修饰}	POI list
有名气一般的四星级酒店吗	{四星级=星级, 一般=POI特性实体修饰, 名气=POI特性实体}	POI list
有清洁度不错的四星级酒店吗	{清洁度=POI特性实体, 四星级=星级, 不错=POI特性实体修饰}	POI list
有观赏性一般的四星级酒店吗	{四星级=星级, 一般=POI特性实体修饰, 观赏性=POI特性实体}	POI list
有图案清晰的五星级酒店吗	{图案=POI特性实体, 清晰=POI特性实体修饰, 五星级=星级}	POI list
有噪声不断的五星级酒店吗	{不断=POI特性实体修饰, 噪声=POI特性实体, 五星级=星级}	POI list
有情节有意思的三星级酒店吗	{三星级=星级, 情节=POI特性实体, 有意思=POI特性实体修饰}	POI list
有气息少的五星级酒店吗	{少=POI特性实体修饰, 气息=POI特性实体, 五星级=星级}	POI list
有底蕴浓厚的三星级酒店吗	{三星级=星级, 底蕴=POI特性实体, 浓厚=POI特性实体修饰}	POI list
有可游性高的三星级酒店吗	{三星级=星级, 可游性=POI特性实体, 高=POI特性实体修饰}	POI list
有绿化整齐的三星级酒店吗	{整齐=POI特性实体修饰, 三星级=星级, 绿化=POI特性实体}	POI list
有污染重的五星级酒店吗	{重=POI特性实体修饰, 污染=POI特性实体, 五星级=星级}	POI list
有环境好玩的五星级酒店吗	{好玩=POI特性实体修饰, 环境=POI特性实体, 五星级=星级}	POI list
有卫生很好的四星级酒店吗	{四星级=星级, 卫生=POI特性实体, 很好=POI特性实体修饰}	POI list
有规模广大的四星级酒店吗	{四星级=星级, 广大=POI特性实体修饰, 规模=POI特性实体}	POI list
有日落短暂的四星级酒店吗	{四星级=星级, 日落=POI特性实体, 短暂=POI特性实体修饰}	POI list
有细节清清楚楚的四星级酒店吗	{四星级=星级, 细节=POI特性实体, 清清楚楚=POI特性实体修饰}	POI list
有夜景朦朦胧胧的五星级酒店吗	{朦朦胧胧=POI特性实体修饰, 夜景=POI特性实体, 五星级=星级}	POI list
有趣味无穷的四星级酒店吗	{趣味=POI特性实体, 四星级=星级, 无穷=POI特性实体修饰}	POI list
有地貌好玩的四星级酒店吗	{四星级=星级, 地貌=POI特性实体, 好玩=POI特性实体修饰}	POI list
有格局高雅的四星级酒店吗	{四星级=星级, 格局=POI特性实体, 高雅=POI特性实体修饰}	POI list
有声势浩大的四星级酒店吗	{四星级=星级, 浩大=POI特性实体修饰, 声势=POI特性实体}	POI list
有秩序还好的五星级酒店吗	{还好=POI特性实体修饰, 秩序=POI特性实体, 五星级=星级}	POI list
有清洁度不错的五星级酒店吗	{清洁度=POI特性实体, 不错=POI特性实体修饰, 五星级=星级}	POI list
有流线乱的三星级酒店吗	{三星级=星级, 乱=POI特性实体修饰, 流线=POI特性实体}	POI list
有夜晚凉快的五星级酒店吗	{夜晚=POI特性实体, 凉快=POI特性实体修饰, 五星级=星级}	POI list
有布置简单的四星级酒店吗	{布置=POI特性实体, 四星级=星级, 简单=POI特性实体修饰}	POI list
有景致颇多的四星级酒店吗	{颇多=POI特性实体修饰, 四星级=星级, 景致=POI特性实体}	POI list
有外表大的五星级酒店吗	{大=POI特性实体修饰, 外表=POI特性实体, 五星级=星级}	POI list
有环境清雅的四星级酒店吗	{四星级=星级, 环境=POI特性实体, 清雅=POI特性实体修饰}	POI list
有光线好看的三星级酒店吗	{三星级=星级, 好看=POI特性实体修饰, 光线=POI特性实体}	POI list
有入口大气的五星级酒店吗	{入口=POI特性实体, 大气=POI特性实体修饰, 五星级=星级}	POI list
有外墙很脏的四星级酒店吗	{四星级=星级, 外墙=POI特性实体, 很脏=POI特性实体修饰}	POI list
有风情美的五星级酒店吗	{风情=POI特性实体, 美=POI特性实体修饰, 五星级=星级}	POI list
有场景细致的三星级酒店吗	{三星级=星级, 细致=POI特性实体修饰, 场景=POI特性实体}	POI list
有光线浪漫的五星级酒店吗	{光线=POI特性实体, 浪漫=POI特性实体修饰, 五星级=星级}	POI list
有晚霞浪漫的四星级酒店吗	{四星级=星级, 晚霞=POI特性实体, 浪漫=POI特性实体修饰}	POI list
有意义大的三星级酒店吗	{三星级=星级, 意义=POI特性实体, 大=POI特性实体修饰}	POI list
有卫生好呀的四星级酒店吗	{四星级=星级, 好呀=POI特性实体修饰, 卫生=POI特性实体}	POI list
有晚霞绚烂的五星级酒店吗	{绚烂=POI特性实体修饰, 晚霞=POI特性实体, 五星级=星级}	POI list
有图案鲜明的五星级酒店吗	{图案=POI特性实体, 鲜明=POI特性实体修饰, 五星级=星级}	POI list
有视觉不错的五星级酒店吗	{视觉=POI特性实体, 不错=POI特性实体修饰, 五星级=星级}	POI list
有细节清清楚楚的五星级酒店吗	{细节=POI特性实体, 清清楚楚=POI特性实体修饰, 五星级=星级}	POI list
有音场烂的三星级酒店吗	{三星级=星级, 烂=POI特性实体修饰, 音场=POI特性实体}	POI list
有噪声大的四星级酒店吗	{四星级=星级, 大=POI特性实体修饰, 噪声=POI特性实体}	POI list
有知名度不高的四星级酒店吗	{不高=POI特性实体修饰, 四星级=星级, 知名度=POI特性实体}	POI list
有样式可爱的四星级酒店吗	{四星级=星级, 样式=POI特性实体, 可爱=POI特性实体修饰}	POI list
有景致非常多的四星级酒店吗	{四星级=星级, 非常多=POI特性实体修饰, 景致=POI特性实体}	POI list
有秩序不错的三星级酒店吗	{三星级=星级, 不错=POI特性实体修饰, 秩序=POI特性实体}	POI list
有景致各异的五星级酒店吗	{各异=POI特性实体修饰, 景致=POI特性实体, 五星级=星级}	POI list
有乐趣更少的四星级酒店吗	{更少=POI特性实体修饰, 四星级=星级, 乐趣=POI特性实体}	POI list
有治安非常好的五星级酒店吗	{非常好=POI特性实体修饰, 治安=POI特性实体, 五星级=星级}	POI list
有香火兴旺的三星级酒店吗	{三星级=星级, 香火=POI特性实体, 兴旺=POI特性实体修饰}	POI list
有光线炫目的四星级酒店吗	{四星级=星级, 光线=POI特性实体, 炫目=POI特性实体修饰}	POI list
有外表新的五星级酒店吗	{新=POI特性实体修饰, 外表=POI特性实体, 五星级=星级}	POI list
有配置低的三星级酒店吗	{三星级=星级, 配置=POI特性实体, 低=POI特性实体修饰}	POI list
有秩序还好的三星级酒店吗	{三星级=星级, 还好=POI特性实体修饰, 秩序=POI特性实体}	POI list
有晚霞耀眼的五星级酒店吗	{耀眼=POI特性实体修饰, 晚霞=POI特性实体, 五星级=星级}	POI list
有海拔较高的三星级酒店吗	{海拔=POI特性实体, 三星级=星级, 较高=POI特性实体修饰}	POI list
有设计厉害的四星级酒店吗	{厉害=POI特性实体修饰, 四星级=星级, 设计=POI特性实体}	POI list
有现代感强烈的四星级酒店吗	{现代感=POI特性实体, 四星级=星级, 强烈=POI特性实体修饰}	POI list
有晚霞绚烂的三星级酒店吗	{三星级=星级, 绚烂=POI特性实体修饰, 晚霞=POI特性实体}	POI list
有观赏性不足的四星级酒店吗	{四星级=星级, 观赏性=POI特性实体, 不足=POI特性实体修饰}	POI list
有外表吸引人的四星级酒店吗	{四星级=星级, 外表=POI特性实体, 吸引人=POI特性实体修饰}	POI list
有名气比较少的五星级酒店吗	{比较少=POI特性实体修饰, 名气=POI特性实体, 五星级=星级}	POI list
有景观破败的四星级酒店吗	{四星级=星级, 破败=POI特性实体修饰, 景观=POI特性实体}	POI list
有装备齐备的四星级酒店吗	{四星级=星级, 装备=POI特性实体, 齐备=POI特性实体修饰}	POI list
有夕阳温暖的五星级酒店吗	{温暖=POI特性实体修饰, 夕阳=POI特性实体, 五星级=星级}	POI list
有构造错综复杂的五星级酒店吗	{构造=POI特性实体, 错综复杂=POI特性实体修饰, 五星级=星级}	POI list
有适合亲子居住的四星级酒店吗	{四星级=星级, 亲子=适宜人群}	POI list
有适合动漫迷居住的三星级酒店吗	{动漫迷=适宜人群, 三星级=星级}	POI list
有适合动漫迷居住的四星级酒店吗	{动漫迷=适宜人群, 四星级=星级}	POI list
有适合情侣居住的三星级酒店吗	{三星级=星级, 情侣=适宜人群}	POI list
有适合动漫迷居住的五星级酒店吗	{动漫迷=适宜人群, 五星级=星级}	POI list
有适合亲子居住的五星级酒店吗	{亲子=适宜人群, 五星级=星级}	POI list
有适合情侣居住的五星级酒店吗	{情侣=适宜人群, 五星级=星级}	POI list
有适合亲子居住的三星级酒店吗	{三星级=星级, 亲子=适宜人群}	POI list
荣军院是几星级的	{荣军院=POI名称}	[星级]
唐人街是几星级的	{唐人街=POI名称}	[星级]
玛黑区是几星级的	{玛黑区=POI名称}	[星级]
莱茵河是几星级的	{莱茵河=POI名称}	[星级]
卢浮宫是几星级的	{卢浮宫=POI名称}	[星级]
日月潭是几星级的	{日月潭=POI名称}	[星级]
金阁寺是几星级的	{金阁寺=POI名称}	[星级]
猴庙是几星级的	{猴庙=POI名称}	[星级]
光明寺是几星级的	{光明寺=POI名称}	[星级]
路易港是几星级的	{路易港=POI名称}	[星级]
孚日宫是几星级的	{孚日宫=POI名称}	[星级]
维多利亚港是几星级的	{维多利亚港=POI名称}	[星级]
多瑙河是几星级的	{多瑙河=POI名称}	[星级]
白沙滩是几星级的	{白沙滩=POI名称}	[星级]
凯旋门是几星级的	{凯旋门=POI名称}	[星级]
芬兰堡是几星级的	{芬兰堡=POI名称}	[星级]
密歇根湖是几星级的	{密歇根湖=POI名称}	[星级]
阿尔法玛是几星级的	{阿尔法玛=POI名称}	[星级]
大夏宫是几星级的	{大夏宫=POI名称}	[星级]
迪士尼是几星级的	{迪士尼=POI名称}	[星级]
红树是几星级的	{红树=POI名称}	[星级]
马穆提岛是几星级的	{马穆提岛=POI名称}	[星级]
景福宫是几星级的	{景福宫=POI名称}	[星级]
全聚德是几星级的	{全聚德=POI名称}	[星级]
迪斯尼是几星级的	{迪斯尼=POI名称}	[星级]
青莲院是几星级的	{青莲院=POI名称}	[星级]
菲律宾碧瑶的全聚德是几星级的	{全聚德=POI名称, 菲律宾碧瑶=地理位置参数}	[星级]
斯里兰卡本托特的迪士尼是几星级的	{迪士尼=POI名称, 斯里兰卡本托特=地理位置参数}	[星级]
美国阿纳海姆的光明寺是几星级的	{光明寺=POI名称, 美国阿纳海姆=地理位置参数}	[星级]
马来西亚哥打巴鲁的莱茵河是几星级的	{莱茵河=POI名称, 马来西亚哥打巴鲁=地理位置参数}	[星级]
澳大利亚悉尼的路易港是几星级的	{澳大利亚悉尼=地理位置参数, 路易港=POI名称}	[星级]
威克洛郡的金阁寺是几星级的	{威克洛郡=地理位置参数, 金阁寺=POI名称}	[星级]
俄罗斯克拉斯诺达尔的迪斯尼是几星级的	{俄罗斯克拉斯诺达尔=地理位置参数, 迪斯尼=POI名称}	[星级]
坎莫尔的荣军院是几星级的	{荣军院=POI名称, 坎莫尔=地理位置参数}	[星级]
印度尼西亚雅加达的荣军院是几星级的	{印度尼西亚雅加达=地理位置参数, 荣军院=POI名称}	[星级]
瑞士格林德瓦的荣军院是几星级的	{瑞士格林德瓦=地理位置参数, 荣军院=POI名称}	[星级]
巴布亚新几内亚新不列颠岛的芬兰堡是几星级的	{巴布亚新几内亚新不列颠岛=地理位置参数, 芬兰堡=POI名称}	[星级]
德国法兰克福的阿尔法玛是几星级的	{德国法兰克福=地理位置参数, 阿尔法玛=POI名称}	[星级]
圣莫尼卡的迪斯尼是几星级的	{圣莫尼卡=地理位置参数, 迪斯尼=POI名称}	[星级]
利斯特维扬卡的芬兰堡是几星级的	{利斯特维扬卡=地理位置参数, 芬兰堡=POI名称}	[星级]
新西兰皮克顿的玛黑区是几星级的	{玛黑区=POI名称, 新西兰皮克顿=地理位置参数}	[星级]
马来西亚吉隆坡的多瑙河是几星级的	{马来西亚吉隆坡=地理位置参数, 多瑙河=POI名称}	[星级]
葡萄牙法鲁的金阁寺是几星级的	{葡萄牙法鲁=地理位置参数, 金阁寺=POI名称}	[星级]
陶尔米纳的凯旋门是几星级的	{陶尔米纳=地理位置参数, 凯旋门=POI名称}	[星级]
马赛的大夏宫是几星级的	{大夏宫=POI名称, 马赛=地理位置参数}	[星级]
基尔根尼的维多利亚港是几星级的	{维多利亚港=POI名称, 基尔根尼=地理位置参数}	[星级]
法国马赛的鼓浪屿是几星级的	{法国马赛=地理位置参数, 鼓浪屿=POI名称}	[星级]
美国伯克利的白沙滩是几星级的	{美国伯克利=地理位置参数, 白沙滩=POI名称}	[星级]
印度尼西亚巴厘岛的新加坡河是几星级的	{新加坡河=POI名称, 印度尼西亚巴厘岛=地理位置参数}	[星级]
意大利威尼斯的密歇根湖是几星级的	{意大利威尼斯=地理位置参数, 密歇根湖=POI名称}	[星级]
伏尔加格勒的白沙滩是几星级的	{伏尔加格勒=地理位置参数, 白沙滩=POI名称}	[星级]
尼尔森的大夏宫是几星级的	{尼尔森=地理位置参数, 大夏宫=POI名称}	[星级]
泰国春蓬的鼓浪屿是几星级的	{鼓浪屿=POI名称, 泰国春蓬=地理位置参数}	[星级]
日本宫古岛的维多利亚港是几星级的	{日本宫古岛=地理位置参数, 维多利亚港=POI名称}	[星级]
勃固的凯旋门是几星级的	{凯旋门=POI名称, 勃固=地理位置参数}	[星级]
横滨的唐人街是几星级的	{横滨=地理位置参数, 唐人街=POI名称}	[星级]
维多利亚的玛黑区是几星级的	{玛黑区=POI名称, 维多利亚=地理位置参数}	[星级]
斯里兰卡马特勒的芬兰堡是几星级的	{斯里兰卡马特勒=地理位置参数, 芬兰堡=POI名称}	[星级]
澳大利亚堪培拉的卢浮宫是几星级的	{澳大利亚堪培拉=地理位置参数, 卢浮宫=POI名称}	[星级]
名古屋的九寨沟是几星级的	{名古屋=地理位置参数, 九寨沟=POI名称}	[星级]
菲律宾达沃的金阁寺是几星级的	{菲律宾达沃=地理位置参数, 金阁寺=POI名称}	[星级]
法国格拉斯的托普卡帕宫是几星级的	{法国格拉斯=地理位置参数, 托普卡帕宫=POI名称}	[星级]
哥伦比亚麦德林的密歇根湖是几星级的	{哥伦比亚麦德林=地理位置参数, 密歇根湖=POI名称}	[星级]
利雅得的青莲院是几星级的	{青莲院=POI名称, 利雅得=地理位置参数}	[星级]
万象的新加坡河是几星级的	{万象=地理位置参数, 新加坡河=POI名称}	[星级]
博拉博拉岛的密歇根湖是几星级的	{密歇根湖=POI名称, 博拉博拉岛=地理位置参数}	[星级]
以色列阿卡的日月潭是几星级的	{日月潭=POI名称, 以色列阿卡=地理位置参数}	[星级]
智利圣地亚哥的马穆提岛是几星级的	{智利圣地亚哥=地理位置参数, 马穆提岛=POI名称}	[星级]
德尔斐的莱茵河是几星级的	{德尔斐=地理位置参数, 莱茵河=POI名称}	[星级]
美国萨克拉门托的九寨沟是几星级的	{美国萨克拉门托=地理位置参数, 九寨沟=POI名称}	[星级]
希腊普雷韦扎的青莲院是几星级的	{希腊普雷韦扎=地理位置参数, 青莲院=POI名称}	[星级]
西班牙萨拉戈萨的迪士尼是几星级的	{西班牙萨拉戈萨=地理位置参数, 迪士尼=POI名称}	[星级]
法国阿讷西的凯旋门是几星级的	{法国阿讷西=地理位置参数, 凯旋门=POI名称}	[星级]
熊本的新加坡河是几星级的	{新加坡河=POI名称, 熊本=地理位置参数}	[星级]
中国苗栗的多瑙河是几星级的	{中国苗栗=地理位置参数, 多瑙河=POI名称}	[星级]
金边的红树是几星级的	{红树=POI名称, 金边=地理位置参数}	[星级]
奥斯坦德的景福宫是几星级的	{奥斯坦德=地理位置参数, 景福宫=POI名称}	[星级]
日本和歌山的莱茵河是几星级的	{莱茵河=POI名称, 日本和歌山=地理位置参数}	[星级]
莫斯科的白沙滩是几星级的	{莫斯科=地理位置参数, 白沙滩=POI名称}	[星级]
鲁尔蒙德的金阁寺是几星级的	{鲁尔蒙德=地理位置参数, 金阁寺=POI名称}	[星级]
葡萄牙布拉加的托普卡帕宫是几星级的	{葡萄牙布拉加=地理位置参数, 托普卡帕宫=POI名称}	[星级]
亚琛的芬兰堡是几星级的	{亚琛=地理位置参数, 芬兰堡=POI名称}	[星级]
哥伦比亚亚美尼亚城的维多利亚港是几星级的	{哥伦比亚亚美尼亚城=地理位置参数, 维多利亚港=POI名称}	[星级]
阿巴斯港的景福宫是几星级的	{景福宫=POI名称, 阿巴斯港=地理位置参数}	[星级]
蔚山的唐人街是几星级的	{唐人街=POI名称, 蔚山=地理位置参数}	[星级]
新西兰奥马鲁的金阁寺是几星级的	{新西兰奥马鲁=地理位置参数, 金阁寺=POI名称}	[星级]
美国阿拉梅达的新加坡河是几星级的	{美国阿拉梅达=地理位置参数, 新加坡河=POI名称}	[星级]
万隆的日月潭是几星级的	{日月潭=POI名称, 万隆=地理位置参数}	[星级]
凯恩斯的玛黑区是几星级的	{玛黑区=POI名称, 凯恩斯=地理位置参数}	[星级]
毕尔巴鄂的青莲院是几星级的	{毕尔巴鄂=地理位置参数, 青莲院=POI名称}	[星级]
布宜诺斯艾利斯的凯旋门是几星级的	{布宜诺斯艾利斯=地理位置参数, 凯旋门=POI名称}	[星级]
瑞典马尔默的猴庙是几星级的	{猴庙=POI名称, 瑞典马尔默=地理位置参数}	[星级]
英国诺丁汉的玛黑区是几星级的	{玛黑区=POI名称, 英国诺丁汉=地理位置参数}	[星级]
罗腾堡的光明寺是几星级的	{罗腾堡=地理位置参数, 光明寺=POI名称}	[星级]
越南芽庄的维多利亚港是几星级的	{越南芽庄=地理位置参数, 维多利亚港=POI名称}	[星级]
不丹廷布的全聚德是几星级的	{不丹廷布=地理位置参数, 全聚德=POI名称}	[星级]
西班牙锡切斯的猴庙是几星级的	{西班牙锡切斯=地理位置参数, 猴庙=POI名称}	[星级]
土耳其伊兹密尔的迪斯尼是几星级的	{土耳其伊兹密尔=地理位置参数, 迪斯尼=POI名称}	[星级]
塞班的青莲院是几星级的	{塞班=地理位置参数, 青莲院=POI名称}	[星级]
象岛的新加坡河是几星级的	{新加坡河=POI名称, 象岛=地理位置参数}	[星级]
哥伦比亚巴兰基亚的白沙滩是几星级的	{白沙滩=POI名称, 哥伦比亚巴兰基亚=地理位置参数}	[星级]
韩国丽水的白沙滩是几星级的	{韩国丽水=地理位置参数, 白沙滩=POI名称}	[星级]
英国利兹的马穆提岛是几星级的	{英国利兹=地理位置参数, 马穆提岛=POI名称}	[星级]
以色列里雄莱锡安的马穆提岛是几星级的	{以色列里雄莱锡安=地理位置参数, 马穆提岛=POI名称}	[星级]
希腊纳克索斯的全聚德是几星级的	{全聚德=POI名称, 希腊纳克索斯=地理位置参数}	[星级]
日本那霸的路易港是几星级的	{日本那霸=地理位置参数, 路易港=POI名称}	[星级]
别府的莱茵河是几星级的	{莱茵河=POI名称, 别府=地理位置参数}	[星级]
尔湾的芬兰堡是几星级的	{尔湾=地理位置参数, 芬兰堡=POI名称}	[星级]
布雷的光明寺是几星级的	{光明寺=POI名称, 布雷=地理位置参数}	[星级]
斯帕的维多利亚港是几星级的	{维多利亚港=POI名称, 斯帕=地理位置参数}	[星级]
桃园的莱茵河是几星级的	{莱茵河=POI名称, 桃园=地理位置参数}	[星级]
富川的芬兰堡是几星级的	{芬兰堡=POI名称, 富川=地理位置参数}	[星级]
凯米的迪斯尼是几星级的	{凯米=地理位置参数, 迪斯尼=POI名称}	[星级]
葡萄牙丰沙尔的大夏宫是几星级的	{葡萄牙丰沙尔=地理位置参数, 大夏宫=POI名称}	[星级]
卧龙岗的维港是几星级的	{维港=POI名称, 卧龙岗=地理位置参数}	[星级]
比利时根特的维港是几星级的	{比利时根特=地理位置参数, 维港=POI名称}	[星级]
印度尼西亚巴厘岛的托普卡帕宫是几星级的	{印度尼西亚巴厘岛=地理位置参数, 托普卡帕宫=POI名称}	[星级]
圣保罗的阿尔法玛是几星级的	{阿尔法玛=POI名称, 圣保罗=地理位置参数}	[星级]
泰国普吉岛的马穆提岛是几星级的	{泰国普吉岛=地理位置参数, 马穆提岛=POI名称}	[星级]
廷布的密歇根湖是几星级的	{廷布=地理位置参数, 密歇根湖=POI名称}	[星级]
奥洛穆茨的芬兰堡是几星级的	{奥洛穆茨=地理位置参数, 芬兰堡=POI名称}	[星级]
韩国木浦市的唐人街是几星级的	{唐人街=POI名称, 韩国木浦市=地理位置参数}	[星级]
巴西圣保罗的维港是几星级的	{维港=POI名称, 巴西圣保罗=地理位置参数}	[星级]
凯米的金阁寺是几星级的	{凯米=地理位置参数, 金阁寺=POI名称}	[星级]
马来西亚古晋的全聚德是几星级的	{全聚德=POI名称, 马来西亚古晋=地理位置参数}	[星级]
不丹帕罗的红树是几星级的	{红树=POI名称, 不丹帕罗=地理位置参数}	[星级]
